abeja	Urunquy.
abeja	Wanquyru.
abortar	Sulluy.
abra	Qasa.
abrir la boca	Hanllariy.
abrir	Kichay.
abuelo	Machu.
acampanado	Pankachu.
acarrear	Astay.
achiote	Achuwiti.
achita, quihuicha	Kiwicha.
acné	Muchi.
aconsejar, orientar	Hamutay.
acorralar, arrear los animales al corral	Qaykuy.
acusar	Qumalliy.
acusar	Willapay.
adivinanza	Watuchi.
adornar	Achalay.
adular	Llunkuy.
afilar	Ñawchiy.
afuera	Hawa.
agacharse, subestimarse	Kumuy.
agarrar, tomar con las manos	Hapiy.
agonizante	Wañunayaq.
agradecimiento, gratitud	Añaychay.
agrio	Puchqu.
aguja grande	Yawri.
ají	Uchu.
alabar, venerar, adorar, honrar	Yupaychay.
alacrán	Atuq atuq.
alas	Rapra.
alba	Achikyay.
alcanzar	Hayway.
alegrarse	Kusikuy.
alegría	Kusiy.
algodón	Utku.
alimento	Kawsay.
alma, espíritu	Ñuna.
almohada	Sawna.
alpaca	Paqu.
alumno	Yachakuq.
amanecer	Paqariy.
amanecer	Achikyay.
amargo	Qatqi.
amarillo	Qillu.
amistar	Allinpay.
ampolla	Pusullu.
anciana	Mamaku.
anciana	Paya.
andenería	Pata pata.
anemia	Upichu.
anillo	Siwi.
animal macho	Urqu.
animal, ganado	Uywa.
ano	Uqiti.
anochecer	Chisiyay.
antes de ayer	Qayninpa punchaw.
antes	Ñawpaq.
antes	Qayna.
anudar	Kipuy.
año	Wata.
apacheta, abra	Apachita.
apagar fuego	Amachay.
aparato urinario	Ispana.
aplanado	Chaqla.
aplastar con los dedos	Llapiy.
aplaudir	Taqllakuy.
apu	Noble, distinguido. Wiraqucha.
arado	Taklla.
araña grande	Apanqura.
arbol nativo del perú	Qiñwa.
árbol	Sacha.
arcilla	Llinki.
arco iris	Chirapa.
ardilla	Waywacha.
ardor	Rawray.
arena	Aqu.
arete	Tulumpi.
armadillo	Kirkinchu.
arrastrarse, reptar	Aysakuy.
arrear	Qatiy.
arreglar, embellecer	Sumaqchay.
arriba	Hanay.
arriba	Wichay.
arrodillarse	Qunqurikuy.
arvejas	Alwirha.
asado	Kanka.
asamblea	Rimanakuy.
asfixia, ahogo	Muki.
asfixiar	Mukiy.
asiento	Tiyana.
aspero	Charpa.
asquearse	Millakuy.
astilla	Qillpa.
asustarse	Manchay.
atado, bulto, quipe	Qipi.
atado	Chuqu, maytu.
atar, amarrar	Watay.
atardecer	Chisiyay.
autoridad	Kamachiq.
ave centinela	Liqliqa.
avergonzar	Pinqachiy.
avestruz, ñandú	Suri.
avisar	Willay.
avispa	Apaychakcha.
axila	Wallwaku.
ayer	Qayna punchaw.
ayudar, colaborar	Yanapay.
azadón	Rawkana.
azufre	Salli.
azul	Anqas.
baba	Lawsa.
bailar	Tusuy.
bajar algo	Uraykachiy.
bandera	Unancha.
bañarse	Armakuy.
barba	Sunka.
barranco	Wayqu.
barrer	Pichay.
barriga, estómago	Wiksa.
barro	Mitu.
bastón	Tawna.
basura	Qupa.
batán	Maray.
bayeta	Wayita.
bebé	Wawa.
beber, tomar	Upyay.
begonia	Achanqaray.
beriberi	Kaqu.
berro	Uqururu.
besar	Muchay.
bizco	Lirqu.
blanco	Yuraq.
blanquinegro	Allqa.
boca	Simi.
bocio	Qutu.
boleadora, laxo, flacido	Liwi.
bolsa tejida	Wayaqa.
bombo	Hatun tinya.
boquiabierto, distraído	Hakachu.
bosque	Sacha sacha.
bosta	Karka
bostezar, bostezo	Hanllapakuy.
botar, arrojar, perder	Wischuy.
brasa	Sansa.
brillo, brillante	Llipipi.
brotar el sembrío	Salir. Lluqsiy.
brotar	Iklliy.
bruto, poco inteligente	Asnu.
buche	Uytu.
búho	Tuku.
burro	Asnu.
caballo	Kawallu.
cabello, pelo	Chukcha.
cabeza	Uma.
cabuya	Paqpa.
cacto	Waraqu.
cada	Sapa.
cadáver, muerto	Aya.
cadera	Siki pata.
cagar, defecar	Akay.
caigua	Achuqcha.
cal, yeso	Isku.
calabaza	Lakawiti.
calabaza	Kalawasa.
calandria	Tuya.
calcular	Tantiyay.
caliente	Quñi.
callapa	Kallapa.
callo	Taqri.
callo	Chullpi.
calor	Rupay.
calvo	Paqla.
calzado	Suqru.
camarón	Yukra.
camellón	Wachu.
caminar, andar	Puriy.
camino, vía	Ñan.
camisa	Unku.
camote	Apichu.
canal, acequia	Yarqa.
canasta	Isanka.
cancha, tostado	Hamka.
cansarse	Pisipay.
cantar	Takiy.
canto gracioso, burlón y caricaturesco; fábula	Aranway.
canto quejumbroso, yaraví	Harawi, yarawi.
cantuta	Qantu.
caña de maíz	Wiru.
cañihua	Qañiwa.
cara	Uya.
caracol	Churu.
carbón	Killimsa.
cargar en brazos	Marqay.
carne	Aycha.
carrizo, caña hueca	Suqus.
casa	Wasi.
casarse	Kasarakuy.
cascabel	Chanrara.
cascada, caída de agua	Paqcha. Catarata.
cascajo	Ranra.
cáscara	Qara.
catarata	Paqcha.
catarro, gripe	Chulli.
catre	Kawitu.
caverna, cueva	Machay.
caya, oca deshidratada	Kaya.
cazar	Chakuy.
cebolla	Siwulla.
celaje	Anta.
celeste	Qusi.
ceniza	Uchpa.
cerca	Kaylla.
cerdo, chancho	Kuchi.
cereal crudo molido	Aqallpa.
cernícalo	Killinchu.
cernidor	Colador. Suysuna.
cernir, colar	Suysuy.
cerrar	Wichqay.
cerro	Urqu.
césped	Champa.
chachacoma	Chachas.
chacra de cultivo	Chakra.
chamiza	Chapra.
chancaca	Chankaka.
charango	Charanhu.
chicha	Aqa.
chochoca	Chuchuqa.
choclo	Chuqllu.
chuño blanco	Muraya.
chuño, tunta	Tunta.
chupe de chuño	Chayru.
cicatriz	Siratu.
ciego	Ñawsa.
cielo, firmamento	Hanay pacha.
ciempiés	Pachak chaki.
cien	Pachak.
cigarra	Qisqis.
cilindro, recipiente	Tuquru.
cintura	Wiqaw.
círculo	Muyu.
claridad	Akchi.
clarificar	Chuyayachiy.
cobarde, tímido	Llaklla.
cobre	Anta.
cocer cereales	Patay.
cocido	Chayasqa.
cocido a vapor	Pasi.
cocinar	Yanuy.
codo, ángulo	Kuchus.
codorniz	Yutu.
cojo	Wistu.
cola, rabo	Chupa.
collar	Wallqa.
color, pintura	Llimpi.
columpio	Wayllunku.
comadreja	Achuqalla.
combustible	Yanta.
comida, comer	Mikuy.
comprar	Rantiy.
comunidad, familia	Ayllu.
cóndor	Kuntur.
congelar, solidificarse	Tikayay.
congregarse, reunirse	Huñunakuy.
conjuntivitis	Wilkachuqa.
cono	Chuqu.
conocer	Riqsiy.
conocimiento, saber	Yachay.
contagiar	Ratay.
contaminación, suciedad	Qillichay.
contaminar	Qilliy.
contar	Yupay.
conversar	Rimay.
corazón	Sunqu.
cordel	Watu.
cordillera, puna	Sallqa.
cornetero	Waqra puku.
corona de flores	Pillu.
correr	Paway.
cortar papa en tajadas	Ikay.
cortar	Kuchuy.
cosechar alverjas, quinua, cañigua, kiwicha	Kallchay.
cosechar tubérculos	Allay.
coser	Siray.
costa	Chala.
crecer de una vez	Progreso. Wiñariy.
crecer, desarrollarse	Puturiy.
crecer	Wiñay.
creer	Iñiy.
crespo	Kuti.
cría	Uña.
criar ganado	Uyway.
cristal, vidrio	Qispi.
criticar	Pinqay.
crudo	Chawa.
cruz	Chakana.
cruzar, atravesar	Chakatay.
cruzar	Chimpay.
cubo	Machina.
cucaracha	Pallaysu.
cucharon de madera	Wislla.
cuello, pescuezo	Kunka.
cuento, narración	Willakuy.
cuernos, asta	Waqra.
cuero	Qara.
cuidar, guardar	Waqaychay.
culebra	Machaqway.
culpar, imputar	Tumpay.
cultivar, aporcar por primera vez	Hallmay.
cuña	Chillpa.
curandero	Hampikuq.
curar	Hampiy.
cuy	Quwi.
cuy macho	Kututu.
dar palmadas	Taqllay.
decir	Niy.
declamar, cantar	Harawiy.
dedo	Rukana.
delante	Ñawpaq.
delgado	Llañu.
dentro	Uku.
derecho	Alliq.
derecho	Paña.
desafilado, alga	Laqu.
desatar	Paskay.
describir	Sutinchay.
desgrana	Iskuy.
deshierbar	Quray.
desordenar, amasar	Chapuy.
despancar	Tipiy.
despedida especial en las fiestas	Kacharpariy.
despertar	Rikchay.
deteriorado	Pumpu.
deuda	Manu.
devolverse un favor mutuamente	Kutichinakuy.
día	Punchaw.
diafragma	Wisqan.
dialogar	Rimanakuy.
diarrea	Qicha.
diente	Kiru.
diez	Chunka.
dificilísimo, sobrecargado	Atiy-atiy.
dios tutelar	Apu.
dirigente	Umalliq.
disolver, remojar	Chulluy.
doblar	Pataray.
doler, dolor	Nanay.
donar, regalar	Llukiy.
dormir	Puñuy.
drama, comedia	Aranwa.
dulce, miel	Miski.
elástico duro	Anku.
emanar olor	Asnay.
embadurnar, untar	Llusiy.
embarazada	Unquq.
emborracharse	Machay.
emplastar	Qipichay.
empujar	Tanqay.
en vano, inútil	Yanqa.
enano	Umutu.
endeudarse, fiarse	Manukuy.
enemigo, adversario	Awqa.
enfermedad	Enfermarse. Unquy.
enfermedad venérea	Wanti.
enfermo	Unquq.
engañar	Pantachiy, yukay.
engendrar, procrear	Yumay.
enjuagar	Aywiy.
enojado, molesto	Piña.
ensartar, introducir	Ustuchiy.
enterrar	Pampay.
entonar triunfos	Haylliy.
entrar	Yaykuy.
envolver masa con hojas	Pintuy.
envolver, vendar	Wankiy.
epoca, tiempo	Mita.
equivocarse, errar	Pantay.
eriazo	Purun.
erizo	Askanku.
eructar	Kakyay.
escaldadura	Llilli.
escapar, huir	Ayqiy.
escapar, huir	Lluptiy.
escarabajo	Akatanqa.
escarbador	Kawsu.
escarbar	Allay.
escarmenar	Tisay.
escocer, dar comezón	Siqsiy.
escoger	Akllay.
escroto	Luqsu.
escribir	Qillqay.
escudo	Pullkanqa.
escuela	Yachay wasi.
esfera	Ruyru.
esforzar, fotalecer	Kallpachay.
espalda	Wasa.
espantapájaros	Manchachi.
esparcir cereales	Maqchiy.
esparcir	Wakay.
espejo	Lirpu.
esperanza	Saywa.
esperar	Suyay.
espina	Kichka.
esposo, marido	Qusa.
espuma	Pusuqu.
esquilar, cortar	Rutuy.
estaño	Yuraq titi.
este	Kay.
estera	Istira.
estiércol de ovinos, cabras y camélidos	Taqya.
estiércol extraído de corral, abono, desperdicio	Wanu.
estornudar	Hachiy.
estrecho	Kichki.
estrella	Quyllur.
estreñido	Aka kichki.
estrofa	Yarayma.
excremento	Aka.
exprimir	Qapiy.
extraviar	Chinkay.
falda	Palika.
feto, aborto	Sullu.
fiambre	Quqaw.
fiesta	Raymi.
fila, línea, dibujo	Siqi.
flamenco	Pariwana.
flauta de madera	Tarqa.
flauta	Pinkuyllu.
flecha	Wachi.
flor de maíz	Parwa.
flor	Sisa.
flor	Wayta.
flotar	Tuytuy.
fogón	Tullpa.
fontanela	Pukyun.
fortaleza	Pukara.
freír	Tiqtiy.
frente	Mati.
frente	Urku.
frijol	Purutu.
frío	Chiri.
frotar, sobar	Qaquy.
fruto de un cactus	Sankayu, wanachu.
fruto	Ruru.
fuerza	Kallpa.
fundar, crear	Paqarichiy.
gallina	Wallpa.
gallinazo	Ullatu.
gallo	Utulu.
ganar, vencer	Ipay.
ganso andino	Wallata.
garrapata	Amaku.
garrote, porra	Maqana.
garúa	Ipu.
garza	Waqar.
gaseoso, vaho	Wapsi.
gato montés	Usqu misi.
gato	Misi.
gavilán	Anka.
gaviota	Qiwlla.
gente, persona	Runa.
girar, dar vueltas	Muyuy.
golondrina	Wayanay.
golpear, pegar	Maqay.
gorrión	Pichiwsa.
gotear	Sutuy.
gramo	Aqnu.
grande, alto	Hatun.
grasa congelada	Tikayasqa.
grillo	Chilliku.
gritar	Qapariy.
grueso en objetos laminados	Rakta.
grueso	Raku.
grupo de cosas	Huñusqa.
grupo	Huñu.
guanaco	Wanaku.
guiar	Pusay.
guiñar los ojos con cólera	Qimchiy.
guiso picante	Llatan.
gusano	Kuru.
gusano	Uru.
habas sancochadas	Puspu.
habas	Hawas.
hacer adivinanza	Watuchiy.
hacer quesillo en forma de terrones	Kurpay.
hacer	Ruray.
hacha	Champi.
halcón	Waman.
hambre	Yarqay.
hambruna	Muchuy.
hambruna	Chiraw.
harina de cereal	Machka.
heces	Aka.
helada	Qasa.
herida, úlcera, llaga	Kiri.
hermana de la mujer	Ñaña.
hermana del varón	Pani.
hermano de la mujer	Turi.
hermano del varón	Wawqi.
hermosear	Achalay.
hermoso	Sumaq.
herramienta de labranza	Churuna.
herramienta para la urdimbre	Allwina.
hervir	Timpuy.
hielo, helada	Chullunku.
hierba, mala hierba	Qura.
hierba, pasto	Qiwa.
hierro	Qillay.
hígado	Kichpan.
hija del padre	Ususi.
hijo	Churi.
hijo menor	Sullka.
hilar	Puchkay.
hilo	Qaytu.
himno, canto triunfal	Haylli.
hinchado	Punkisqa.
hito	Saywa.
hombre rico, poderoso	Apu.
hombre	Qari.
hombro	Rikra.
hondonada	Pukru sqa.
horizonte, través	Kinray.
hormiga	Sisi.
horqueta	Tanka.
horrible, feo	Millay.
hoy, ahora	Kunan, kanan.
hoz, segadora	Rutuna.
huacatay silvestre	Chikchimpay.
huella	Yupi.
huérfano	Wakcha.
huevo	Runtu.
humear	Qusñiy.
humita	Huminta.
identificar	Kikinchay.
imaginarse	Rikchapakuy.
imperdible, prendedor	Tipana.
inca	Inka.
insípido	Qamya.
insultar	Kamiy.
inteligente	Umayuq.
ir	Riy.
isaño	Maswa.
izquierda	Lluqi, ichuq.
jaguar	Uturunku.
jardin	Muya.
jilguero	Chinqu.
jora para chicha	Wiñapu.
joroba, jorobado	Kurku.
joven varón	Maqta.
jugar	Pukllay.
juzgar, hacer justicia	Paqtachay.
labios	Wirpa.
labrar	Llaqllay.
ladera, pendiente	Qata.
ladera	Waqta.
ladrar, reprender	Anyay.
ladrón	Suwa.
lagarto, lagartija	Qaraywa.
lagarto, lagartija	Sukullukuy.
lago, laguna, estanque	Qucha.
lágrima, llanto	Wiqi.
lamer	Llaqway.
lana	Millwa.
langosta	Aqaruway.
lanzar	Chamqay.
lápiz, lapicero	Qillqana.
largo	Suni.
laringe	Tunquchi.
lavador de arcilla	Llata.
lavador de arcilla	Chapa.
lavarse la cara	Upakuy.
leche cuajada	Llukllu.
leche	Ñuñu.
lechuza, mochuelo	Pakpaka.
leer	Ñawinchay.
lejos	Karu.
lengua quechua	Qichwa.
lengua	Qallu.
leña	Yanta.
letra	Qillqa.
libélula	Kachi kachi.
libélula	Tisi tisi.
liberar, zafar	Qispiy.
libertad	Paqtachi.
libertador	Qispichiq.
libro, texto	Liwru.
libro	Qillqasqa maytu.
liendre	Chiya.
límite, lindero	Qayllan.
limpiar, pulir	Kituy.
limpio	Chuya.
linaje, casta	Panaka.
litro	Winku.
liviano	Sampa.
llama	Llama.
llamar, invocar	Qayakuy.
llanura, pampa	Pampa.
llenar	Huntay.
llevar con la mano	Aysay.
llevar	Apay.
llorar	Waqay.
lluvia	Para.
loma	Muqu.
lombriz	Lliwqa.
loro	Wiqru.
luciérnaga	Pinchikilla.
lucuma	Luqma.
luna	Killa.
luxación	Muqa.
luz	Akchi.
madeja	Kawa.
madre	Mama.
madurar, maduración	Puquy.
maguey	Chuchaw.
maíz	Sara.
malagüero	Chiki.
maloliente, apestoso	Asnaq.
manantial	Pukyu.
manco	Willu.
mandar, enviar	Kachay.
maní	Inchik.
manta para cargar o abrigar la espalda	Pullu.
manta	Lliklla.
mantilla de la cabeza	Chukulli.
mañana, día siguiente	Paqarin.
mareo	Uma muyu.
mariposa nocturna	Taparaku.
mariposa	Pillpintu.
mate, vasija	Mati.
mayor	Kuraq.
mazamorra	Api.
mediano	Taksaniraqlla.
medida	Putquy.
menos	Pisi.
menstruar	Kikuy.
mentira	Llulla.
menudo	Ñutu.
mercado, plaza	Qatu.
mes	Killa.
metal	Chuqi.
meter, echar dentro de algo	Hinay.
metro	Tatki.
mezclado	Chaqru.
miccionar	Ispay.
mil	Waranqa.
milano, dominico	Aqchi.
mirar, observar	Qaway.
mitad, medio, centro	Chawpi.
mochar, talar	Wituy.
moco	Ñuti.
moler	Kutay.
molestarse	Piñakuy.
molido	Kuta.
mono	Chipi.
montera	Muntira.
morado	Kulli.
morado	Sani.
morder, masticar	Kachuy.
morder	Kaniy.
morir	Wañuy.
mortero, moledor	Tunaw.
mosca	Chuspi.
moscón chupador de sangre	Tankayllu.
mote	Muti.
moteado	Chiqchi.
muchacha	Pasña.
mudo, sordomudo	Amu.
mujer escogida	Aklla.
mujer joven	Sipas.
mujer, esposa	Warmi.
murciélago	Masu.
muro	Pata, pirqa.
nacer, brotar	Paqariy.
nadar	Waytay, tuytuy.
naríz	Sinqa.
nariz de animales	Chuñu.
negro	Yana.
nevada	Lasta.
nevada	Riti.
nevar	Ritiy.
nido	Qista.
nido	Qisa.
nieto	Willka.
niño	Irqi.
nobleza, autoridad local	Qullana.
noche	Tuta.
nodriza	Amani.
nombre	Suti.
nube	Puyu.
nuca	Muchu.
nudo	Kipu.
nuera	Llumchuy.
ñato	Winti.
obedecer	Kasukuy.
objeto hecho de arcilla	Sañu.
oca	Uqa.
ocioso, flojo	Qilla.
odiar, aborrecer	Chiqniy.
ofrenda, ofrendar	Haywakuy.
oir	Uyariy.
ojos	Ñawi.
ojota	Siquy.
ojota	Llanki.
oler, olfatear	Muskiy.
olla	Manka.
olor	Asna.
ombligo	Pupu.
orden, grado	Ñiqi.
ordenar, normas	Kamachiy.
ordenar	Sinriy.
oreja, oído	Rinri.
órgano genital femenino	Raka.
orilla	Pata.
orina	Ispay.
oro	Quri.
ortiga	Itaña.
oso	Ukuku.
ovillar	Kururay.
ovillo	Kurur.
ovino	Chita.
ovino, oveja	Uwiha.
pachamanca	Watya.
padre	Tayta.
paja brava	Ichu.
paja brava	Iru.
paja	Ischu.
pájaro bobo	Waqana.
pájaro carpintero	Hakachu.
pájaro, ave	Pisqu.
pálido(a)	Aya.
palo	Kaspi.
paloma	Urpi.
palta	Palta.
paludismo, malaria	Chukchu.
pan	Tanta.
panca de maíz	Suqutu.
panecillo	Kispiñu.
panecillo	Puyllu.
pantalón	Wara.
pañal del bebé	Mitay.
papa deshidratada	Chuñu.
papa lisa	Olluco. Ulluku.
papagayo	Wakamayu.
papaya	Papaya.
papel	Página. Rapi.
paralítico	Suchu.
pared	Pirqa.
parir, dar a luz	Wachakuy.
parpadear	Qimchiy.
parte baja	Uray.
parte posterior	Qipa.
partir	Chitqay.
paso largo	Chankay.
paso	Tatki.
pastear	Michiy.
patada, puntapié	Hayta.
patear	Haytay.
pati, árbol quebradino	Pati.
pecado	Hucha.
pecar	Huchakuy.
pecho	Qasqu.
pedir	Mañay.
pedir	Uyllay.
pedo	Supi.
pedregal	Ranra ranra.
peinar	Ñaqchay.
peine	Ñaqcha.
pelar	Tipllay.
pellizcar	Chiptiy.
pelota	Haytana.
pene	Lani.
pene	Ullu.
penetrar, deslizarse	Ustuy.
pequeño	Taksa.
pequeño	Uchuy.
perdiz	Yutu, pisaq.
perdonar, olvidar	Pampachay.
perro	Allqu.
pesado	Llasaq.
pesar	Llasay.
pescar	Challway.
pestañas	Qichipra.
petrificado	Rumiyasqa.
pez	Challwa.
piar	Chilakyay.
picaflor	Qinti.
picar	Hayay.
pico	Churuna.
pico	Tuspa.
picotear una y otra vez	Tuspapayay.
picotear	Tuspay.
pie	Chaki.
piedra caliza	Llampu, isku rumi.
piedra preciosa	Umiña.
piedra	Rumi.
piel	Qara.
pierna, muslo	Chanka.
pintar, colorear	Llimpiy.
piojo	Usa.
pircar, edificar	Pirqay.
pisar	Saruy.
pito	Akakllu.
placenta, pares	Paris.
planta	Yura.
plata	Dinero. Qullqi.
plato de barro	Chuwa.
plomo (metal)	Titi.
plomo	Uqi.
pluma	Puru.
pobre	Wakcha.
poder	Atiy.
polilla	Puyu.
pollera	Pullira.
pollo	Chiwchi.
ponche	Punchi.
poncho	Punchu.
poner huevos	Runtuy.
poner	Churay.
poroso, liviano	Sapsa.
posadera	Siki.
prado, pradera	Waylla.
preparar carbón	Killimsay.
preparar un bulto	Qipichay.
primer corte de pelo	Rutuchiy.
primogénito	Piwi.
procrear, engendrar	Churiyay.
procrear, multiplicar, desarrollar, aumentar	Miray.
profesor	Yachachiq.
prohibir, impedir, vedar	Amatay.
propagarse fuego	Mismiy.
provincia	Suyucha.
pudrir, descomponerse	Ismuy.
pueblo	Llaqta.
puente	Chaka.
puerta, entrada	Punku.
pujar	Qamay.
pujar	Quqmay.
pulga	Piki.
pulmones	Surqan.
punzar, hincar	Istiy.
punzar	Tuksiy.
puñado	Hachi.
puño	Aptisqa maki.
puré de quinua	Pisqi.
pus	Qiya.
quemar	Kañay.
quena	Qina.
querer	Munay.
queso	Kisu.
quijada	Kakichu.
quinua	Kinwa.
quipo, cifra	Kipu.
quishuar (arbusto serrano)	Kiswar.
quitar los retoños	Kituy.
quitar, restar, sustraer	Qichuy.
escoger, seleccionar	Akllay.
raíz	Sapi.
rama	Kallma.
rana	Kayra.
rápido	Utqay.
ratón, pericote	Ukucha.
rebalsar	Tasnuy.
rebelarse, defenderse	Kutipakuy.
recibir	Chaskiy.
recipiente grande	Maqma.
reciprocidad	Ayni.
reclamar con fuerza, levantamiento	Huqarikuy.
recoger, levantar, alzar	Pallay.
recordar	Yuyay.
red	Kullancha.
red	Lluku.
reflexionar	Hamutay.
regar	Parquy.
región, territorio	Suyu.
reír	Asiy.
reloj, medidor del tiempo	Inti watana.
remar	Nadar. Tuyuy.
remojar	Nuyuchiy.
remolino de viento	Muyuq wayra.
remolino de viento	Tutur.
remover, batir	Qaywiy.
renacuajo	Uqullu.
repetitivo	Kuti.
reprender, resondrar	Qaqchay.
reproducir, procrear	Mirachiy.
resbaladizo, liso	Lluchka.
resbalar	Lluchkay.
resfrío	Chulli.
respirar, echar el aliento	Samay.
resucitar	Kawsariy.
retaceado, con flecos	Chillpi.
retener algo en la boca	Amuy.
retirarse	Suchuy.
reunir, juntar	Huñuy.
riñón	Rurun.
río	Mayu.
robar	Suway.
roca	Qaqa.
rociar agua	Maqchiy, chaqchuy.
rocío	Sulla.
rodar, tumbar	Kuchpay.
rodilla	Muqu.
rodilla	Qunquri.
roer	Kutkuy.
rojo	Puka.
romadizo, resfriado	Rumasiru.
romper, quebrar	Pakiy.
romper, rasgar	Llikiy.
romperse, rajarse, reventarse	Panchiy.
roncar	Qurquryay.
ropa	Pacha.
rosetas de maíz	Pasanqalla.
rosetas de maíz	Taqi sara.
roto, quebrado	Pakisqa.
roturar, barbechar, voltear la grama	Chakmay.
rubio	Paqu.
rueca	Puchka.
ruiseñor	Chiqullu.
sabio	Yachaq.
saborear	Malliy.
sacar agua	Wisiy.
sal	Kachi.
salado	Puchqu.
salitre	Qullpa.
saliva	Tuqay.
salta	Chintay.
saludar	Napakuy.
sangre	Yawar.
sapo	Hampatu.
sarampión	Ruru unquy.
sarna	Qaracha.
sartén	Tiqtina.
sebo, grasa	Wira.
seco	Chaki.
sed	Yakunayay.
selva	Yunka.
sembrar	Ruruy.
sembrar, siembra	Tarpuy.
semen	Yuma.
semilla	Muhu.
separar, apaciguar, defender	Amachay.
sequía	Chiraw.
ser mágico encantado	Illa.
ser o estar	Kay.
serpiente	Amaru.
servir comida, servir	Qaray.
seso, cerebro	Ñutqu.
silbar	Sukay.
simpa, trenzas	Simpa.
sobrar o guardar comida para alguien	Chanikuy.
sofocarse	Rupapakuy.
soga de paja	Qiswa.
soga	Waska.
sol	Inti.
solo	Sapalla.
sombra	Llantu.
sombrero	Chuku.
sombrero	Ruqu.
sonaja	Chilchi.
soñar	Musquy.
sopa	Chupi.
sopa de trigo	Patachi.
sopa	Lawa.
soplador	Pukuna.
soplar	Pukuy.
sorber	Suquy.
suave	Llampu.
subir, escalar	Qispiy.
subir	Siqay.
sucio	Qanra.
sudor	Humpi.
suelto	Waya.
sufrir, padecer	Usuy.
sumar o adicionar	Yapay.
suplicar	Mañakuy.
surco	Suka.
suspirar	Anchiy.
tacaño	Maqlla.
tacaño	Waqati.
tallar	Turpay.
tallo	Tunu.
tama, corral, cerco, canchón	Kancha.
tambor pequeño, tinya	Tinya.
tapadera	Kirpana.
tapar	Kirpay.
tarántula	Apasankay.
tarde	Chisi.
tarhui, chocho	Tarwi.
tartamudo	Hakllu.
techar	Wasichay.
tejer, urdir	Away.
telaraña	Llika.
tembla	Katatatay.
temer	Manchakuy.
tender	Mastay.
tendón	Anku.
tener esperanza	Suyapakuy.
teñir	Tullpuy.
terrón	Kurpa.
testículo	Quruta.
teta	Ñuñu.
tierno, verde (inmaduro)	Llullu.
tierra	Allpa.
tierra suelta	Qallpa.
tijeras	Tikras.
tiznado	Qichinchasqa.
tizne	Qichincha.
tobillo	Wichuchu.
tocar con la mano	Llapchay.
tonto, sordo	Upa.
torcaza	Kukuli.
torcaza	Ququtuwa.
torcer lana	Kawpuy.
tormenta	Tuyu.
toro	Turu.
torrentera, aluvión	Lluqlla.
tórtola	Kullku.
tortuga	Charapa.
tos	Uhu.
tostadera	Kallana.
tostar	Hamkay.
trabajar	Llamkay.
trabajo colectivo	Minka.
tragadero	Millpu.
tragar	Millpuy.
trama	Mini.
tráquea	Tunquri.
trazar una línea, dibujar	Siqiy.
trenzar	Simpay.
trepar	Lluqay.
trigo	Chaqipa.
trigo	Tirihu.
trillar	Iray.
tristeza	Llaki.
trocar, cambiar	Chalay.
troje	Pirwa.
trompeta de caracol	Pututu.
trompeta	Kurnita.
tronar	Wakriy.
tronco	Kullu.
tuerto	Chuqru.
tumbo	Tintin.
túnica de mujer	Aqsu.
turbio	Putka.
ulcera en los labios	Lliqti.
universo, tiempo, hora	Pacha.
uno(a), único(a)	Huk.
unu, agua	Yaku.
uña	Sillu.
urdidera	Allwina.
urinario, letrina	Ispana.
vaca	Waka.
vasija de calabaza o de mate	Putu.
vagina	Chupi, raka.
valle interandino	Qichwa.
valor, precio	Chanin.
variedad de lechuza	Chusiq.
vasija, cántaro	Chatu.
vaso incaico de madera	Qiru.
venado	Taruka.
venas	Sirka.
vencedor	Atipaq.
vencer, ganar	Atipay.
vender	Rantikuy.
veneno	Miyu.
venir	Hamuy.
venus	Chaska.
ver	Rikuy.
verdad, certeza	Chiqa.
verde	Qumir.
vesícula biliar	Hayaqnin.
vicuña	Wikuña.
vivir	Kawsay.
vizcacha	Wiskacha.
volar	Paway.
voltear	Tikray.
volumen	Winara.
volver	Kutiy.
yerbas aromáticas, condimentos	Asnapa.
yerno	Masa.
yuca	Yuka, rumu.
yunta	Yunta.
zampoña	Antara.
zancudo	Wanwa.
zarigüeya, muca	Qarachupa.
zarzaparrilla	Llaqi llaqi.
zorrino, zorrillo	Añas.
zorro	Atuq.
zorzal	Chiwaku.
