abadesa	Aware:sa.
abajo	Yańlo.
abajo	Ya'lo.
abeja	Chuydi.
abierto	Ra:kwa.
abierto a la fuerza	Wescho.
abiscocharse	(por ejemplo en el horno) Chatełni.
aborrecer	Donna.
aborrecerse	Jarachijni.
abrazar a alguien	Juła:ye.
abrazarlo a alguien	Jułna.
abrigarse	Chankocheł.
abrigo	Chanko.
abrir a la fuerza	Wesna.
abrir a la fuerza algo que no es para abrir	Wasa:cho.
abrir el monte	(buscando salida) Wesmo:łe.
abrir espacio	Tata:choł.
abrirse	Racho:cho.
abrir una puerta	Kelna.
abrir una puerta u otra cosa	Kele:łe.
absorber	Łowa:łe.
abuelo(a)	Nono'.
abusar de algo	Pakayewe:łe.
abusar de alguien	Paka:ye.
acabar algo	Bara:na.
acabar de morir	Chonte'.
acariciar a alguien	Siyełna.
acarrear sus trastes	Jaka:rim.
aceitarse el cuerpo	Chira:ti'i.
aceite de raya	Chavo'mes.
aceptar	Jaywane:łe.
aceptar a alguien	Jaywa:na.
aceptar una cosa que alguien le da a uno	Jaylopa:na.
acercar algo	Nałna.
acercarse	Nałcheł.
achacado	Kemme.
achachairú	Chakakayra.
aclarando el día	Jelewni.
acobardado	Ba:baycho.
acomodado	(por ejemplo una cama acomodada) Ajka:pa.
acomodar	Ajkapa:na.
acomodar algo	Aja:pa.
acomodar en fila	Samato:va.
acomodar la cama	Vi.
acomodarse	Ajkalowescheł.
acomodar una coas tras otra	Ajato:to.
acomodar un cuarto	Ikacho:na.
acompañante	Oylo.
acompañar	Oyloniłna.
aconsejar	Bokowe:łe.
aconsejarle a alguien	Boko:na.
acordarse	To'baycho.
acostado(a) de espalda	Kewwe.
acostado con alguien	Deyałe'a.
acostarse	De:cheł.
acostarse con alguien	Deya:łe.
acostarse con una mujer	Deyałechakwe:ya.
acostarse juntos	De:chijni.
acrecentar o multiplicar algo	Eyajna.
acrecentarse	Eyajni.
adelante	Naychi.
adentro de una casa	Daychoł.
adinerada	Baraya:na.
adivinar	Chona:ra.
adobe	Toto:kwa.
a dónde vas?	Joynan.
adornar	Silna.
adornarlo	Tije:na.
adornar sombrero	Tijeto:na.
adorno	Lowe:kwi.
adorno	Ti:je.
aeropuerto	Javuńwa:nas.
afanoso	Batejasra.
afilar	Wisna.
agacharse	Waldupiń.
agarrar	Ewna.
agazapado	Wadu:dul.
agonizando	Łowkate.
agotarse la munición	Ba:dineł.
agradecer a alguien	Solopayi:na.
agrandar algo	Mere'na.
agrio	Cha:soy.
agrío	Ra:pis.
agua	To:mi.
agua bendita	Chuswanmi.
agua caliente	Jo:jo:mi.
aguacil	(libélula) Su'pay.
agua clara	Ilimni.
agua con jabón	Jawo:mi.
agua donde hay pochi	Chichanramlo.
aguantar	Jara'cho:na.
aguantar algo	Ba:lomajna.
aguja	Modinła:ris.
agujón hecho de cuerno	Kojamutelwambes.
ahí	Nakal.
ahí	(visible) Nokode.
ahí	(más lejos) Nokolde.
ahijado(a)	Łi:ye.
ahogarse con agua	Se'mina.
ahogarse con algo espeso	Se'lo:na.
ahogarse con humo	Se'ru:na.
ahora	Kwey.
ahora	Kweyka.
ahora	Nokowa.
ahorrar	Italo:ba.
ahumado	Bujru:kwa.
ajena	So:tełe.
ají	Chi:ji.
ala	Tovaykwa.
alabarse	Vańkato:łe.
alacrán	Kuńsisi:wa.
alcanza	Manara'a.
alcanzar a alguien	Jowe:na.
alcanzar algo	Ya:sina'.
alcanzarle algo a alguien	Kwajna.
alcanzarlo a alguien o algo	Balowesna.
al centro	Terescho.
alcornoqui	(árbol) Ti:poł.
al día siguiente	Tawa'ni.
al disparate	Jekakara.
alegría	Bele'wa:nas.
alejarse	Kila:laj.
alejarse	Nandu'.
alejarse dos personas que ya no se quieren	Tańcho:łe.
alejarse dos personas que ya no se quieren	Uńcho:łe.
aleteo de las aves	Va:vayiń.
al final del día	Łuvuyni.
al frente	Alkawanłe.
algodonero	Bujdinmo:ri.
algo que infunde miedo	Tino'.
algo que no tiene cola	Tambojsi.
alguien que encabeza algo	Bakwanłe:kwa.
alguien que se inventa cosas	Vatasi:pa.
alguien que se mejora de una enfermedad	Ajkabaycho:ni.
algún día	Telayka:ka.
algunos	So:kate.
aliciado	Yełyełwanra:ni.
alimento	Ka:na.
alimento cocido al tiesto	Baybijełto.
alimento fresco hecho de masa de yuca	Tova'loł.
aliñar algo	Dili'na.
aliso	(árbol) No:ros.
alistado la lazada	Loycho.
alistar	Loye:na.
alistar algo	Loyna.
alistarse	Lo:ye.
allá	Nosde.
allegarse	(reflexivo) Jaylo:ba.
allegarse	Umcho:łe.
alma	Bawrawa:wa.
al medio	Terescho.
almendra	Chochołkwa.
almidón de yuca	Diveḿba.
almohada	Di'bakwa.
al momento	Po:raka.
alojamiento	Yełna.
a lo mejor	Joyka.
al otro lado	Alcho.
al otro lado del río	Aldi.
al revés	Jolkwa.
altivo	Jo'ka:toł.
alto	Ku:lo.
alto de estatura	Ku:des.
altura	Ku:lolo:ba.
alumbrar	Jele:łe.
alumbrar algo	Jelewna.
alumbrar algo	Jelna.
alumbrar con vela	Jela:ra.
alumno	Vańkapawanne.
alzar	Pe'na.
alzar	Sawe:łe.
alzar	Wayna.
alzar algo	Dajna.
alzar madera	Peka:vos.
amable	Si'way.
amanecer	Jelewni.
amanecer	Tawake:ni.
amanecerse en otra cosa	Tawa'tovałni.
amanecerse sin haber dormido	Jelewweni.
amansar un animal	Vata:poy.
amante	Oyye:ye.
amar	Kwajescha:ye.
amar a alguien	Kwajesna.
amargo	Se:se.
amarillear	Serejni.
amarillento	Serejawa:di.
amarillo	Se:rej.
amarrar	Jama:łe.
amarrar	Suḿna.
amarrar bien	Supa:ba.
amarrar con soga o huasca	Supa:łe.
amarrarlo	Jamna.
amarrar su jase	Suḿpi:łe.
amasar algo	Ni'na.
amasar algo hasta que tenga una forma redonda	Nika:ba.
amasar una masa	Yata:buń.
ambaibo	Wo'wo.
ambiente tranquilo	Daylo.
amigo	Alra.
amigo(a)	Albaycho.
amistarse	Umcho:łe.
amoldar	Pay'na.
amonestar	Juke:łe.
amonestar a alguien	Ju:na.
amontonado	Sońlo:ba.
amontonar	Sota'loba:na.
amor	Kwajeswa:nas.
ampolla	Voslo:łe.
ampollarse	Woslo:łe.
anaconda	Yana:we.
analizar	Para:na.
ancho	Powcho.
anciano	Anti:wo.
andar	Ilo:ni.
andar a pie	Ajłabał.
andar uno detrás de otro	Kankame:ni.
andar uno detrás de otro	Kweykaye:ni.
angosto	Tochi'cho.
anguila eléctrica	Ta'as.
anguila ordinaria	Bu:ray.
anidar	Ita:bał.
animal	Popoykwa.
animal con cría	Enałe:poy.
animal domestico	No:no.
animal enfermo	Terani:poy.
animal flaco	Beye:poy.
animal hembra	Kweyampoy.
animal macho	Toro:poy.
animal muerto	Kayni:poy.
animal preñado	Jimo:poy.
animarse a enfrentar	Mirińna.
ano	Chocho:res.
anoche	Alimeł.
anoche	Al'imeł.
anochecer	Łuvuyni.
anochecerse	Imaye:ni.
anta	O:ma.
antebrazo	Bakwanyiń.
antepasado	Anti:wo.
antes	La'.
antes del momento presente	Kwey.
antojarse	Che'che'e.
anunciarse	Loyrane:łe.
anzuelo	Ta'tuwanra.
añadir	Chajna.
añadir sal	Łoma'na.
añadirse	Chajpińcheł.
año	Tino:na'.
año nuevo	Polatino:na'.
apagar	Rosna.
apagarse	Rosros.
apareado	Alchi:ni.
aparecer de la nada	Vaḿvaḿ.
aparecer de repente	Tokela'ni.
aparecido	En'enra.
apartar	Sotajna.
apartar algo	Usna.
apartarlo	Kilajna.
apartarse	Uscheł.
aparte	So:taj.
apegado	Alu'.
apegar juntar	Alu'na.
apegarse	Alu'cheł.
apegarse	Nałcheł.
Apellido	Kem'eł.
Apellido	Ku:juy.
Apellido Almaquio	Alma:kilo.
Apellido Amblo	Ambolo.
apertura	Ta'cho.
aplastado	La:tos.
aplastar	(por ejemplo un objeto metálico) Soma:cho.
aplastarlo	Latosna.
aplaudir	Bopońcho:pa.
aporrearse	Bayvo:seł.
apoyado	Dilpoj.
apoyarse	Alpa:ni.
apretado	Sińcho:cho.
apretar	Romna.
apretar algo	Dila:cho.
apretar una masa	Yańna.
apretar y amasar	Roma:cho.
aprete!	Romti.
apuntar	Chuse:łe.
apurado	Po:ra.
apurarse	Dińka:ye.
aquello	Asko.
aquí	Ayru.
aquí	Ney.
aquí	(demostrativo) Neyru.
aquí presentes	I'ko.
araña	Si:wa.
arañar	Bite:łe.
árbol	Ko'o.
arco de flecha	Tani:lo.
arco iris	Ko'cha'.
arder	Ba'le:les.
arder fuego	Ve'e:ti'.
ardilla	Wa'way.
ardor	We:wew.
arena	Wi'wis.
arepa	Baybijełto.
arepa	Dere'to.
arisco	Sere:ra.
armar algo	Joya:ra.
aro	Mońlo:to.
arqueado(a)	Yampiń.
arrancar algo	Rałna.
arrancar algo de la raíz	Kota:ki.
arrastrarse	So:wasłe.
arrear	(por ejemplo el ganado) Neńna.
arrear animales	Neta:poy.
arreglado	Ajka:ra.
arreglado(a)	Ajkalo:wes.
arreglar a alguien	Ajkaye:na.
arreglar algo	Ajkara:na.
arreglarse	Ajkalowescheł.
arreglar un tejido	Kojele.
arreglos	Aja:pa.
arrepentirse	Choykabaycho.
arriba	A:riwa.
arriba	Ku:lo.
arrimado	Dilpoj.
arrocillar	Bay'na:na.
arrollar	(por ejemplo una estera) Puya:ba.
arrollar algo	Pila:cho.
arrollarse	Puyba:ba.
arroyo	Bijra.
arroyo	Wala:cho.
arroz	A:roso.
arrozal	Aroso:mo.
arroz calentado	Jo:jo:di.
arrugarse	Sulu:ni.
artículo demostrativo para personas	I:ri.
artículo plural para objetos y animales	Is.
artículo que sirve para enfatizar a la persona	Kaw.
asado	Is'isra.
asar carne	Isa:ra.
aseado	Ko'loj.
asentarse un pájaro	Pencheł.
aserrín	Larujkwa.
aserruchar algo	Jiłna.
aserruchar madera	Jiła:vos.
asesando	Jasjascho:na.
así	(indicando con la mano) Nokopa.
asiento	Aswa.
así es	E'a.
así es	Janwa.
así es	Jeya'a.
asolearse en un barranco	(por ejemplo un lagarto) Ilba:łe.
áspero	Chapujni.
asta	Chankwa.
asustarse	Teńcheł.
atajar	Kajłe:na.
atajar o parar a alguien	Taja:poy.
atajarse	Tajpo.
atajar va alguien en el camino	Kaja:łe.
atar	Suḿna.
atenido en si mismo	Jinne:cheł.
atizar	Ita:ba.
atragantado	Sińbi:ye.
atreverse animarse	Mirińchel.
atropellarlo	Wilna.
aujero ancho	Powcho:ra.
aullar del perro	Jawjawcho:na.
aumentar	Nayra:ni.
aumentar agua	Chama:mi.
aumentar algo	Chajna.
aún cuando	Wa:rey.
ausente	Kinos.
ausente	Kis.
ausente	Kos.
autoridad	Eno:na.
avansarle en una visita imprevista	Wachołra.
avanzar	Daydaywi'na.
avanzar	Nayra:kwi.
avanzar en un trabajo	Kilajwińni.
ave	Jo'me.
avecita de las playas	Jaywisełpammo.
ave de color ceniza	Tuvusmo.
ave de rapiña	Chi:ya.
ave hembra	Kweyammo.
ave que está empollando	Deyałe:mo.
a ver!	Ona.
ave rosada	Balosi:mo.
avestruz	Da'ra.
avisarle a alguien	Kena:pa.
avispa	O:mayle.
axila	Chovajdimpo.
axila	Chowiń.
ayudar	Alpa.
ayudar	Alpanełe.
ayudarse	Alkapanełe.
ayudarse	Alkapa:ni.
ayudarse	Alpa:ni.
azotar	Mase:łe.
azul	Su:vuj.
babearse	Ło'lokwa:kwa.
bacín	Chojwamba.
bagre	Sejdi.
bailador	Telo:pa.
bailar	Te:lo.
bajada del agua	Ovni.
bajarle el precio	Tatabalkwa:na.
bajarse	Tańba:łe.
bajío	Chisa:was.
bajo de estatura	Te:des.
bajó el agua	Osani.
bajo vientre	Pojsi.
balsamina	Cha'kałałba.
bandeado	Dońpiń.
bandurria	Taka'ya.
bañar a alguien o algo	Łaḿna.
bañarse	Łaḿłaḿ.
baño	Tori:na.
barato	Beyrimeł.
barbecho	Bo'chonamo.
barnizar	Rińna.
barquinear	Teńka:ba.
barranco	Łavałkwa.
barredora	Pulacho:pa.
barrer adentro	Pula:cho.
barriga	Chodo:wi.
barro	Bubuńkwa.
bastón	Cha'pa.
basura	Mova:kwa.
basura que queda de la caña	Bawankwa.
basurear	Pula:mo.
batan	Asłe:du'.
batan	Du'na.
batir	Tawna.
batir algo	Chawna.
batir o mermar	Wasna.
bato	Wusu:wu'.
bautizar	Bań'ełe.
bautizar	Ruḿchimpa.
bebé	Tami:ba.
bebedor	Ya:lowe:pa.
beber algo líquido	Toromna.
beber con gusto	Ma'neskalo:cho.
bejucal	Wawankwammo.
bejuco	Wawankwa.
bello	Chamu:yas.
bello en la parte genital de la mujer	Chuskaba:ba.
bello en la parte genital del varón	Chuskalo:ri.
belludo	Chamu:yas.
bendecido	Dachis'i.
besar a alguien	Puruńna.
besarse	Puruńcheł.
besarse	Puruńłe.
bibosi	(árbol) Si:lim.
bien arrimado para no caerse	Di:re.
bien seguro	Jolo:wes.
bigotes	Chuskachuskwa.
bizquear	Walaychidus.
blanco	Ta:voj.
blandeado	Lede'ni.
blandito	Sibo'ni.
blando	Jusawni.
blando	La:wiń.
blando	Lawińni.
blando	La:wiń.
blando	Lawińni.
blanquear	Wisna.
boca	Kwan'i.
boca arriba o mirar hacia arriba	Cha'kwa.
bocio	Woro'ba.
bocón	Ełkwa.
boda	Nayewa:nas.
bofe	Wasojmo.
bola o pasta de jabón	Jawo:ba.
bolsa	Mari:ko.
bolsa pequeña	Mariko:ba.
bolsillo	Worsi:ko.
bolsita	Mariko:ba.
bombo	Pono:na.
bonito	Ja:yaw.
bonito	Ji:ran.
bonito	Jiranni.
boquiabierto	Lemlemkwa:ni.
borde	Łała:kwa.
borochi	Tuya:wa.
borrachera	Layakwanwa:nas.
borrachera	Layakwanwa:nas.
borrar	Rosna.
borrarse	Rosros.
bosque	Chaḿmo.
bosta	Chi'i.
bosta del chulipi	Modońchi:ya.
bosta de pez	Cha:yał.
bosta de pez molida y cernida	Chayałvas.
bostezar	Jalaykwa.
botar algo	Jara'na.
botarlo de su casa o de un lugar	Jara'chołna.
botarlo en el monte	Jara'mołna.
botón	Woto:ne.
boyé	Waybuswa.
brasa	Dela:kwa.
brazo	Bo:sa.
brazos cruzados	Jamnba:yiń.
bregar	Batejni.
brincar	Descheł.
brincotear cuando se baila	Deskalo:boj.
bromear	Kawasłe.
brotar	Paḿpaḿ.
brujo	Ukwampa.
buche del ave	Bajasła.
bueno	Do:koy.
bueno	Ja:yaw.
bueno	Si'way.
buey	We:ye.
bufeo	Paj'i.
búho	Ełkwammo.
burbujear	Chisisi'.
buscar algo	Salna.
buscar mujer	Salakwe:ya.
buscar piojos	Damna.
caballito	Kawayo:di.
caballo	Kawa:yo.
cabello	Risa:kwa.
cabello espeso	Duḿmo.
cabello fino	La:mis.
cabello suelto	Mańchori:sa.
cabeza	Bakwa:kwa.
cabeza de pelo blanco	Tavojba:kwa.
cabeza dura	Dińchoba:kwa.
cabeza redonda	Japilba:kwa.
cabezaseca	(ave) Laya:ta.
cabezaseca	(ave) Laya:ta.
cabo	Banełkwa.
cabo o mango de un hacha	Pitełkwi.
cacaré	(ave) Charcha.
cachete	Kwinto.
cachete de vaca	(pedazo de carne) Kwinto:kwa.
cachorrito	Chu:chu.
cada rato	Jemes.
cadáver de animal en descomposición	Dońpoyni.
cada vez	Choń.
cada vez	Jaya'na.
cadera	Mosikwa:kwa.
caer de bruce	Va'kwa.
caerse de arriba	Tańvo:seł.
caerse de estar parado	Ło'ło'.
café	Ka:pe.
café preparado	Kape:lo.
caja de fósforo	Pajwela:moł.
cajón	Amka:rim.
cajón	Kajo:ne.
cala de cusi	Wajle:di.
calentar agua	Jo:mi:na.
calentar algo	Jo:na.
calentarse en el fuego	Jo:we.
calentarse la cabeza	Joba:kwa.
caliente	Kwajles.
callarse	Kwale:łe.
callarse	Wayasłe.
calle	Chora:da.
calle de uno	Choradaneł.
calmar el dolor	Ajtivijni.
calmarse	Tajpo.
calor	E:wel.
calor agradable al cuerpo	Buwa'ni.
calucha	Chochołkwa.
calumniado	Kemme.
caluroso	Ewelni.
caluroso	Tayo:ka.
calvo	Tosba:kwa.
camarada de armas	Allo:ba.
cambiado de lado	Volto.
cambiado de ropa	Boń'ojeł.
cambiar	Bawra:na.
cambiar apariencia	Volrada.
cambiar de dirección	Vola:kwa.
cambiar de idea	Volbaycho.
cambiar de lugar	Bo'wa:wa.
cambiarlo	Bońra:na.
cambiarlo de base	Vola:to.
cambiar los caballos	Bońpoyna.
cambiarse de ropa	Boń'ojełe.
caminar	Ilo:ni.
caminar bien	Jayawlo:wes.
caminar de noche	Aj'imeł.
caminar de noche	Iloni'imma.
caminar lento	Jiballo:wes.
camote	Jala:la'.
camote	Walu:sa.
canasta de asiento tejido	Samresmo.
canasta de cogollo de motacú que se empieza a tejer del asiento	Jolteresmo.
canasta que tejen los collas	Dawanmo.
canastas bolsa	Amka:rim.
canción	Lewwansi.
cangrejo	Da:ka.
caníbal	Kayajuyeni:pa.
canilla	Riskwi.
canilla	Ris'i.
canoa	Chonveni:wa.
canoa	Ju:ve.
cansado(a)	Yamu:muj.
cantar	Lewlew.
cantar por cantar	Lewka'asna.
cantor	Lewpa.
caña de azúcar	Chara:ye.
cañería	Tute:kwa.
cañuela	Dodomba.
cañuelar	Dodombammo.
capibara	Ni:yo.
cara	Mo:ra.
carachupa	Pusa:ra.
caracol	Wa:wa.
caracoré	Sur'suru'.
cara de manechi	Judimmo:ra.
caramba!	Tojeł.
carau	A:ray.
carbonizado	Ba:cho:kwi.
carcaña	(ave) Taru:ba.
carcoma	Tono:ko.
cardenal	(ave) Chuwi:sa.
cargado en espalda	Bańdu'u.
cargar algo en la mano	Łi:na.
caricari	Koti:ti.
caricarisal	Kotitimmo.
carne	Wa:kato:da.
carnear	Wa:ka:ti'.
carnearse	Wa:ka:ni.
carne asada	Is'isra.
carne calentada	Jo:jo:ra.
carne cruda	Nu:ra.
carne de anta	Ornato:da.
carne de mono	Sidojra.
carne frita	Deńchołra.
carne por demás de flaca	Daminni.
carne sancochada	Dejdejra.
caro	Dińrimeł.
carpir	Waje:łe.
carpir	Wajna.
carpir	Wa'waj.
carpir un pajonal	Waja:mo.
carretón	Kare:ta.
casa	Asna.
casa	Ro:ya.
casa con techo de paja	Dimasdi.
casa de juego	Kuynana'wandi.
casa embarrada	Payłava:di.
casa pequeña	Roya:di.
casarse	Na:ye.
casa vieja	Meme:di.
cascabel	Tintimba.
cascajal	Champandi.
cascara de curupaú	Małaḿbeń.
cascara de la fruta	Tobeńkwa.
cascara del árbol	Tobeńkwa.
cascara de paquió	Vosimbeń.
cascara que usaban como vestimenta los nativos	Bocho:mo.
casi	Me:kaka.
casi	Tela.
casra del alcornoqui	Tipołbeń.
castellano	Kaste.
castigados juntos	Alwitełni.
castigar a alguien con crueldad	Łavora:na.
castigar con azotes	Mase:łe.
casuela de barro cocido	Chapa:ye.
Cáumol	(apellido) Kawmoł.
cavar	Wońna.
cavar	Wote:łe.
Cayalo	(apellido) Kaya:lu.
cayú	Talumba.
Cayú	(apellido) Kayu'.
cazador de teitetú	Kayotimpa.
cazar	Ba:yeł.
cebo	Se:wo.
cebo de la panza	Chokwammowo'wo.
cebo de la tripa	Chiraskwanwo'wo.
ceboro	Da:ka.
cedrillo	(árbol) Kwałna.
cedro	Mapo:no.
ceja	Balra.
celar	Keraaye:łe.
cementerio	Kayniwandi.
ceniza	Ve'e:vus.
centro	Terescho:ma.
cepe	Toka:da.
cepillar un objeto de madera	Kołna.
cera	Chuydimba.
cerco	Cha'di.
cerco	Cha'ves.
cerco cerrado	Vi'cho.
cerdo	Ko:chi.
cerebro	Dinełbakwa.
cerebro	Popojmo.
cernidor hecho de junco	Kona:le.
cernir algo	Korojna.
cerrar	Po'na.
cerrar con llaves	Tu'na.
cerro con piedras	Champammo.
cesta de boca pequeña	Parukwammo.
chaaco	(árbol) Kisa'.
chacarero	Bayłimpa.
chaco	Bayłim.
chaco	Bayłinwa:nas.
chaco entero	Pe'łim.
chaicita	Tolo:do.
Chaima	(apellido) Chayi:ma.
chala	Bovijkwa.
chala de arroz	Momołkwa.
chala de maíz	Vobijkwa.
chamuscar	Vusna.
chamuscarse	Vusłe.
chapapa	Pi'chis.
chaparral	Toto:mo.
chaqueado	Bayłinwa:nas.
charlar	Alwa:ni.
charque	Charki.
Chayava	(apellido) Chaya:wa.
Chelebo	(apellido) Chele:bo.
Chicaba	(apellido) Chika:wa.
chicha	Po'so.
chicha de camote	Jalala'so.
chicha de manga	Manka:so.
chichapí	Jollej.
chichapisal	Jollejmo.
chilchear	Ridisti'.
chillidos estridentes por todas partes	Alasełni.
Chimani	(apellido) Chirima:ni.
chisme	Aja:ra.
chismoso	Ajasi:pa.
chispa de fuego	Tamunles.
chiste	Josiwanra:ni.
chistear	Kawasłe.
chive	Mo'incho.
chive con agua	Boyboylo.
chive dulce	Tadoycho.
chive fino	Vuku:cho.
chive negro	Tuncho.
chive simple	Tova'cho.
choclo	Dochi'ta'.
choco	Wa:yo.
chocolate	Chukula:te.
Cholima	(apellido) Choli:ma.
chonono	Tintimba.
chonono de cascabel	Sojolwampa.
choquisuela	Beranchinamo:kwa.
Chori	(apellido) Cho:ri.
Chormini	(apellido) Chorni:ni.
chuchial	Arandimmo.
chuchio	Arandi.
chulupi	Mo:doń.
chupacoto	Karawa:chi.
chupar	Nonnon.
chupar algo	Chulumna.
chupar caña	Doya:as.
churuno	Ołneł.
churuno	Takasba.
chuto	Tambojsi.
chuvi	Chi:ya.
ciego	Lolcho:ra.
cielo	Beńra.
cien pies	Chavo'łełewmo.
ciervo	Dawjes.
cigarrillo	Seka:ru.
cigüeña	Wapayto'.
cintura	Kwikwi:kwi.
cinturón	Suḿka:piń.
cipío	(avecilla) Chabo:na.
clara de huevo	Soko:koń.
claro	Choyrey.
claro	Je:lew.
clavícula	Vi'chi.
cobarde	Tino'si.
cobrar algo	Daja:cho.
cocer al fuego	Lovełna.
cocer algo en agua	Dejna.
cocinar	Deja:jal.
codiciar a alguien por algo	Koyi'na.
codo	Ba:ruń.
coger	Ba'na.
coger algo	Ewna.
coger arroz	Tanaro:so.
coger con la mano una fruta	Lo:na.
coger frutas	Baka:ba.
coger frutas	Baka:łe.
coger un animal	Ewa:poy.
cogido por la noche	Imaye:ni.
cogollo	Teteykwa.
cojeando	Teskadi:wa.
cojear	Tescheł.
cojonudo	Molojoła'a.
cojudo	Molojoła'a.
cola	Bałewkwa.
cola arrancada	Pujłew.
cola de mono	Sidojłew.
colar	Tejna.
colcha	Chanko.
coleccionar	Italo:ba.
colgar	(por ejemplo en un gancho) Oła:łe.
colgar algo en un lugar	Lemna.
collar	Nowe:di.
colocarlo en su lugar	Chonajna.
colocar pluma de ave	Batamuń.
color	Lowe.
colorado	Ra:pal.
color anaranjado	Donlowe.
color pardo de las aves	Dońlosi:mo.
columna	Lelejdu'.
comadreja	Podota:wa.
comedirse	Alkapanełe.
comegente	Kayajuyeni:pa.
comenzar	Ba'wiń.
comenzar a hacer algo	Penwiń.
comenzar a trabajar	Pentej.
come plátano	(especie de loro) Kusała.
comer	Kaykay.
comer algo	Joma:ni.
comer con jacuú	Sekemna.
comer después de estar hambriento	Ya'muj.
comer juntos	Albu:ni.
cometierra	Kayałaba:pa.
comida	Ka:na.
comida	Kaywanra.
comida calentada	Jo:jo:loł.
comida de arroz	Aroso:lol.
comida de frijol	Madonloł.
comida de gualusa	Butułloł.
comida de maíz	Kwajta'loł.
como	O:be.
cómo estas?	Aya.
como me hacen a mí	Jene:neł.
cómo te llamas?	Ełełan.
compañera	Alkwe:ya.
compañero	Allo:ba.
compañero(a) de castigo	Alwiteł.
compañero de farra	Allo:cho.
compañero de ocio	Almaro:ni.
compañero de una acción	Allo:maj.
completar	Bara:na.
completar algo	Ba:ełna.
componer	Ajkara:na.
componerse	Inlowesni.
componerse	Połkabaycho.
comprarlo	Rímenla.
conal	Kona:le.
con buena puntería	Bisi'ne.
concho del agua u otro liquido	Chochokwankwa.
concluido	Ba:lomaj.
concluir algo	Joyalo:maj.
con cuidado	Jayawka:pa.
cóndor	Talota:lo.
con dos días	Oyyemeskwy.
conejo	Ba:tus.
confesarse	Kepanascheł.
confiar	Jaykwani.
confiar en alguien	Jina:ye.
con fiebre	Romo:moy.
con la cabeza agachada	Walaychi.
con la cabeza levantada	De'de'bakwa:ni.
con la nariz tapada	Sińchi.
con los ojos cerrados	Mi:ra.
con más ahínco	Dińtejna.
con más fuerza	Dińtejna.
conocer algo	(en sentido abstracto) Onalowesna.
conocer la actitud de otra persona	Onalomajna.
conocer su propia actitud	Onalomajcheł.
conocer una cosa	Onara:na.
conocer un lugar	Onawajna.
conocimiento	Paku'wa:nas.
con olor a osamenta	Beyesni.
con pena inquieto	Onka:ye.
con piernas desnudas	Banal:ri.
con quien converso	Alwa.
conseguir	Ba'kwi.
contador	Pakełpa.
contador	Pakełpanne.
contagiar	(por ejemplo una enfermedad) Ińna.
contagiar	Ite:łe.
contar	Ajalo:maj.
contar	Pake:łe.
contar	Pa'na.
contar de si mismo	Ajlomajcheł.
contar de su sueño	Ajsi:kwa.
contar la historia de uno	Ajlomajcheł.
contar los días	Pakaye:mes.
contar narrara relatar algo	Aja:ra.
contemplar	Para:na.
contemplar	Velna.
contestar	Chaywa.
contestar	Chaywanełe.
con vergüenza	Chajani:wa.
conversación ó forma de conversar	Alwaniwa:nas.
conversar	Alwa:ni.
con voz vibrante	Telemsineł.
coñera	Chojlolo:muy.
copa de un sombrero	Bakwaneła'a.
coquinal	Katenammo.
coquineño	Katenammomajye.
coquino	(árbol) Kate:na.
corazón	Jasła.
corazón fuera del cuerpo	Jasławanra:kwi.
corazón humano	Jasławanra.
corcho	(árbol) Pujła:vos.
cornamento de ciervo	Chanjes.
corona	(por ejemplo de la casa) Chimpa.
corona	Toro'chimpa.
corral	Wa:kawandi.
correa	Wa:ka:di.
corredor	Dińtokwi.
corredor o acera	To:piń.
correr	Ja:yi.
correr con alguien o con algo	Jayiłe:na.
corresponder	Bawpa:na.
corretearle	Kweyasełna.
corriente de agua	Sa:vaw.
corriente fuerte de un río	Dińvaw.
cortado por medio	Tampiń.
cortar	Tane:łe.
cortar	Tanna.
cortar algo con un machete	Dasna.
cortar distancia del río por el canal	Mana:pil.
cortar granos	(por ejemplo arroz) Tana:di.
cortar por lamitad	Tana:piń.
cortés	Si'way.
corto	Te:ra.
corva	Kwana:mo.
cosa fina	Lamisni.
cosa para reírse	Josiwanra.
cosa que hace dar vergüenza	Chajampojni:ra.
cosas para jugar	Ji:sawanrani.
cosechar	Baka:ba.
cosechar con la mano	(por ejemplo una fruta de un árbol) Ba'na.
cosechar granos	Chata:di.
cosechar maíz	Chata:mo.
coser	Sińna.
cosera	Chu:kul.
cosorió	(árbol) Saka'la.
costilla	Vebeskwa.
costurar	Sińna.
costurar el dobles de una vestimenta	Puyna.
costurarle la ropa a alguien	Sita'o:jeł.
costurar ropa	Sita'oj.
cotiví	Cho:cho.
coto	Ełworo:ba.
coto	Woro'ba.
covacha	Kowa:cha.
creación	Nalomajwa:nas.
crear	Vańna.
crecer	Bijawni.
crecer	Mere'ni.
crece rápido y ligero	Aykapa.
crecimiento del agua	Cheslo.
creerle	Wawasinapojna.
crespo	Mu'lu.
cresta	Burankwi.
criarse	Bijawni.
criatura	Tami:ba.
cristalino	I:lim.
criticar	Donkara:na.
crucificado	Bańsuneł.
crudo sin cocer	Molra.
cuajo	(ave) Joko'.
cuajo	(ave) Kwa'i.
cuándo?	Ełlomaj.
cuando tiembla una cosa que está plantada en el suelo por el viento	Liki:kiń.
cuando tocan las dos de la tarde	Tarawanno.
cuánto cuesta?	Jankarimeła'a.
cuánto son? ¿cuánto hay?	Jankara'is.
cuatro	Oyka:ra.
cubrí	Pakałe.
cuchara	Kucha:ra.
cuchara	Sawła.
cucharon de tutuma conocido como matato	Do'la.
cuchichear	Ława'cheł.
cuchillito	Kachirampiń.
cuchillo	Kachi:ra.
cuco o cigarra	Riri:ya.
cuco o cigarra	Yariya:ri.
cuello de los dedos	Chovajdimpo.
cuello de una prenda de estir	Woro:keł.
cuentero	Ajasi:pa.
cuento narración	Ajarawa:nas.
cuerno	Chankwa.
cuero	Bebeńkwa.
cuero de capibara	Niyo:beń.
cuero de gato montés	Chuyuwambeń.
cuerpo	Loba:ba.
cuerpo grueso	Powlo:ba.
cuervo margullón	Chosdi.
cueva	Siłkwa.
cueva	Wala:si.
cuidado	Cho:ne.
cuidar	Velna.
cuidar un sembradío	Ayaye:na.
cumplir año	Imtinonake:łe.
cuñada	Chejta.
cuñado	Kweńtuj.
cura	Pa:'i.
curandero	Lawajeschaye:pa.
curandero	Lawajeschaye:pa.
curi	Kavosdi.
curiche	Jaya:cho.
curichi fangoso	Betełkwa.
curichón	Jayacho:mo.
curucusí o luciérnaga	Deta:di.
curupaú	(árbol) Małaḿ.
cusi	Wajle.
cusisal	Wajle:mo.
cuyabo	Baw'i.
da lastima	Beyka.
da rabia	Jalayni.
dar a luz o parir	Tami:ti'.
dar ánimo	Use:łe.
dar campo	Tata:choł.
dar consejo	Bokowe:łe.
dare cuenta	Onabaycho.
dar en el blanco	Bisi'na.
dar instrucciones	Vatalo:maj.
darle algo	Kaya:łe.
darle crédito	Wawasinapojna.
darle de chupar	Nona:poj.
darle de comer a alguien	Kaya:poj.
darle el pecho	Nona:ye.
darle el pecho al bebé	Nona:poj.
darle huasca	Masna.
darle la forma a algo redondo	(por ejemplo hacer tinaja) Paya:ba.
darle la vuelta a algo	Dapilna.
dar media vuelta	Volkwa.
dar nombre	Bań'ełe.
dar nombre	Kema:'eł.
dar paliza a alguien	Baya:ye.
dar paso	Dowajdes.
dar patadas	Łeke:łe.
darse a la fuga	Jay'asłe.
darse la mano	Tolacho:pa.
darse la vuelta con todo el cuerpo	Sapilcho:ni.
darse por vencido	Kwaybaycho.
dar vuelta por algo	Japa:łe.
dar vuelta por algo redondo	Japilna.
dar vuelta por la plaza	Japalo:los.
dar vueltas alrededor de algo	Jaḿkałe:na.
dar vueltas por algo	Jula:łe.
de adrede	Kwajrada:ni.
de a poquito	Beyka:ra.
debajo de algo	Dayko.
debajo de algo	Deyko.
debajo de un mueble	Chodo:wi.
de buenas ideas	Jirankabaycho.
de buen tamaño	Manne.
decente	Si'way.
decir	Jankwa.
decir la verdad	Chona:ra.
decir la verdad	Wawasi:na.
decirle a alguien lo que tiene que hacer	Kemalo:maj.
de color bonito	Jiranlo:we.
de conducta intachable	Wa:yes.
dedo de las manos	Dimpa.
dedo del pie	Dimpoj.
de donde se viene	Jeyna.
de este tamaño	Ya:desna.
defecar	Momo:kwa.
defecar sangre	Momodonna.
defecarse	Momo:cheł.
defender algo	Bore:na.
degollado	Da'tu.
degollar	Daka:tu.
degollarse	Da'tucheł.
dejá!	Chu'.
déjalo	Cheła'a.
déjame	Ka'cheł.
deja! ¡no!	Ka'.
dejar atrás	Ela:na.
dejar de existir	Ya:loma:maj.
dejar en el monte	Daya:moł.
dejar fermentar una masa o un barro	Daya:buń.
dejarle hacer algo a alguien	Ka'pojcheł.
dejar o asentar una cosa en el suelo	Daykara:na.
dejar pasar el agua	Chilo:lo.
de la misma altura	Imkalo:ni.
de la misma edad	Imbaycho.
de la misma fuerza	Imkakatejni.
de la misma idea	Imkabaycho:ni.
delante	Bura:da.
delgado	(por ejemplo una tela) So:roy.
delito	Ko:vij.
del medio de la madera incorruptible	Terescho:ma.
del mismo precio	Imkarimełni.
del otro lado	Aldimmajye.
de mala calidad	Jeysi.
de mañana	Ima:yoj.
de nada	Manra.
de noche	Imayni.
dentro de la casa	Roya:cho.
denunciar	Kema:si.
denunciar algo	Dita:toł.
de otra forma	Sońlo:wes.
de otra persona	So:tełe.
de parado	Ena'.
de paso	Pajas.
de pocas palabras	Beysineł.
de preocuparse	Rujałni:ra.
de primero	Naykachin.
derecho	Bo:łoḿ.
de repente	Bu'karani.
de repente	Ji:nana'.
de rodillas	Enchina:mo.
derramado	Jopa'si.
derretirse	Mańlo:lo.
desangrarse	Ba:do:don.
desaparecer	Ba:kaloma:maj.
desaparecer	Dayima'ni.
desatar	Mańna.
desatarse	Mańłe:łe.
desayuno	Ya'muj.
desbaratado	Raka:ba.
desbarrancar	Ło'cho:cho.
descansar	Ajtejni.
descendencia	Jeyłe.
descocer algo	Matadineł.
descocer algo	Raładineł.
descocerse	Rałdinełe.
descolgado	Lemłe:łe.
descolgar una cosa	Lemlem.
descolorizarse	Ba:lowe:we.
descomponer	(por ejemplo cuando uno se quiebra un hueso) Daku:kul.
descompuesto	Dońra:ni.
desecharse	Ralcheł.
desgajado	Jescho:pa.
desgajar	Jesacho:pa.
desgajar	Latato'lej.
desgajarse	Jeschopa:pa.
desgranar	Mułna.
deshacer algo	Ba:kalomajna.
deshacerse	Ba:kaloma:maj.
deshecho	Raka:ba.
deshierbar	Wajna.
deshojar maíz	Bisa:choł.
desmayarse	Sońte'.
desmontar	Dasa:mo.
desmontar de un animal	Łoḿpoye:łe.
desmoronarlo	Loka:cho.
desnudo	Banne.
despachar a alguien	Jopa:ye.
despachar a varias personas	Joḿkaye:na.
despacio	Ji:bal.
desparramar algo	Rakamocho:na.
desparramarlo	Tamolna.
desparramarse	Mu:masłe.
despedir gas	Rosońkwa.
despejado	(por ejemplo un patio sin árboles) Bancho.
despertador	Tarawamba:ni.
despertar	Ta:ra.
despertarle a alguien	Tama:ye.
despintarse	Ba:lowe:we.
desplumar ave	Puła:mo.
desportillarse	Kańcho:cho.
desportillarse	Kili:liń.
despreciar	Donna.
despreciar	Nanalopa:nas.
desprender algo	Besa:choł.
desprender algo	Besa:łe.
desprenderlo	Besna.
desprenderse	Bescho:łe.
desprenderse	Lo'łe:łe.
desprendido	(por ejemplo una calucha de su cascara) Toschoł.
después	Jayłe.
desquitar	Bawpane:łe.
desquitar algo	Bońcho:na.
destapada la apertura de un recipiente	Kelwa.
destripar	Kola:cho.
desviar la mirada	Noyka:kwa.
de tiempo pasado	Isos.
de toda clase	O:kaka:ra.
detrás de mi cadera	Mosi:si.
de una manera u otra	O'okakawiłna.
de verdad	Choy.
de verdad	Kwajradan.
devolver algo	Chonajna.
devolver un favor	Bawlomajwa.
día	Je:mes.
día del festejo	Chonlo:wes.
día lluvioso	Jemeslu'.
dialogo	Alwa.
dicen	Dela'wa.
diente	Soyła.
dientes limados	Tajła.
difícil	Ba:lomajna.
difícil	Batejasra.
difunto	Kayni.
digno de lastima	Łavo:ni.
dinero	Pola:ta.
discutir	Ba:kawanne:cheł.
disparar con un arma de fuego	Manna.
disparar un tiro	Ma:ni.
distraerse	O:kabaycho.
distraerse a pesar de estar triste	Połkabaycho.
dividido en dos	Alcho:ni.
dizque	Dela'wa.
dizque	Łań.
doblado(a)	Yampiń.
doblar	Yana:ba.
doblés	Łała:kwa.
Dolea	(apellido) Dole:ya.
dolencia enfermedad	Ti:vij.
doler	Tivijni.
doloroso	Diteswiń.
domingo	Lomi:ko.
dominguera	Lomito:ti'.
dónde?	Naya'.
donde el cielo se pinta mañana y tarde	Jela:ba.
dónde es el lugar?	Janwaja'a.
donde sale el sol	Jata'.
donde se junta el fuego	Do:ki.
donde uno duerme	Joro:na.
donde voy	Nenkwa:na.
donde voy	Nenna.
dormilón	Jorojorowamba.
dormir	Jo:ro.
dos	Oyra.
dos chorros	Oycho.
dos personas	O:ye.
dos personas de color	Altu:ne.
dos personas ociosas	Almaro:ni.
dueño	Kaw ninła.
dulce	Ta:doy.
duro	Dińra.
duro	Kurumna.
duro	(de carne) Tachołni.
duro	(de yuca) Tachołpa.
duro como la goma	Danuyni.
echar agua	Yeła:mi.
echar algo en algo	Chama:ye.
echar algo en un líquido	Chamaloł.
echar en algo	(por ejemplo hielo al agua) Yełna.
echarle sal	Busuńna.
echarse a perder sin razón	Ińkaba:cheł.
el	(la) menor (por ejemplo hijo(a) o hermano(a)) Kwaja'pa.
el	(tiempo pasado) Os.
el	(ausente) Usko.
el	(presente) U'ko.
elay	E'a.
el centro del pueblo	Tereslo:los.
el detrás de la casa	Bachinki.
el día anterior	La'je:mes.
el humo	Mu:masłe.
el interior de una casa	Chodo:wi.
el jachi de la harina	Dinra:kwa.
ella	I:ni.
ella	Isne.
ella	(presente) I'ne.
el/la último(a)	Jo:kwan.
ellos	Isko.
ellos son	E'i.
el que enseña	Vatapanchaye:pa.
el que tiene poder para hacerlo	Tenapanłe:pa.
el que va al lugar indicado	Joykwa'a.
el que viene del lugar indicado	Jeykwa'a.
el sembradío que se va sembrar	Wulwanra:ni.
el último	Ya'ko.
embarazada	Ełdimba.
embarazada	Jimo:ba.
embarcado	Amme.
embarcar a alguien	Ama:ye.
embolsado	Amriko:neł.
embriagado(a)	Laya:kwa.
embriagado(a)	Laya:kwa.
embromar	Ruja:ra.
empapar	Pay'na.
empeorado de alguna enfermedad	Kwajpa.
empezar	Ba'wiń.
empleado(a)	China:cho.
empujar	Use:łe.
empujé	Usamo:mo.
enamorar a una mujer	Kweyanti'.
encaramarse	Chajdu'cheł.
éncebar huasca o lazo	Jusa:di.
encerrar algo tapándolo	Poka:choł.
encerrar echando llave	Poka:łe.
encerrarse	Po'łecheł.
encerrarse en un canchón	Vi'cho:łe.
encía	Bałła.
encima de todo	Paspas.
encogerse	Kuḿba:ba.
encogerse	Waykaba:ba.
encogerse	Yaku:kuń.
encomendarse	Dajkwanascheł.
encontrar	Ima'kwa.
encontrar	Mana:ye.
encontrar algo	Chika:ye.
encontrar algo en la calle y llevárselo de paso	Pajasłena.
encontrarse entre varios	Ala'kwa.
encorvado	Yandu'.
encostar	Dita:ve.
encresparse	Chamo:mol.
en donde está la huella	Enbari:na.
endulzar algo	Tadoyna.
enemigo	Alchiwanne.
en este momento	Alkava:ni.
enfadado	Jala:yij.
enfermera	Velaye:pa.
enfocar	Jele:łe.
enfriado	Pa:sul.
enfriar	Pasulni.
enfriar algo	Pasulna.
enfuertarse	Rapisni.
enganchado	Do'cho.
enganchar	Jaje:łe.
engordarse	Mese:ni.
engrapar	(por ejemplo el ganado) Posalobał.
engrosar la yuca	Joḿpa:ni.
enjuagar	Vokolołna.
enjuagarlo por dentro	Vokocho:na.
enlazar algo	Ołna.
enlazar el ganado	Oła:poy.
en lo pando del agua	Tesi:loł.
en oraciones intransitivas	Iń.
enredar algo con otra cosa	Sula:łe.
enredarse en algo	Julłe:łe.
enrojecer	Rapalni.
ensartado	Do'cho.
ensartado	Ołna.
ensatar o enganchar algo	Dokacho.
ensayar el vuelo	Va'kalowiń.
ensayarlo	Opa:na.
enseñar	Vatapancha:ye.
enseñar a alguien	Vata:pa.
enseñar sonidos	Vata:wa.
ensillar caballo	Tompoye:łe.
ensillarlo	Tonamo:si.
enterrado	Wulko.
enterrar	Wula:ko.
enterrarse	Amba:łe.
entonces	Jayłe.
entrar	A:mon.
entre día y noche	Łuvuyni.
entregar en manos propias	Chutatachopanriyasa.
entregarle	Kwajna.
entregarle en la mano a alguien	Chutacho:pa.
entregarse	Umcheł.
entremeterse	Kojkachołe.
entrepierna	Lo:ri.
entreverar agua lentamente	Vokomi:na.
entreverar algo	Posa:kwa.
entreverar con otra clase	Posalobał.
entristecerse	Łavokabaycho.
en vano	Kwajkalo:va.
enviar algo	Uma:ra.
enviar una carta	Uma:beń.
envidiar	Koyi'na.
envolver	Tona:bał.
envolver bien	Pilababał.
envolver en medio de algo	Puya:choł.
equivocarse al hablar	Sankawa:ni.
equivocarse con lo que es	Kema:ye.
erizar del cuerpo	Chamunkaloba:ni.
erutar	Reskwa.
esa	A'ko.
es abuelo	Nono'wawankwa.
escalera	Tolejdi.
escapar algo	Kosi'na.
escapar de la mano una cosa	Tatapanłe.
escases de alimentos	Maw'iwa:wa.
es cierto	Chonlo:maj.
escoba	Pupo:mo.
escoba de jipurí	Pulalayasdi.
escoger	Aje:łe.
escoger	Jote:łe.
escoger a personas	Jońye:na.
escoger a una persona entre varias	Jotaye.
esconder	Kwala:ra.
esconder algo en el monte	Kwala:moł.
escondido(a)	Kwalra.
escozor	Chu:kul.
escribir	Bena:beń.
escritor	Benabeńpa.
escuchar	Owa:na.
escuchar algo que suena de manera despacio	O'o:wa.
escuchare	Palo:to.
escupir	Dotońła.
escurrir	Kota:loł.
esfumarse	Ba:kaloma:maj.
esfumarse	Desayni.
eso	Asko.
eso	Kalru.
espacio abierto	Tańchoł.
espalda	Dudu:du'.
espantajos	En'enye.
espantapájaros	En'en'oj.
espantar algo	Leve:na.
esparcirse	Tamu:mun.
especialmente el cuerpo en una cirugía	Daka:cho.
especie de loritos	Ti'lis.
especie de loros cotorra	Chele:ka.
especie de paja que sirve para techar casa	Kwełris.
especie de papa conocida como gualusa	Bu:tuł.
especie de paraba	Cha:wan.
especie de soga	Davulcho:di.
esperanza vana	Kwajkabaycho.
esperar a alguien o algo	Aya:na.
espesar o calafatear algo	Chuyna.
espesar un alimento echándole algo	Yeła:loł.
espeso	Wayiń.
espesura de bosque	Duḿmo.
espiando	O'ocho:na.
espiar	O'ochołna.
espiar cautelosamente	Dojadoja:łe.
espiar o vigilar a alguien	Pachołna.
espiga de maíz	Kwajta'ła.
espina	Lelejkwa.
espinal	Lelejkwammo.
espinazo	Lelejdu'.
espíritu	Bawrawa:wa.
esponjarse	Chescheł.
esposo(a)	Alwaj.
espuma	Tava:kwa.
esqueleto	Jemnun.
esquina	Tochi:chi.
esquivarse	Uńcho:łe.
es suficiente	Manara'a.
está	Kode.
está	Kolpa.
está	Kolre'e.
está	Kolwa.
está	(cosa o animal con alguien visible) Kopa.
está	(cosa o animal parado visible) Kore'.
está	(cosa o animal fuera de vista) Koro'.
está	(cosa o animal elevado) Kowa.
está	(fuera de vista) Kuro'.
está aquel	Kolde.
estaba	(cosa o animal) Oso'.
estaba el	Uso'.
está capado	Koljoł.
estacar	Tajna.
estacar cuero	Tajabeń.
está cocido	Lovełni.
está él	(parado visible) Kure'.
esta ella	Kinede.
está ella	Kine.
está ella	Kino'.
está fangoso	Pujulni.
está lloviendo	Lu'ti'.
están	Kide.
están	Kilde.
están	Kilpa.
están	Kilwa.
están bien	Je'kaka'is.
estancia	Wa:kawandi.
están ellos	Kipa.
están ellos	Kiro'.
están ideando	Mebaychovałna.
están viniendo	Kila'wa.
estar abrazado	Julłe.
estar abrazado por la cintura	Jułpiń.
estar acarreando agua	Jaka:mi.
estar acomodado(a)	Ajkalo:wes.
estar acostado(a) en el centro del cuarto o la cama	Daytereschoł.
estar acostado después de un castigo	Dayachołwi:teł.
estar acostado marido y mujer	De:łe.
estar acostumbrado	Onra:ni.
estar adormecido(a)	Panuskwa.
estar agachado	Wadulpiń.
estar agarrado	Waypa.
estar agritos	Kamayasna.
estar a la vista	Chondusłe.
estar alegre	Bele:ka.
estar al medio	Terescho:ma.
estar alzando	Peke:łe.
estar amañado	Onkacho:ni.
estar amarillo	Serejni.
estar amarrado	Jamłe.
estar apagado	Ros'i.
estar aplastado	Latosni.
estar apretado	Sińchochołni.
estar ardiendo	Tale:les.
estar arrollado	Pilba.
estar arrollado	Puyba.
estar asutado(a)	Sejka:ye.
estar atrasado	Jumlo.
estar atrasado	Ya'ko.
estar bien	Ya:yu'.
estar bien cocido	Lo've.
estar bien salado	Łomdi.
estar buscando	Sale:łe.
estar cerca	Su:we.
estar colgado en un gancho o clavo	Ołłe.
estar colgado por ejemplo encima de una vara horizontal	Olpiń.
estar compuesto	Ajka:ra.
estar con apetito	Ma'neskwa.
estar concluido un lugar para vivienda	Joywaj.
estar con diarrea	Ba:cho.
estar con flojera	Kwayi:maj.
estar conforme	Mambaycho.
estar con hambre	Maw'inkwa.
estar con los ojos tapado	Muycho:ra.
estar contado	Pa'i.
estar contento	Jayawlo:maj.
estar cortado en varias partes	Tanka:piń.
estar crespo	Mulayni.
estar debajo	Toro'maj.
estar de buen humor	Bele'kabaycho.
estar de mal humor	Jalayikaye:ye.
estar desanimado(a) quedar conforme	Ya:baycho.
estar descocido	Mańdineł.
estar desecho o desatado	Ma'cho.
estar desesperado	Jome:me.
estar desinflado	Yascho.
estar desprendido	Beschoł.
estar distraído	Sankabaycho.
estar doblado	Yamba.
estar dolorido del diente	Tivijsoyła:ni.
estar dormido	Joro:kwa.
estar dulce	Tadoyni.
estar echado de costado	Basto.
estar empinado	Cha'si.
estar encerrado	Di'łe.
estar encerrado	Po'łe.
estar encerrado bajo llave	Tu'łe.
estar en cuclillas	Do'si.
estar en el agua	Tomi:maj.
estar en el campo	Beń'immaj.
estar en el pueblo	Lolosmaj.
estar enfermo	Tera:ni.
estar en fila	Samto:ba.
estar en hamaca	Sele:maj.
estar en hilera	Jeyto:va.
estar enjabonado(a) con jabón	Jawo:kwa.
estar en movimiento	Buka'.
estar enojado	Ba:baycho.
estar enojado	Jala:yij.
estar enojado	Situ:ka.
estar enrredado en algo	Sulłe.
estar entreverado	Poskwa.
estar entumido	Su*mamani.
estar en un logar desconocido	Jolwaj.
estar en venta	Rimłe.
estar errado	Wuykwa.
estar escarmentado	Onijni.
estar esperando	Aya'aya:ni.
estar exprimida una fruta o una caña	Damoyloł.
estar extraviado en el monte	Maykakwanmoł.
estar fatigado	Kawka:ye.
estar fregado(a)	Rujra.
estar frito	Deńchoł.
estar guardado	Ajpa.
estar hediondo	Pusa:ni.
estar hinchado	Wo:tos.
estar húmedo	Tanusni.
estar ideando	Mebaycho.
estar infectada una herida	Deńdeń.
estar jalando	Łowa:piń.
estar ladeado	Basto.
estar liado a algo	Pilłe.
estar liado alrededor de algo	Jaḿłe.
estar liviano	Sadoyni.
estar llena una cosa	Dolra.
estar lleno	Ji:dam.
estar loco	Sabaycho.
estar machucado	Du'cho.
estar mal	Je:ni.
estar manchado	Achichi.
estar mareado	Samayra.
estar mareado	Sara:dal.
estar mojado	Poy'i.
estar mojado	Wa:cho.
estar mojado(a)	Ludayni.
estar molido	Du'na.
estar morado	Rimilni.
estar nublado	Paychi.
estar oscuro	Paya'.
estar o volverse amargo	Sese:ni.
estar parado bajo techo	Enchodowineł.
estar parado en la calle	Enchoradaneł.
estar parado lado a lado	Entomajni.
estar pasando hambre	Maw'i:ti'.
estar peor ya por exagerado	Kwajra:da.
estar perdido	Kwa:le.
estar perdido en el monte	Kwale:moł.
estar pesaroso(a)	Daykabaycho.
estar picante	Vusu'ni.
estar plantado	Cha'poj.
estar por hacer una cosa	Loy.
estar prendido en la planta	Batu'bojełni.
estar preocupado	Rujałni:wa.
estar puesto al fuego	Bańleseł.
estar puesto encima	Bańkwanłe.
estar puesto en su lugar	Batu'ni.
estar pujusó	Mutełni.
estar rallado	Tuł'i.
estar rebatido	Ta'ka:ba.
estar recién enfuertado	Tova'ni.
estar recuperado	Sejawni.
estar resfriado	Paluya:seł.
estar reunidos	Ay:loba.
estar rodeado	Mumele.
estar roto	Ralba.
estar sano	Je'ka:ka'.
estar sentado juntos	Asto'majeł.
estar sentado o echado	Daya'.
estar sin fuerzas	Beytej.
estar sin sangre	Ba:don.
estar sudando	Tayo:ka.
estar suelto	Le:de'.
estar tapada la boca de un objeto	Po'kwa.
estar tapado(a)	(por ejemplo una persona) Ro'bał.
estar tibio	Veyo'ni.
estar torcido	Damoy'i.
estar torrado	Se:den.
estar torrado	Sedenni.
estar triste	Rujkabaycho.
estar vacío	Wascho.
estar vestida de tipoy	Chon'ojeł.
estar vestido(a) de negro	Tun'ojeł.
estar vestido de camiseta	Mariko'ojeł.
estar visible	Dede:ye.
estar vivo	Ite'ni.
estar volcado	Jolcho.
estar volcado	Podońcho.
estar volcado	Volto.
este	Eney.
este	Jata'.
este	(aquí cerca) U:ru.
estera	Powol.
estera pequeña	Powolpiń.
estimar	Juma:ra.
estimar	Kwajesna.
estirar algo	Korońna.
estirar algo	Łowa:piń.
estirarse	De'piń.
estirarse	Koro:doń.
estirarse	Łowłow.
esto	Ayru.
esto	A'ko.
estorbar a alguien	Rujkapa:na.
estornudar	Achiskwa.
estos	I:ri.
estos	Is.
estos(as)	I'ko.
estrella	Didinkwa.
estrujar algo	Jukuy'na.
estrujarse a otra persona	Nu:yeneł.
estudiante	Vańkapawanne.
estudiar	Vańkapa.
estudiar	Vańkapanasna.
es verdad	Chonlo:maj.
evaporarse	Chile:les.
excavarlo	Wo'na.
excremento	Chi'i.
explicarle punto por punto	Kemakemalo:to.
exprimir algo	Roma:loł.
extenderlo	Tamolna.
extender o tender algo que está arrollado	Pasińna.
extrañar	Jome:me.
extrañar a alguien	Jomepa:na.
fabricadora de estera	Powolpa.
fabricar algo	Jisa:na.
fallando la respiración	Yamu:muj.
fallar un tiro	Rujińna.
falta de bebida	Mo:molo:cho.
faltar	Mora:ni.
faltarle	Momoyeskwa.
fangoso	Pu:jul.
fantasma	Jeyra.
farsante	Jo'ka:toł.
feo	Cho'es.
fiebre	Ro:moy.
fiesta	Piyesta.
fila ancha	Powto:va.
filo	Do:jiń.
filo	Pe'res.
filones de altura	Dudu'kwa.
filtro del cigarrillo	Bojchinkwa.
fino	Ji:sim.
fino harinoso	Vuku:ni.
flaco	Be:ye.
flauta	Polawta.
flecha	Jułpa.
flexible	Lede'ni.
flojera	Kwa:yim.
flojo	Beylo:maj.
flor	Morinkwa.
flor de alcornoque	Tipołmo:ri.
flor de algodón	Bujdinmo:ri.
flor del tajibo	Tawułmo:ri.
florecer	Morinti'.
florero con flores	Morinkwawamba.
fonda	(arma primitiva) Maniwammo.
forma de algo	Janlo:wes.
forma de varios colores	Lowe:kwi.
formando corriente	Savawti'.
forzudo	Kwajtej.
fósforo	Paje:la.
foto	Lava:bał.
foto	Lava:bał.
fracasar	Rujlo:maj.
fragancioso	Jo'wes.
francuca	Tambojsi.
frazada	Chanko.
fregar	Ruja:ra.
frente	Be:ra.
frialdad	Paluyres.
friccionar algo	Birińna.
friccionarse	Birińcheł.
frijol	Ma:do.
frio	(ave) I'to:we.
frío	Jilo'.
frío	Pa:luy.
frío	Paluyni.
fritar en manteca o aceite	Deta:choł.
frito de harina	Deńchołba.
fruncirse	Kuḿba:ba.
fruncirse	Sumsum.
fruncirse	Waykaba:ba.
fruta	Baba:kwa.
fruta casi podrida	Rumba.
fruta de motacú	Chujańdi.
fruta de totaí	Purańdi.
fruto	Dodo:kwa.
fruto de coquino	Katena:di.
fruto del mate	Takasba.
fruto del paquió	Vosimdo.
fruto del tarumá	Chekwesła.
fuego	Ve'e.
fuerte	Ra:pis.
fuerzudo	Dińtej.
fumador	Sekaru:pa.
furúnculo	Sin'i.
gajo	Tolejkwa.
gajo con hojas	Lomo:kwa.
galápago	Basworo'no.
gallina	Matawa:re.
gallina con pollitos	Enałe:mo.
gallina jóven	Tolkosmo.
gallo	Torowa:re.
ganadero	Wa:kawandimmajye.
ganar cuando se hace una apuesta	Pa'winłe.
ganarle a alguien	Jula:ra.
gancho	Jajła.
gargajo	Jowo:ba.
garganta	Ełworo:ba.
garganta	(el interior) Taka:ka.
garganta	Woro'.
garrapatilla	Dam'immo.
garza blanca	To'ba.
gas	Ro:so'.
gatear	Welcho.
gato	Mi:chi.
gato montes	Chuyu:wa.
gaveta	Raweta.
gavetillo	Mo'nełkwa.
gaviota	Le:tos.
genital femenino	Buskwa.
gente del agua	Tomimajye.
gentileza	Juyeniwa:nas.
golondrina	Chiki:lo.
golpear algo	Taja:cho.
golpear con un palito	Bayna.
golpearlo con algo	Tore:na.
golpear o tocar algo	Dotojna.
golpearse el antebrazo	Baybakwanyiń.
golpearse en la cabeza	Tajchoba:kwa.
golpear sobre la tierra	Tusulna.
gordo	Me:se.
gordura	Meskwa.
gorgojo	Ku:ła.
gota	Lodinkwa.
gotear	Ło'lo:łe.
gotera	Lorisra.
gracias	Solopa:yi.
grande	Mere'.
granizo	Ilijba.
grano de arroz	Aroso:di.
grano en chala	Batu'mołdi:ni.
granos que salen en la piel	Javułlo.
grasa	Meskwa.
grasa de cerdo	Kochimmes.
grasa de gato montés	Chuyuwanmes.
grasa del manechi	Judimmes.
grasa de tejón	Bichichiḿmames.
grasa de víbora	Mimidimmes.
grasoso	Su'mes.
grasoso	Su'mesni.
grillo	Siwaloto:to.
gritar	Kama:may.
gritar	Wara:day.
gritar de dolor	Waryasna.
gritarle a alguien	Kamayłe:na.
grito	Ka:may.
grosor	Janra.
guajojó	Wa'o'o.
Gualima	(apellido) Wali:ma.
Guanaile	(apellido) Wanayle.
guapurú	Rapu'ła.
guardar algo en un cajón	Ajpa:na.
guardar aparte	Sotajna.
Guasinave	(apellido) Wasina:we.
Guataica	(apellido) Watayka.
guayaba	Pa:di.
guayabal	Padimmo.
guerra	Jarawa:nas.
guineal	Talumre:mo.
guineo	Talummo.
guiñarle el ojo a alguien	Liḿrałe:na.
gusano	Wo:chi.
gusano de donde provienen las moscas	Wo:sana.
gusano verde que come la hoja de tabaco	Olo'tey.
gustarle el sabor	Ma'nespa:na.
haber nacido	Tami:łe.
haberse salvado de un peligro	To'yaj.
había sido	Ji:nana'.
habitante de una casa	Aswa'a.
hablar	Iwa:ni.
hablar bonito	Jiransinełni.
hablar como otro habla	Imkawane:łe.
hablar con energía	Jere:łe.
hablarle	Peńna.
hablarle fuerte a alguien	Jerełna.
hablar por hablar	O:kakapeńna.
hablar por uno mismo	Alwanascheł.
hablarse	Peńcheł.
hace calor	Ewelni.
hace caso	Pe'nira'a.
hace picar	Woje:łe.
hace poco	Jo'mi.
hacer	Jisa:na.
hacer algo	Bisa:pa.
hacer algo así	Jampa.
hacer algo bien	Jayawna.
hacer algo bonito	Jiranna.
hacer algo redondo	Japilna.
hacer algo solo	Jempa.
hacer barro	Bubuńkwanti'.
hacer bulla	Wo'le.
hacer caer	Łoka:łe.
hacer compras	Rimti'.
hacer daño	Rujwil.
hacer de nuevo	Volrada.
hacer el esfuerzo	Dińtełe.
hacer falta	Mora:ni.
hacer frío	Jilo'ni.
hacer gestos	Kuna:nay.
hacer humo en un cuarto	Chumaycho:na.
hacer la venia	Yasba:kwa.
hacerle broma	Bawanłe:na.
hacerle caer	Sula:des.
hacerle caso	Jaywa:na.
hacerle gestos a alguien	Kunayłe:na.
hacerle recuerdo	Jelewa:na.
hacerlo largo	Kulo:wesna.
hacerlo más grande	Mere'na.
hacer lo mismo	Impane:łe.
hacerlo picante	Vusuńna.
hacer lo posible	Dińtejcheł.
hacerlo sonar	Wutusna.
hacer mover algo que está fijo	(por ejemplo un árbol) Liki:na.
hacer objetos de barro	Paya:buń.
hacer olla de barro	Paya:bij.
hacer pan	Pamba:ti'.
hacer pasar por alto	Tojełpojna.
hacer reventar algo	Doposcho:na.
hacer reventar algo	Rała:cho.
hacerse el dormido	Joroka:poj.
hacerse el loco	Sabaychonana'ni.
hacerse el valiente	Darańpojcheł.
hacerse el valiente	Ovenipojcheł.
hacerse el vivo	Paku'kapojcheł.
hacerse masa	Ni'baba.
hacer sentir deseo a alguien	Che'kapojna.
hacerse viejo	Bijawni.
hacer subir a alguien	Selna.
hacer temblar a alguien	Litińpojna.
hacer una flor	Morinti'.
hacer una herida en la cabeza	Tajachoba:kwa.
hacer un montón	Sota'loba:na.
hacer un nudo	Jama:ba.
hacha	Dineła'a.
hacha	Layła.
hacha	Layła.
hacha pequeña	Layła:di.
hacha pequeña	Layła:di.
hachear	Dase:łe.
hachear	Dasna.
hachear	Late:łe.
hachear algo	Lańna.
haciéndolo rebalsar	Pelna.
hallar algo	Kulna.
hallar algo bien	Jayawpojna.
hallar después de haber buacado	Duma:ye.
hamaca	Se:le.
hambre	Maw'i.
hambruna	Maw'iwa:wa.
harapiento	Ralba'ojeł.
harina	Vabaskwa.
harina de chive	Mo'incho:vas.
harina de maíz tostado	Du'cham.
hasta ahí	Ka'de'a.
hasta el tronco	Ya:bajel.
hasta luego	Joyda'.
hay agua	Tomina:kwa.
hazme un favor	Juma'pojdo'.
hechizar a alguien	Ukwanna.
hecho el malo	Dońkatotołni.
hediondo	Beyesni.
hediondo	Pu:sa.
hembra parida	Tami:poy.
herboso	Duyuḿmoł.
herencia psicológica	Jalo:maj.
herido	Daylo:va.
hermana	Alkwe:ya.
hermana mayor	Ke'e.
hermanita	(en saludo) Ke'chita.
hermano(a) mayor	A:kay.
hermano(a) menor	A:na.
hermano de mentira	A:nana'ni.
hermano mayor	(saludo de respeto) Ope'.
hermoso	Ja:yaw.
herramienta	Rimni:wa.
herramientas	Tijkaka:ra.
hervir	Łoko:koń.
hetore	Polababachiya:pa.
hiel	Dońsese:wa.
hieloso	Jiliwni.
hígado	Sondo.
hijo(a)	Majni.
hilar	Davulna.
hilar	Javu'na.
hilo	Bujdi.
hilvanado	Do'ka:łe.
hilvanarlo	Do'kałe:na.
hincharse	Wotosni.
hocico	Chuskwa.
hoja de motacú	Chujańmuń.
hoja de palmera	Mumuńkwa.
hoja de un árbol	Lorankwa.
hombre	Itila:kwa.
hombro	Do'la:la.
homosexual	Paluyres.
hondo profundo	Ku:si.
hongo	Woloto:to.
honrado	Wa:yes.
hora	O:ra.
horadar	Tokacho:ra.
horadar algo con el dedo	Juyna.
horcón	Cha'ła.
horizonte	Jela:ba.
hormiga	Chi:jeł.
hormiga brava	Chonjeł.
hormiga cazadora	Chikaba:ba.
hormiga chotota	Dichiyenjeł.
hormiga chotota	Tu:we.
hormiga culilarga	Mamipanjeł.
hormiga de ambaibo	Wo'wojeł.
hormiga de palo diablo	Rumlo:jeł.
hormiga grande	Powjeł.
hormiga hedionda	Pusa:jeł.
hormiga loca	Jayka'asnapanjeł.
hormiga loca	Sabaycho:jeł.
hormiga orebaré	Wusayjeł.
hormiguero	Chuya:ła.
hormiguero	Ikamba.
hoy	Kwey.
hoyar	(por ejemplo en el chaco) Chaka:cho.
huaracachi	Wada:ka.
huasca	Wa:ka:di.
huatoco	Tedo:woj.
hueco	Woscho.
huella	Barinwaj.
huérfano	Bata:yaj.
hueso	Nun'i.
hueso de humano	Juyeni:nun.
huevo	Jołkwa.
huevo de gallina	Matawarenjoł.
huevo de gaviota	Letosjoł.
huevo de la golondrina	Chikilo:joł.
huevo de loro	Awaro:joł.
huevo del serere	Chamba:joł.
huevo de mosca	Dumuychi:ya.
huevo de pescado	Bilawjoł.
huevo de peta	Sono:ba.
huevo quebrado	Baychojoł.
huevos de lagarto	Karamjoł.
huevos del piojo	De:kwes.
huevos de toro de ganado	Lotodinkwa.
huir dos personas	Jayi:łe.
huirse	Desayni.
humear algo	Chumayna.
humo	Bujru.
hundimiento de la tierra	Yańsi:łe.
hundirse	Ya:ba:kwa.
hundirse en el barro o el fango	Jolobuteł.
hurgar	Chu:na.
hurgar con un palo	(por ejemplo una fruta para que caiga) Chu'na.
huso	Javu'chonawanra.
idioma	Iwaniwansi.
idioma	Iwansi.
idioma nativo	Chonsineł.
iglesia	Ele:siya.
igual que otra persona	Jenni:kwa.
Ilcha	(apellido) Ilcha.
imagen	Lava:bał.
imagen	Lava:bał.
imitar	Ijikapa:na.
imitarlo	Impa:na.
imitar una acción	Ijikapane:łe.
incluyendo el oyente	I:de.
indica que la acción no a realizado todavía	Dis.
indicar la modalidad	Vatolo:wes.
indígena	Alle.
infierno	Chocho:łim.
inflado	Javułcho.
inflamarse	Wotosni.
inflar algo	Javułcho:na.
ingibre	Vusu'dul.
ingiere	Wusu'duł.
iniciar	Nayalo:wes.
inició algo	Nawaja'.
inmediatamente	Loyka.
inmediatamente	Ya'łe.
inmediatamente	Ya'łeka.
insecto como el mosquito de color blanco	Rokoroko.
insignificante	Kila'moka.
insistir	Alka:va.
insistir	Batejni.
insistir	Bo'tej.
insistir en tener algo	Dińbaychovałna.
instrumento para trabajar	Tijkarimwanra.
insultar a alguien	Donna.
intercambiar	Bawpa:na.
interior	To:ro'.
interior de un tejido	Chodo:wi.
inundado	Ya:loł.
inventar	Vańna.
invitar a alguien a hacer algo	Loyełe:na.
ir a	Loy.
ir a la abra	Ba'mayasna.
ir a la punta	Churo:na.
ir al baño	Tori:na.
ir al monte	Chaḿmo:na.
ir al otro lado	Aldi:na.
ir al pueblo	Lolosna.
ir a pescar pacú	Noto:ti'.
ir a un entierro	Wulakochaye.
ir a un pueblo	Jo:be.
ir dando vueltas	Polkaba:ba.
ir directo	Chonlo.
ir en ancas	Amcho:łe.
ir escogiendo	Jote:łe.
ir por arena	Wi'wisti'.
ir por barro	Bubuńkwanti'.
ir por gualusa	Butułti'.
ir por jarca	Chaladiti'.
ir por leña	Ko'o:ti'.
irse	Joycheł.
irse	Nandu'.
irse inmediatamente	Joykał.
irse lejos	Kilajni.
ir tras de alguien	Kweye:łe.
isla de monte	Payłim.
jabón	Ja:wo.
jachi	Mova:kwa.
jacuú	Se:kem.
jajo	Dinła.
jalar	Łowa:piń.
jalar algo	Łowna.
jalar algo de donde casi no se nota	Kosna.
jane	Chapunkwa.
japutamo	Dommo.
jarajorechi	Tululu:si.
jarca	(árbol) Chala:di.
jarcal	Chaladimmo.
jasayé	Sandinłewmo.
jasayé pequeño	Bovemo:ba.
jase	Suḿsuḿpi.
jausi	Po'ros.
jeta	Dosła.
jipurí	Dulwe:kwa.
jocal	Rarismo.
jochi colorado	Punsi.
jochi pintado	Lume'.
joco	Wa:ris.
jopo	Burankwi.
joven	Oveniwankwa.
jueves	We:wes.
jugar	Kuyna:na'.
jugo	Lolołkwa.
jugo de naranja	Narasa:lo.
jugo de piña	Mayuse:mi.
juguete	Ji:sa.
juguete	Ji:sawanrani.
juicio final	Ba:kalomajwa:nas.
juntar	Ińna.
juntar el fuego	Ita:ba.
juntar el fuego	Naylese:łe.
juntarse	Alu'cheł.
juntos en el río	Albijraneł.
la	Isnos.
la	(presente) I'nes.
labio	Dosła.
labrar	Wara:day.
labrar madera	Dasachocha:vos.
la carne de un humano o un animal	Chapunkwa.
lado derecho	Cho:ni.
lado opuesto	Aldi.
ladrillo	Lari:ya.
ladrón	Tolkarana:pa.
lagartija chupacoto	Siko:ya.
lagarto	Ka:ram.
lago misterioso que se dice era una ciudad	Wawanlo.
lagrimas	Ji:wanlo.
laguna	Bijra.
laguna	Powlo.
laguna del tajibo	Tawułmo:lo.
laguna o de una calle	Aldi.
la llegada	Na:va.
la materia que se encuentra debajo de la cascara de una fruta	Chapunkwa.
lamer algo	Doyna.
lanudo	Chamu:yas.
la papde la planta	Babakwakwa'a.
la parte blanda de la cabeza de un bebé	Jasłabakwanina.
la parte recta después de una curva	Kurakapojsi.
largar	Nana:ra.
largo	Ku:lowes.
largo	Ku:ra.
largo y delgado	Ku:piń.
lastimado	Daylo:va.
lastimado	Le:ra.
lastimar o herir a alguien	Daylova:na.
la tela	Lavińkwa.
la tela	Lavińkwa.
lavar algo	Lojna.
lavar platos	Lojacha:do.
lavar ropa	Loja:'oj.
lavarse la cabeza	Lojba:kwa.
lavarse las manos	Lojcho:pa.
lavarse los pies	Lojba:ri.
lavar utensilios	Lojka:rim.
leche	Nonlo.
lechuza	Suwuwunta.
leer	Lewa:beń.
le hago chupar teta	Nonna.
lejía	Rońlo.
lejos	Jeywaj.
lejos	Ki'laj.
lengua	Iwaniwansi.
lengua	(separada del cuerpo) Rułkwa.
lengua	Rul'i.
lengua de panza	Bosi'.
lenguaje	Iwaniwansi.
lenguaje	Iwansi.
lentes	Antipa:ra.
lento	Ji:bal.
leña	Ko'o.
leña del caricari	Kotitinra.
león	Donto:kwa.
leque	(ave) Tayla'a.
letrina	Momowandi.
levantado	De'łe.
levantar de dormir	Pota:mo.
levantarse de dormir	Pońmo.
levantarse de madrugada	Łuvu:ye.
levantar un objeto pesado	Pe'na.
liar algo	Jaḿna.
liar algo	Pilna.
liarlo	Pila:cho.
liendre	De:kwes.
ligero	Po:ra.
ligero	So:riń.
Limaíca	(apellido) Limayka.
limarse los dientes	Tajłacheł.
limón	Li:mo.
limonada	Limo:mi.
limpiar con trapo	Nisna.
limpio	Bancho.
limpio	Kolojni.
limpio	Ko'loj.
lindo	Ma'nes.
linterna	Jelełwamba.
liña	Davuldi.
liquido guardado	Meme:lo.
liso	Ti:łoy.
lista la parrilla	Loycho.
liviano	Sa:doy.
llamar a alguien	Jaya:moł.
llamar a personas	Jayamołcha:ye.
llanura extensa	Beń'i.
llegar	Jo'yaj.
llegar al destino	Ya:pa:na.
llegar a saber	Bispa:ni.
llegar a su pueblo de origen	Di:rał.
llegar con algo al pueblo	Dirałe:na.
llegar tarde	Ya'ko.
llenar algo con agua	Dola:mi.
llenar algo con algo	Dola:ra.
llenar completamente	Pelna.
llenarse con agua	Jidammi:na.
lleno	Sińcho:cho.
lleno de tierra	Nuyvuseł.
llevado por el viento	Kavujłe.
llevar a cabo una actividad	Bisa:pa.
llevar consigo algo o a alguien	Joya:łe.
llevarlo lejos	Kilajna.
llorar	Ji:yi.
llorar agrito	Waraylos.
llorón	Jiwamba.
llorona	Jiwamba.
llover	Lu'ti'.
llovizna	Ridisti'.
lloviznar	Vubujti'.
lluvia	Lu'lu'.
lluvia torrencial	Yełamimilu'.
lobo	Ku:le.
locro	Lo:kwa.
locura	Sabaychowa:nas.
lo extraño	Dayimkay.
loma	Dudu'kwa.
loma donde hay altos palitos	Koridimba.
lombriz intestinal	Pi:wa.
londra	Ja'lala.
lo que no es el cielo	Ya'lo.
lo que no se ve	Chodo:wi.
lo que queda del maíz	Voboskwa.
lo que uno tiene que hacer	Kemlo:maj.
lorito cotorrita	Sikwi:li.
loro	Awaro.
loro come arroz	Chi:tań.
loro medio verde	Tori:ka.
loro pequeño	Awaro:di.
los	Isos.
lucero de la noche	Imayniwandi.
lucha cuerpo a cuerpo	Jamba.
Lucú	(apellido) Luku'.
lúcumo	(árbol) Ti:chol.
lugar de reunión	Ińlobawa:nas.
lugar donde está parado	Enna.
lugar donde se colocan utensilios	Bańkarinwanra:ni.
lugar donde se come	Kayna.
lugar donde se encontró	Manaye:na.
lugar donde uno asienta	Penna.
lugares marginales	To:ri.
luna	Yejcho.
luna nueva	Polayejcho.
lunes	Lu:nes.
machete	Pitełkwi.
machete	Sawi:pa.
machete pequeño	Sawipanto.
machinarse	Vanuyni.
machucar	Nika:ba.
madera	Ko'o.
madera	Todankwa.
madera de ambaibo	Wo'wovos.
madera o hueso	Kojamutelwambes.
madre	Ma'a.
madre de familia	Ma'wawankwa.
madrugada	Łu:vuy.
madrugar	Łuvu:ye.
madurar	Bewni.
magulladura	Dijoyni.
Maileva	(apellido) Mayle:wa.
maíz	Kwajta'.
maizal	Kwajta'mo.
maíz en grano	Kwajta'di.
maíz tierno	Dochi'ta'.
majlo	Voboskwa.
mal acostumbrado	Oncho:ni.
Malale	(apellido) Mala:le.
mal colocado	Jeyra.
mal del estomago	Cho'eskakaye.
mal del estomago	Dońreskwa:ni.
malgastar	Ba:kalomajna.
mal hecho	Jeylo:wes.
mallugado	Sibo'ni.
malo	Dońtoł.
malquerer a una persona	Dona:ye.
malquererse	Jarachijni.
mal sueño	Rujsi:kwa.
mal tiempo	Ruja:jas.
maltratar a alguien	Jańna.
Malue	(apellido) Malu:we.
mamuri	Tono:ko.
manchar algo	Achichi:na.
manchar algo con resina	Jemalo:si.
mancornar	Waya:łe.
mandato	Kemlo:maj.
mandíbula	Kwinto:nun.
manea	Supa:ba.
manga	(fruto) Manka.
manga caballo	Kawayo:ba.
mango	Banełkwa.
mango o cabo del hacha	Layłapiteł.
mango o cabo del hacha	Layłapiteł.
manguarí	Wayape:ra.
maní	Chi'chi.
mano	Cho:pa.
mano derecha	Cho:ni.
mano de tatú	Barinkwa.
mano izquierda	Jo:li.
manteca	Meskwa.
manzanilla	Lochiwamba.
mapajo	Wa:se:na.
maquina fotográfica	Chipojlababałkwanra:ni.
marchito	Dovayni.
mareo	Samayra.
marigui	Chichi'ła.
marimono	Pato:re.
mariposa	Deltoveń.
mariposa nocturna	Su:ba.
martes	Ma:retes.
martín pescador	(ave) Cha:da.
masa	Bubuńkwa.
masa de chive	Mo'incho:buń.
masajear	Romna.
masajear algo	Romkacho:na.
masajear a personas	Birińcha:ye.
mascara de torito	Mosi:kwa.
mascar algo para saborearlo y escupirlo después	Lela:ba.
más grave que lo esperado	Kwajlo:maj.
más o menos	Me:kaka.
más peor	Kwajlo:maj.
más tarde	Nokowa.
masticar	Eła:di.
masticar algo	Danna.
más todavía	Ła:kwa.
matarlo	Tikoyna.
matarse	Tikoycheł.
mate	(fruto) Sawa'bo.
mate de naranja	Narasa:mi.
materlo al agua	Yaja:loł.
matico	Cho:dis.
matrimonio	Nayewa:nas.
mauri del chico	U:liḿ.
mauri del grande	Bonko.
Mayapo	(apellido) Maya:pu.
Mazaro	(apellido) Masa:ro.
me agrada	Jirampojkay.
me anda	Welayni.
me arde	Wewewni.
me causa temor	Ewejpojkway.
mecer a alguien	Leke:na.
mecerse	Leke:cheł.
mechero	(árbol) Kulujdi.
me da asco	Cho'espojkay.
me da rabia	Jalaypojkay.
me da vergüenza	Chajampojkay.
media noche	Teres'im.
mediodía	Chonsi.
medir	Pa'na.
médula	Tava:lo.
me gusta	Jirampojkay.
me hace calor	Ewelni:wa.
me hace sentir triste	Dayimkay.
mejilla	Pojra.
mejor	Wa:watoł.
melero	Tavojchodinła.
mellizo	Jo'ya:łe.
me maltrata	Ke'arani:kay.
mentira	Tija:si.
mentira	Tijka:choł.
mentirle a una persona	Tijkachołna.
mentiroso	Tijasi:pa.
menudos de una res u otro animal	Babawankwa.
me pica	Chukulni.
me preocupa	Rujałkay.
me rodean las abejas	Muele:kay.
mes	Yejcho.
mesa	Me:sa.
meter algo en otra cosa	Kojna.
meter caña altrapiche	Koja'as.
meterle en la boca	Uya:kwa.
meterse al agua	Penlo:łe.
meterse en el agua	Amlo:łe.
meterse en el barro	Ambute:łe.
meterse en la tierra	Amłaba:łe.
meter una cosa dentro de otra cosa	Ama'poj.
metido en el agua	Amloł.
metido en el barro	Ambuteł.
metido en la tierra	Amłabal.
mezclado	Poskwa.
mezquinar	Koyikaye:cheł.
mezquinar	Uye:na.
mezquino	Dońlo:wa dombaycho.
miedoso	Tino'si.
miel de abeja	Chuydinlo.
mi nombre	Eł'i.
mi ojo	Cho:ra.
mira!	Łań.
mira!	Velti.
mirar	Vaye:łe.
mirar algo	Para:na.
mirar hacia atrás	Volye.
mirarle su altura	Olo:na.
mirar mal a alguien	Kuna:nay.
misa	Mi:sa.
mi seno	Chaj'i.
misterioso lago de que se cree que haya sido una ciudad	Banwa:wa.
mis viejos	Bija:jaw.
moco	Noro'chichimba.
mohoso	Mutełni.
mojado(a)	Lu:day.
mojar	Poyna.
mojarse	Ludayni.
mojarse	Wa:choye.
molde	Chocho:kwi.
molde para tejer sombrero	Mila:cho.
Mole	(apellido) Mo:le.
moler	Duke:łe.
moler	Du'na.
moler	Tajna.
moler arroz	Dukaro:so.
moler granos	Duka:di.
moles	Tajna.
molestar	Ke'a:ra.
molestar	Rujapanłe.
molestar	Tijna.
molestar a alguien	Bawiłna.
molestar a una mujer	Tijakwe:ya.
mondar granos	Eła:di.
mono	(mono silbador) Si:doj.
mono chichilo	Kachi:chi.
mono león	Dokado:ka.
mono manechi	Ju:di.
mono nocturno	Despu.
montar a caballo	Aspoye:łe.
montar a caballo	Selcheł.
monte	Chaḿmo.
monte del rapulo	Rapu'lo:mo.
morder	Lape:łe.
morder algo o alguien	Laḿna.
mosca	Du:muy.
mosca diminuta	Chojlolo:muy.
mosquitero	Tordeta.
mosquito	Ka:wuḿ.
mosquito grande	Tumvuń.
mosquito medio morito	Wo:ja.
mosquito puguilla	Chuydimsi.
mostrar algo	Chusa:pa.
mostrar un lugar	Chusa:waj.
motacú	Chu:jań.
motacusal	Chujammo.
moverse repentinamente en un lugar	Iye:kani.
movima	Mowi:maj.
muchacha	Tolkosya.
muchas vueltas	Kawpojsi.
mucho	Tojeł.
mucho antes	Kwil.
muchos	Kawra.
mucho tiempo atrás	Lajań.
mudar algo	Dowajna.
mudarse	Dowa'waj.
muela	Kwinto:ła.
muerte	Kayniwa:nas.
muerto	Kayni.
mujer	Kwe:ya.
mujeriego	Kweyayammo.
mujer joven	Tolkosya.
mujer que no puede tener hijos	Jo:li.
mujer que tiene hijos	Ma'wawankwa.
multiplicarse	Eyajni.
muñeca	Bakwanyiń.
murciélago	Bo:siń.
música	Mu:sika.
muslo	Di:noj.
mutun	(ave) Mama:ku.
muy	Tojeł.
nacer	Donłe.
nacer	Paḿpaḿ.
nacido	Tami:łe.
naciente	Jata'.
nadar	Koma:lo.
nalga	Dinsi.
nalga	Kwansi.
naranja	Nara:sa.
naranja agria	Chasoyba.
naranjal	Narasa:mo.
nariz	Ba:chi.
narrar algo	Ajalo:maj.
Navala	(apellido) Nawa:la.
navidad	Paskwa.
necesitar	Jumara:ni.
necesitar a alguien o algo	Juma:ra.
negativo	Kwajka.
negro	Tunni.
ni aun cuando	Nawan.
nido	Babalkwa.
nido de tejón	Bichichiḿma:bał.
niel de caña	Charape:lo.
nieto(a)	Ona:cho.
nigua	Ku:duḿ.
niña	Kweyanchi:ye.
niñera	Velaye:pa.
niño(a)	Dichi:ye.
niño varón	Itilakwanchi:ye.
nivelado	Imkato:ni.
nivelar algo que contiene una basija	Parajna.
no	Kas.
no	Ka'i.
noche	I:may.
noche entera	Pe'im.
noche oscura	Paya'im.
no decir nada	Jana'kwa.
no haber nada	Ełe:ni.
no haber saciado el apetito	Momoyeskwa.
no importa	Wadi'.
nomás	Ja'.
nombre de una persona no identificada	Ełwanra.
no querer	Jana'pa.
no querer volver	Volbaycho.
noria	Lu:ve.
no sabe nada de ello	Pakuka'as.
no se	Joydi'.
no sirve	Jeysi.
no sirve	Kemaka'ra'a.
no sirve	Ura*be.
nosotros	I:de.
nosotros	Ił.
nosotros	(menos el oyente) I'łi.
nos vamos	Joydajay'łi.
no tener nada	Ełe:ni.
no tener nada	Je'ka:ka'.
no todavía	Mo:ka.
nové	Jeje:.
novelear	Wuru:na.
nube	Be:yas.
nuca	Dinełbakwa.
nuevo	Pola:ra.
número	Pakełwanra.
nunca	Eła'lomajniwa.
ñandú	Da'ra.
o	Kabo.
obedece	Pe'nira'a.
obedecer	Jaywane:łe.
objeto para defenderse	Borewanra.
objeto para pegar	Jatełwanra.
objeto que da luz	Jelra.
observar	Para:na.
observar la conducta de otra persona	Palomajna.
observar su propia conducta	Palomajcheł.
ochoo	Kana:wa.
ocultado(a)	Kwalra.
ocultar	Kwala:ra.
ocultarse	Kwale:łe.
oculto	Bo'we.
odiar	Dona:ye.
odiarse aborrecerse	Doncheł.
oído	Chochobakwa.
oír voces	Onlolomajni.
ojalá	Disłańwa.
ojalá	Ła'wa.
ola	Papawła.
oler	Senna.
oler algo agradable	Jirannesni.
oler a quemado	Sekayni.
oler a rancio	Site'ni.
olerlo	Payesna.
olla	Wu'tu.
olla de barro	Bubuńkwambij.
olla grande de barro cocido	Tomo:re.
ollita	Wu'tuba.
olor	Mujełkwa.
olor a fruta madura	Vuwa:ni.
olor agradable al olfato	Jowesni.
olor fuerte	Di:tes.
olvidadizo(a)	Kilayniba:kwa.
olvidarse	Kilayni.
ombligo	Dimmo.
Onarry	(apellido) Onajri.
orar por alguien	Dajkwanasłena.
ordenarle a alguien	China:cho.
ordeñar	Roma:lo.
oreja	Loto:to.
oreja de palo	Woloto:to.
oreja de vaca	Loto:kwa.
orevaré	Vusayjeł.
orientarse	Pawaje:łe.
orificio o hueco negro	Tuntunsi:ni.
origen	Nalomajna.
orilla	Tori:di.
orilla de la noria	Luvenbijra.
orilla del lago	Bijra.
orilla de una laguna	Powlobijra.
orilla de un objeto	Łała:kwa.
orina	Chojlo.
orina	Sa:ray.
orinar	Chojkwa.
orinón	Chojsi.
oro	O:ro.
oscuro	Paya'ni.
o será	Kabo di'.
oso bandera	Bana:maj.
oso hormiga	Wayewaye.
otra cosa	Kaka:ra.
otra cosa	Sońra.
otra cosa	So:taj.
otra persona	So:te.
otra ropa	Kaka:'oj.
otra vez	Reyka.
otra vez	Sońlo:maj.
otro	Sońra.
otro día	Kakaye:mes.
otro día	Sońne:mes.
Ovale	(apellido) Owa:le.
oveja	Ma:sa.
oxidarse	Momo:cheł.
pacaí	(árbol) Chusbo'.
pacú	(pez) No:to.
pacú pequeño	Noto:di.
padecer de una enfermedad	Batesna.
padre	Pa'a.
padre	Pa'wawankwa.
padrino	Łiyeni:kay.
pagar a un trabajador	Rima:ye.
pagarle	Bawa:ra.
paicahne	(arbusto) Kawmoł.
paire	Chapa:ye.
paisano	Alle.
pajal espeso	Duḿmo.
paja que se usa para techar	Di:mas.
pájaro carpintero	Ya'ya:ma.
pájaro pequeño	Chirwła.
pala	Chakatora:wa.
pala	Dineła'a.
palabra	Sinełkwa.
palabra de cariño	Bito'.
palabra larga	Ku:lopitel.
palabra que es un nombre pero sin referir a ninguna persona en especial	Ełwawankwa.
palabra que se pronuncia cuando a la persona no le agrada lo que le dicen	Achapu'u.
paladar	Cho'vaj.
paleta	Tovaykwa.
palideció	Kovela'ni.
pálido	Kovelni.
pálido	Serejawa:di.
palito	Kori:di.
palito	Tolejkwa.
palo	Ko'o.
palo diablo	Rumlo.
palo encebado	Upavaswanra:ni.
palomaría	(árbol) Lajni:ye.
palometa	Lala'kwa.
palo santo	Rumlo.
pam grande	Powba.
pampa	Beń'i.
pan	Pamba.
pan de arroz	Aroso:ba.
pantalón	Karso:ne.
panza	Chokwammo.
pañuelo	Panwe:lo.
papaya	Maropa.
papel de cuaderno	Alwambeń.
paquió	(árbol) Vo:sim.
paraba	Kara'.
paraba barba azul	Sari:di.
parabachi	Seya:mo.
parado(a) en la orilla	Enbijraneł.
para que	Bo.
para qué es?	Kemara'a.
para referirse a personas o cosas que no están presentes	Isko.
pararse	Encheł.
pararse	Tajpo.
parásito	Rum'i.
parece ser	Jaysoń.
parecido a	O:be.
pared de ladrillo	Łavałkwa.
pareja de casados	Alwajni.
pariente	Alkaka:ye.
pariente	Alle.
parpado	Mołra.
parrilla	Chocho:kwi.
parte del tronco	Bojełkwa.
parte trasera de una embarcación	Bo:boj.
partido	Ra:cho.
partido	Ra:kwa.
partir	Paja:cho.
partir algo	Racho:na.
partir la sandia	Daka:cho.
partir leña	Pajachocha:ra.
partir o cortar	Daka:cho.
partirse	Racho:cho.
pasanca	Kule:ma.
pasar	Toje:łe.
pasar así	Janlo:maj.
pasar la mano sobre algo	Pałna.
pasarlo en agua herviente	Yaku'na.
pasar por un lugar donde siempre se pasa	Tojełna.
pasearse de un lado para otro	Marka:kwa.
pasó la fiesta	Baloweskwiwa:wa nas pieyesta.
pasó todo el día	Pe'yemeskwi.
pata del animal separada	Barinkwa.
pateador	Łekełpa.
patio	Lo:los.
pato	(palabra desconocida para algunos hablantes Kodo:si.
pato	Końko:re.
pato cuervo	Kele:le.
pato puga	Kele:le.
pato putirí	Wi'lili.
pato roncador	Torada'.
pato vichichí	Wi:sisi.
patujú	Ovempoj.
patujú del grande	(parecido al plátano) Pe:rena:na'.
patujusillo	Tawasdi.
pavi	Wa:wos.
pecado	Peka:to.
pecador	Pekato:pa.
pececillo	Bilawła.
pecho	Be'łała.
pedacito	Bojchinkwa.
pedacito de astilla	Todankwa.
pedazo de carne	Wa:kato:da.
pedir	Dajkwanasłena.
pedir algo	Daja:ja.
pedir un favor	Karaye:na.
pega	Tijkarimwa:nas.
pegar	Jańna.
pegar	Jate:łe.
peine	E:ła.
pelado	Beschoł.
pelar	Tosna.
pelarlo	Besna.
pelar los dientes	Pulchinła.
pelea	Jarawa:nas.
peleador	Jara:pa.
pelear	Ja:rał.
pelear con alguien	Jarałe:na.
pelearse	Ba:kawanne:cheł.
pelecho o cascara del huevo	Momołkwa.
peligroso	Ewejni.
pellizcar	Łi'na.
pellizcar algo o a alguien	Bińna.
pellizcar ligeramente	Bite:łe.
pelo	Risa:kwa.
pelo de gato	Michiri:sa.
pelo de perro	Pa:kori:sa.
pelota	Powojlolo:ba.
pendiente de la mujer	Mońlo:to.
pene	Tey'i.
pene del niño	Chuchu'.
pene pelado	Tosba.
penga	Mo'los.
peni	(reptil) Ja:ma.
pensar	Pabaycho.
pensar en alguien o algo	Pabaychovałna.
pensar en una actividad	Pabaychova:na.
pensar mal	Kwalbaycho.
peor	Ła:kwa.
pequeñito	Toti'.
pequeño	Tochi'.
percibir	Owa:na.
perder algo	Kwale:na.
perder el conocimiento	Sońte'.
perdiz	Tolwsi.
perdonarle	Tojełpojnakwa:na.
perdonárselo	Tatabalkwa:na.
perdurar	I:lolomajni.
perezoso	No:nopa.
perforar algo	Tokacho:ra.
perfume o aceite fragancioso para untarse al cuerpo	Chi:ra.
perjudicar	Rujapanłe.
permitirle algo	Ka'pojna.
permutar algo	Bawra:na.
pero	Ban.
pero no	Didi'.
peroquí	(ave) Sańlo.
perro	Pa:ko.
perseguirlo	Kweyasełna.
persinarse	Chuscheł.
persistir	Jempiteł.
persistir hasta lograr lo que uno quiere	Tija:łe.
persona	Juyeni.
persona alcohólica	Layakwampa.
persona alcohólica	Layakwampa.
persona blanca	Baraya:na.
persona bonita	Jayawwe.
persona celosa	Kemayełewamba.
persona con barba	Chuskamo:ra.
persona con instinto animal	Popoykwanlo:maj.
persona de baja estatura	Tedowojye.
persona del campo	Beń'immajye.
persona del pueblo	Lolosmajye.
persona del sexo femenino ausente	Isne.
persona del sexo femenino en tiempo pasado	Isnos.
persona de otro lugar o de otra raza	Jeyye.
persona de piel clara	Jelewwe.
persona enfermisa	Teranini:ye.
persona extranjera de otra lengua y que no es indígena	Ita:na'.
persona fea	Cho'esye.
persona flaca	Beyeye:ye.
persona friolenta	Jilo'si.
persona gorda	Mesye.
persona hábil para contar	Pakełpa.
persona mayor que uno	Bijawwe.
persona morena	Tu:ne.
persona no bautizada	Lolba'eł.
persona picarosa	Kilmomo:ye.
persona puntera	Bisi'ne.
persona pura	Jemme.
persona que come mucho	Kaypa.
persona que cura mediante masajes	Birińchaye:pa.
persona que hace de papá	Pa'wawankwa.
persona que pega a otras	Jatełchaye:pa.
persona que tiene	Ninninła.
persona que tiene habilidad	Biso'.
persona que ya tiene nietos	Nono'wawankwa.
persona retada	Juwankwa.
pertenecías	Tijkaka:ra.
pertenencia	Dayajna.
pesado	De'łe.
pesado	Dino'.
pesar	Pa'na.
pescado	Bi:law.
pescador	Bilawpa.
pescar	Ba:yeł.
pescuezo	Popojmo.
pestaña	Lowadinra.
pestañear	Liḿra.
peta del agua	So:no.
peto	O:mayle.
petoabeja	Chuydimayle.
peto chuturubí	Domba:chi.
picaflor	Chimili.
picante	Vusu'.
picao de yuca	Lokwampiń.
picapica	Isełlowa.
picardía	Kilmowa:nas.
picaro	Kilmo.
picazón	Chu:kul.
pichiró	(sabor a fruta por madura) Talumni.
pico	Chuskwa.
pico cerrado	Wuychuskwa.
pico de la ave	Tu'ła.
picotear	Dupe:łe.
pie	Ba:ri.
piedra	Champa.
piel	Tobeńkwa.
piel belluda	Chuskabeń.
piel blanca	Tavojveń.
piel suave de una fruta	Lavińkwa.
piel suave de una fruta	Lavińkwa.
pierna	Ła:ri.
pífano	Pi:kolo.
pillar a alguien haciendo algo	Chika:pa.
pillar a alguien o algo	Mana:ye.
pilotear una embarcación	Tuka:boj.
pintado	Si:vil.
pintar	Piłe:łe.
pintar	Ri'na.
pintoneado el sembradío	Sejni.
piña	Ma:yuse.
piñal	Mayuse:mo.
piñón	Chi'china:na'.
piojo	Dam'i.
piraquina	Masla:pos.
piroco	Tosworo'di.
pisar algo	Łeka:cho.
pisonear	Duke:łe.
pisonear algo	Du'na.
pita entorchada	Davuldi.
pitaí	Javułlo.
pitar	Se'na.
pitar un cigarrillo	Se'na.
pitón	Rochindi.
pitón	(árbol) Rochindo.
pitón	Vulni.
piyu	Da'ra.
plancharlo	Riłna.
planchar ropa	Riła'oj.
planear	Pabaycho.
planta acuática	Chichamra.
planta del mango	Manka:boj.
planta utilizada para teñir ropa de color anaranjado	Chuchuchi.
plátano frito	Deńchołmo.
plátano maduro	Bewmo.
plátano tierno	Łała:kwi.
plato	Cha:do.
plaza	Lo:los.
pleitear	Jaradakwa:na.
pluma	Mumuńkwa.
pluma de huaracachi	Wadakamuń.
pluma de la paraba	Kara'muń.
plumaje de machetero	Łewkwa.
plumero	Juḿwammo:ni.
Poboslo	(apellido) Powojlo.
pobrecito	Beyka.
pochi	Chichamra.
pocita que guarda agua por tiempo	Kokońkwa.
poco	Beyra.
poco profundo	Te:si.
poder hacerlo	Tanapanłe.
podrido	Dońra:ni.
polilla	Nunris.
pollito	Tochi'mo.
pollos huérfanos	Batayajmo.
polvo bien cernido	Ni'wis.
polvo de la tierra	Vuskwa.
poner algo	Bańna.
poner algo en el suelo	Daya:ra.
poner en el fuego	Bata:si.
poner en orden	Ajkapa:na.
poner hojas de palmera en un techo	Batamuń.
poner huevo	Jołti'.
ponerle en claro a alguien	Jelewa:na.
ponerlo al fuego	Bataleseł.
ponerse a la sombra	Chanlava:łe.
ponerse en fila	Samtova:cheł.
ponerse loco de amor	Sawa:way.
ponerse una vestimenta o joya	Do'na.
poner sobre algo	Jana:łe.
ponsoñoso	Diteswiń.
popa	Bobojkwa.
por eso	Jan.
por favor	Juma'pojdo'.
por la mitad	Alcho:ni.
por lo menos	Beya'ka.
por que	Bo.
por suerte	Manran.
posetacú	Chuya:ła.
posiblemente	Joy.
posiblemente	Joychoyka.
poste	Cha'vos.
potro	Pariye:wa.
poza parte de un bajío	Chisawascho.
pozo	Kokońkwa.
preguntar	Dajawane:łe.
preguntarle a alguien	Daja:wa.
preguntar por algo	Daja:ja.
prender fuego	Bata:les.
prender fuego	Chuta:les.
prenderse en algo	Bay'łełe.
prendido de la olla	Bay'bi:jeł.
preocupado	Kawka:ye.
preocupado	Onka:ye.
preservarse	I:lolomajni.
prestar algo	Botepojna.
prestarse	Bo:te.
prima	Pi:ri:ma.
primer día	Naychinye:mes.
primer día de fiesta	Naychinlo:wes.
primero	Naychi.
primo	Pi:ri:mo.
príncipe del agua	Bo:law.
principio	Nalomajwa:nas.
pringar	Pay'na.
probablemente	Joychoy.
probar algo	Opa:na.
probar el gusto	Owesna.
probar la calucha	Ochołna.
procurar algo	Dimbaychovałna.
profesor	Vatapanchaye:pa.
prohibido	Ura*be.
prohibir	Uḿna.
prohibir	Uta:be.
propinarle	Chilna.
protestar	Baka:wa.
puchíchi	Sin'i.
pueblerino	Lolosmajye.
pueblo	Lo:los.
pueblo viejo	Memelo:los.
puerco de la cueva	Siłkwammaj.
puerco espín	Dudu:tus.
puerco taitetú	Kayo:ti.
puerta	Ra:da.
puerta	Radanłe.
puerto	Tokwi:kwi.
pues	Rey.
pues sí	Lo.
puesto a la cruz	Bańsuneł.
puesto derecho	Bołoḿ'i.
pulga	Ku:duḿ.
punta con punta	Altura:chi.
punta de la caña	Churo:kwa.
punta de la nariz	Turu:chi.
puntiagudo	Do:jiń.
punzonear	Chaka:cho.
puño	Kolo:ba.
pura resina	Jemlo:si.
puro	Jemme.
puro	Kolojni.
puro	Ko'loj.
puro hoyo	Jemsi.
pus	Dońlo:wa.
que baila toda la noche	Telo'imna.
quebrado	Baycho.
quebrado	Kańpiń.
quebrado abierto	Ra:cho.
quebrar algo	Baya:cho.
quebrar algo de algo	Baka:łe.
quebrar algo de algo	Kata:łe.
quebrar algo largo por la mitad	Kata:piń.
quebrarse	Kańcho:cho.
quebrarse al tronco del árbol	Kańboje:łe.
quebrar un árbol	Kata:boj.
que brilla	Jelesni.
que camina feo	Cho'eslowe.
qué cosa?	Jeka'ni.
que da miedo	Dayimni.
que da miedo	Tino'ni.
quedar bien parado	Enu'ni.
quedar en lo seco	Osełni.
quedarse acostado	Deku'ni.
quedarse atrás	Elasłe.
quedarse atrás	Ela:ye.
quedarse en algún lugar	Asu'ni.
que es suave	Ni'loyni.
que está carbonizado	Tayko.
que está muy sabroso	Ma'nesni.
que está partido	Pajcho.
que está por llegar	Telayni.
que fluye agua	Limi:mi'.
qué fue?	Łeła'a.
qué has hecho?	Janwitan.
quejarse de dolor	Jaya:yas.
qué lástima! me pesa	Beyka:pa.
que llegue	Telaka'ni.
quemado	Ba:les.
quemar	Ise:łe.
quemar	Taya:ko.
quemar algo	Isna.
quemar chaqueado	Vusa:łim.
quemar o calentar algo por dentro	Isa:cho.
quemarse	Vusłe.
que no tiene paz con nadie	Jaradada:mo.
que pena!	Łavo:ni.
querer dormir	Jorosicha'kwa.
querer estimar a personas	Kwajescha:ye.
querer hacerlo	Didi'.
querer orinar	Chojsicaha'kwa.
queresa	Dumuychi:ya.
qué tal? ¿ayakweł? ¿cómo están? ¿aya kos jeyan? ¿qué tienes?	Aya.
que te vaya bien	Jay'lo.
que va bien cargado	Pampammo'mo.
que vive en el pleito	Jaradada:mo.
quiabó	(olor a pescado) Ka:loy.
quiabó	Kaloyni.
quién?	E:łe.
quitarle algo a alguien	Suyna.
quitarse el pantalón	Końła:ri.
quizás	Bu'ni.
quizás	Jina'.
rabia	Ja:lay.
rabioso	Jala:yij.
rabo	Bałewkwa.
raíz	Dudułkwa.
rallador	Pujła.
rallar	Jiłna.
rallar con la punta del cuchillo	Tułna.
rallar la yuca	Jiłapa.
rama	Tolejkwa.
ramillete	Mo'los.
rana	Si:ba.
ranchear	Jaje:łe.
rancio	Di:tes.
Rapu	(apellido) Ra:pu.
rascar	Wałna.
rasgar	Biłna.
raspar algo	Bołna.
raspar yuca	Boła:pa.
rata	Nołkwa.
ratón	Nołkwa.
raya	Chavo'.
rayar	Piłe:łe.
rayar	Piłna.
rayo	Yampa.
razo	Bancho.
rebalsar	Pelpel.
rebanar choclo	Muła:cho.
rebatir	Ta'kaba:na.
rebatir algo	Tańkaba:na.
reboleado	Boyboylo.
recaer de una enfermedad	Cholo:ma:maj.
rechazar	Nanalopa:nas.
recibir agua	Eya:mi.
recibir en propias manos	Uycho:pa.
recién	Jo'mi.
recién	Te:teka.
recimo	Pojełkwa.
recogerlo	Kulna.
recoger o escoger del suelo algo	Jońna.
recto	Bo:łoḿ.
recto	Imkato:ni.
redondo	A:te'.
redondo	Ja:pil.
reemplazar algo	Bońra:na.
reemplazar algo o a alguien	Bawchołna.
refregar	Juchu'.
refregar ropa	Juchu'ojna.
refresco	Wara:po.
regado	Dachis'i.
regalarle a alguien	Elna.
regalo	Elełwa.
regalo	(de nadie en particular) Elełwanra:ni.
regalo	Kayłewawa.
regalos	Elełwa:ni.
regar	Ruḿna.
regar agua	Tamunmi:na.
regarse	Tamu:mun.
regresar	Salmo.
reilón	Josika'asna:pa.
reilona	Josika'asna:pa.
reírse de algo o de alguien	Cosipa:na.
relampaguear	Tapela'ni.
relampaguear	Tapel cheł.
relatar	Ajalo:maj.
reloj	Paka'orawanra:ni.
remar	Saya:ve.
remedar algo	Ijikapa:na.
remedar el habla de otra persona	Ijikawa:na.
remedio	Lawa:jes.
remedio	Lawa:jes.
remendado de apenas	Way'cho.
remendar	Tonna.
remendar la ropa	Tona'oj.
remo batidor de madera	Sayłaye:do.
remo de boga	Jolkwandoneł.
renacuajo	Wosba.
rendido	Ba:te'.
renegar	Baka:wa.
reñir	Juke:łe.
reñir	Uru'ła.
representar algo	Chekasna.
representarse	Chekascheł.
resbalarse	Kachiḿpoj.
resbaloso	Kachi'ni.
resfriarse	Paluyasełni.
resina	Losi:kwa.
resina de ochoo	Kanawanlo:si.
resino de macororó	Kawa:wa.
respetar a alguien	Wayesna.
respeto	Wayeswa:nas.
respirar	Łowte'.
responder	Chaywanełe.
resucitar	Choyte'.
resurtir	Chaychi.
retaso de tela	Do'ewanojbeń.
retoñar	Tochinti'.
retoño	Tochinkwa.
retroceder	Choysi.
reunidos	Ińlo:ba.
reunión o lugar de reunión	Aylobawa:nas.
reunirse	Ay:loba.
reventado	Rałcho.
reventado	Rancho:cho.
reventar caña	Doposchacha'as.
reventarse con sonido	Doposcheł.
revivir	Choyte'.
revocar o afinar una pared	Payna.
revolcarse	Polkaba:ba.
rezador	Lewalo:pa.
rezar	Lewa:lo.
rezar por alguien	Lewalokwa:na.
rincón	Po:poj.
riñón	Torindi.
río	Bijra.
río	Mani:ki.
río grande	Ińwa.
río rapulo	Rapu'lo.
risa	Jo:si.
robarle a alguien	Doja:łe.
robarle a alguien	Tolkara:na.
rociado	Dachis'i.
rociar algo	Ruḿna.
rociar con gotas grande de agua	(por ejemplo con una tutuma) Dachisna.
rociar ropa	Vubuj'ojna.
rociart	Vubujna.
rocío	Bełlo.
rodar	Polkaba:ba.
rodear	Julałełe.
rodear a alguien	Muna:łe.
rodearlo	Jula:łe.
rodilla	Ba:mo.
rodilla	China:mo.
rojo	Ra:pal.
romper	Peła:cho.
romper el monte	Peła:mo.
romper trapo o papel	Pełna.
roncar	Łoro:doń.
ronchearse	Sonolba:ba.
ropa	Do'we.
rosado	Balo:si.
rosar	Dasa:mo.
roto de tal forma que se ve el interior	Pełcho.
rotoso	Rałba.
rubio	Wa:yo.
rugir	Łere'cho.
sábado	Sa:waro.
sábalo	Ukaḿ.
sabañón	Wojwoj.
saber	Bispa.
saber de algo	Paku'na.
saber hablar	Biswa.
sabor a fermentado	Chasoyni.
sabros	Ma'nes.
sacar	Łowa:łe.
sacar	Sawe:łe.
sacar agua de una vasija	Yata:mi.
sacar algo	Konna.
sacar algo	Końna.
sacar algo	Sayna.
sacar algo de a poco	Chelna.
sacar algo del agua	Kona:loł.
sacar algo desde adentro	Kona:choł.
sacar algo o hacerlo salir	Chipojna.
sacar cascar de alcornoque	Tipołbeńti'.
sacar con la mano	Wayna.
sacar del fuego	Konale:seł.
sacarle un pedazo a algo	Loka:cho.
sacerdote	Pa:'i.
sacudir algo	Lirijna.
sacudir con trapo para quitar el polvo o tierra	Toronja.
sacudir la cama	Torojka'waj.
sacudirse	Lirijcheł.
sacudirse la nariz	Suḿchi.
safarse	(por ejemplo un canasto de un gancho) Tańpa.
Sairama	(apellido) Sayra:ma.
sal	Do:yoń.
salado	Busuńni.
salado	Łoma'ni.
salar algo	Łoma'na.
salió como yo	Jayeni:kay.
salir	Chi:chi.
salir al paso	Kajłe:na.
salir de pena	Do'łe.
salir de pena terminar	Chopayni.
salirse del agua	Ko'lo:łe.
saliva	Alo:we.
saliva	Do:toń.
saltamonte o tucura	Sińdi.
saltar a algo	Desa:kwa.
saltar en el piso	Descheł.
saltar lejos desde arriba	Kulo:wiń.
salud!	Kila'wa.
saluda!	Pete:łe.
saludar	Pete:łe.
saludar a alguien	Peńna.
saludarse	Peńcheł.
saludo	Petełwa:nas.
salvar de un peligro	Toka'yaj.
salvarse	To'ya.
sama	Si:wa.
sanar	Tarałni.
sanar a alguien	Tarałna.
sancochar algo	Dejna.
sandia	Sani:ya.
sangrar	Chido:don.
sangre	Don'i.
santa rosita	(avecilla) Donajoylo.
sapito chico	Sulu:lu.
sapo	Wara'tey.
sapo escuerzo	Ulu'tey.
sarna	Nij'i.
sarnoso	Nijbeń.
sarso	Walaydi.
sartenejal	Bawaskwa.
sayubú	Si:siwa:di.
secar	Werelni.
seco	We'rel.
secretear	Ława'cheł.
se dice cuando una actividad a durado toda la noche	Al'imeł.
se dice sobre todo de ropa	Beyesni.
sedoso	Ni'loy.
sedoso	Ni'loyni.
se fue	Polala'as.
seguir a alguien sin que el lo sepa	Kwyna.
se huele	Payespayes.
semana santa	Kwaresma.
semblante de muerto	Kaynimo:ra.
semblante triste	Łavołavomora:ni.
sembradío	Wulwanra.
sembrar	Wulka:rim.
sembrar	Wulna.
semen humano	Lolo:lo.
semialtura	Roj'i.
semilla	Didinkwa.
semilla de joco	Warisdi.
semilla de lúcumo	Tichołdi.
semilla de naranja	Narasa:di.
semilla de papaya	Maropandi.
semilla grande	Dodo:kwa.
semilla que se usa para hacer collares	Kawayo:di.
sentado(a) en el agua	Asłol.
sentado(a) en el suelo	Asłabał.
sentado(a) en la estera	Aspo:jeł.
sentado al pie de un árbol	Asbojeł.
sentarse	Ascheł.
sentarse al pie de un árbol	Asbojełe.
sentarse en el agua	Aslo:łe.
sentarse en el suelo	Asłaba:łe.
sentido	To:ra.
sentir	Senna.
sentir algo	Payesna.
sentir algún pesar	Tivijpojkay.
sentir alivio	Jayawbaycho.
sentir cansancio	Yate:tej.
sentir deseo de algo que uno no puede tener	Che'che'e.
sentirse triste	Łavokabaycho.
señor	Pa'a.
señora	Ma'a.
separar algo	Ajna.
sepultado	Wulko.
sepultar a un muerto	Wula:ko.
será así	Di'joy.
ser abusivo	Pakapaka:ye.
será? palabra que utiliza para expresar incredulidad o sorpresa	Dojka.
ser así	Janlo:maj.
ser autoridad	Enonawa:nas.
ser blando movedizo	Likwi:kwiń.
ser capaz de alzar algo pesado	Daka:łe.
ser celoso	Keraaye:łe.
ser delgado	Soroyni.
ser enemigo	Alchiwanneni.
serere de la pampa	Piyo'.
serere del río	Chamba.
ser feo	Cho'esni.
ser filo	Peresni.
ser ganador	Jularawe:łe.
ser grasoso	Sumesni.
ser igual	Imkakara:ni.
ser la mitad de algo	Pascho.
ser lento	Ju:juma'lo.
ser madura una fruta	Bewni.
ser nacido	Donłe.
ser nutritivo	Su'mesni.
ser parecido	Jane:ni.
ser peligroso	Omawni.
ser pesado	Dino'ni.
serpiente cascabel	Oloba'was.
ser posible	Bisra.
ser soltero(a)	Jempa:ni.
ser valiente	Ove:ni.
servir comida	Wase:łe.
servite	Kila'wa.
ser vivo(a) entendido(a)	Paku'.
se siente	Payespayes.
seso	Tabvaloba:kwa.
se terminó su lengua	Ba:ruł.
se usa para nuera y yerno	Ulchał.
se usa para referirse a sus padres	Bija:jaw.
si	Jo:jo'.
sicurí	Yana:we.
siempre	Choń.
siempre hasta ahora	Daykaka.
si fuera	Disoy.
si fuera así	Ła'wa.
silbar	Siḿła.
silla	Si:ya.
silvaco	Bolawmo.
simbado	Samdinłew.
simbar	Samadinłew.
simbar lazo	Sama:di.
sin	Lol.
sin concluir	Mo:lowesni.
singa	Tokavewanra.
singuear	Toka:ve.
singuear	Tuka:ve.
sin mezcla	Jemme.
sin pantalón	Banal:ri.
sin ropa	Banne.
si pues	Choyrey.
siquiera	Beya'ka.
sirari	Tokwandi.
sirve	Kemakema:ra.
(situación demostrativa)	Ayru.
snacadilla	Sula:des.
sobaco	Chovajdimpo.
sobaco	Chowiń.
sobar despacio con algún ungüento	Jusna.
sobornarle a alguien	Chilna.
sobrar	Puńra:ni.
sobrar comida	Puta:ra.
sobresaliendo	Lemłe:łe.
sobrino	Ya:ni:kay.
sol	Tinno.
solamente	Ja'.
sol caliente	Dińwel.
soleado	Tinno:ti'.
solera de casa	Łała:kwi.
sólito	Soka'te.
solito(a)	Jempa:ni.
solo	Soka'te.
solo está la idea	Dis.
soltado	Rałpiń.
soltar	Nana:ra.
soltarse	Mańłe:łe.
soltarse	Ta'ka:pa.
soltarse de su penga	Lo'łe:łe.
sombra	Chanla:vał.
sombra	Lava:bał.
sombra	Lava:yas.
sombra	Lava:bał.
sombra	Lava:yas.
sombrero	Chorankwanto.
sonar	Siki:cheł.
sonar brevemente	Wutuscheł.
sonar fino como cristal	Sijilcheł.
sonido fuerte	Ditasłe.
son palabras demostrativas	Kolwa.
soñador	Beysikwampa.
soñar	Beysi.
soñar	Beysi:kwa.
soplador	Bo:ve.
soplador	Juḿwanra.
soplar	Javułna.
soportar	Jempa.
soportar algo	Jara'cho:na.
sordo(a)	Si'lo:to.
sorprender	Chika:pa.
sorprender hablando a alguien	Chika:wa.
sorprenderse	Jolbaycho.
suave	Jusawni.
suave	Ni'loy.
suave	Tiłoyni.
suavizarlo	Riłna.
subir a la nada	Welełka'asna.
subir al barranco	Welełba:łe.
subir arriba	Wele:łe.
su cabo	Baneła'a.
sucha	Tuspa'.
sucio	Cho'es.
sucio	Cho'esni.
su cola	Bałewa'a.
su color	Lowe:kwa.
sudor	Tayawlo.
suegro	Ulchał.
sueño	Beysi.
suficiente	Manra.
su follaje	Loranełe'as.
sufrir un percance	Rujlo:maj.
suicidarse	Tikoycheł.
sujal	Kwełrismo.
sujo	Kwełris.
sujo	(árbol) Ło'im.
sumamente	Tojeł.
su mango o cabo de un machete	Dineła'a.
sumergirse	Ya:ba:kwa.
sumuqué	(palmera) Morón.
sumurucucu	Tuku:ku.
sunchar algo	Cha'na.
sunchar con arma blanca	Chake:łe.
su par	Alchi.
suplicar	Karaye:łe.
su punta	Churudu'a.
su punta	Tu'ła'a.
sur	Ku:juy.
surcir algo	Waya'cho.
sur con agua	Kujuylu'u.
suspender las piernas a cada momento	De'kała:ri.
suspendido	De'łełe.
su tronco del árbol	Boboja'a.
su tronco del árbol	Bobojkwakwa'a.
Tababari	(apellido) Tawawa:ri.
tábano	Tenaymo.
tábano amarillo	Serejmo.
tábano grande	Chorammo.
tabla	Tawla.
tacú	Enłe:du'.
tacuara	Chiri:wan.
tacuara para flauta	Savu:di.
tajibo	Ta:wuł.
Talamani	(apellido) Talama:ni.
talar árboles	Latabojcha:vos.
tallo de la yuca	Layłapiteł.
talón	Ba:si.
tal vez	Jina'.
tamal	Boyboy.
tamaño	Janra.
tambalearse	Baska:to.
también	Jema'.
tapacaré	To'way.
tapado	Chuykwa.
tapar	Po'na.
tapar algo con su propia tapa	Poka:kwa.
tapar algo su abertura	Poka:cho.
taparse	Chankocheł.
taparse bien	Cho'ba:łe.
tapar una apertura con algo que no es específicamente su tapa	Chuya:kwa.
tapar una vasija que contiene algo	Roka:kwa.
tapeque	Chi:loj.
tapequearse	Chilojcheł.
tapera	Meme:di.
tapir	O:ma.
taracoe	Po'dala'.
tarántula	Kule:ma.
Taraune	(apellido) Tarawni.
tardar	Jumlo.
tardar una hora	Pe'oraneł.
tarde	Pola.
tardo	Ji:bal.
tarechi	Chi:tań.
tari	Ołneł.
tarope	Doyoḿpa.
tarro	Taro:ba.
tarumá	Che:kwes.
tatú	Sutulra.
taza	Ya:lowewamba:ni.
techar la casa con paja	Sama:ris.
techo	Ko:re.
técnicamente	Wuru:du.
tejer	Kojele.
tejer	Samna.
tejer sombrero	Sama:to.
tejón	Bi:chichiḿma.
tela	Do'ewa:noj.
tela negra	Tun'oj.
teléfono	Iwaniwamba:ni.
temblar	Liti:tiń.
temer	Tino'ba:na.
temor a un peligro	Onridisni.
templado	Kwiri:dil.
templar a algo o a alguien	Kwirilna.
tender algo al sol	Ilna.
tender algo con su apertura al sol	(por ejemplo una tutuma para seque por dentro) Ila:cho.
tender chive	Ila:cho.
tender ropa para que seque	Ila:'oj.
tener ave	Joḿjoḿme.
tener cabello crespo	Mulayni.
tener calambre	Way'kachocho.
tener cicatrices	Sili:ni.
tener conocimiento	Bispa.
tener cuidado	Jayawkapa:na.
tener deudas	Bawabawa:ra.
tener el cabello crespo	Mulaykaba:kwa.
tener en la boca	Uykwa.
tener fallo de un ojo	Pascho:ra.
tener frío	Jilo:ka.
tener hipo	Łe'kwa.
tener ideas	Pembaycho.
tener la oreja cortada	Tanloto:veł.
tener larga respiración	Ku:te'.
tenerle lastima a alguien	Łavoye:na.
tener más	Nayra.
tener miedo	Dayimni:wa.
tener miedo	Tino:ka.
tener noticia	Paku'na.
tener otra cosa que hacer	Sońtijna.
tener presentimiento	Jambaycho.
tener sed	Ya:lowesicha'kwa.
tener sueño	Jorosicha'kwa.
tener una buena vista	Dewajkwi.
tentar	Otolna.
teñir algo	Łoyna.
terminado	Ba:lomaj.
terminar	Bara:na.
terminar de arder	Ba:le:les.
terminar de bañarse	Ba:ła:vij.
terminar de caer una fruta	Ba:ris.
terminar de comer	Ba:bu.
terminar un evento	Ba:loweskwiwa:wa.
termino que se utiliza como saludo de respeto a una mujer mayor	Ke'e.
termino usado entre mujeres	Chejta.
terraplén	Payto.
terraplenar	Ela:cho.
terreno plano	Imkakawajni.
testículos	Loto:di.
teta	Chajkwa.
tía	Ay'ku.
tiempo	Tino:na'.
tiempo bueno	Jaya:was.
tiempo caluroso	Ewelwa:wa.
tiempo con amenaza de lluvia	Ruja:jas.
tiempo de agua	Tomi:na'.
tiempo de cosecha	Tanadiwa:wa.
tiempo de guayaba	Padiwa:wa.
tiempo de la viruela	Dorosbawa:wa.
tiempo de lluvia	Lu'cho:na.
tiene 10 cm de largo	Olo'tey.
tiene color	Lowe:kwa.
tiene delito	Kovijko:vij.
tierra	Łakaḿba.
tierra greda especial para alfarería	So'la.
tiesto	Wereycho.
tigre	Rulrul.
tigre gente	Juyenirulrul.
tiluchi	Titi:ti.
tinaja	Loto:ba.
tío	Ya:ya'.
típicamente de curi	Cha'di.
tipo de caña	Kaya:na.
tipoy	Chon'oj.
tirado o botado en el agua	Jara'loł.
tirar con buena puntería	Bisi'na.
tirarse al agua	Jara'lo:łe.
tirarse al agua	Manlo:łe.
tirarse o caerse al agua	Chosoma'ni.
tizón	Veba:kwa.
tobillo	Lotoba:kwi.
tocar algo	Otolna.
tocar instrumento	Ponot'.
tocar instrumento de viento	Javułna.
tocar una canción	(por ejemplo con guitarra) Pono:na.
tocar un instrumento	(por ejemplo el tambor) Bayna.
tocayo	Ełpanchi.
toda la noche	Al'imeł.
todas las veces	A:lalas.
todavía	Di:ra.
todavía	Mo.
todavía	Paspas.
todo	Pe'łełe.
todo completo	Ba:ra.
todo cortado	Tanka:ba.
todo el día	Pe'ye:mes.
todo mordido	(por ejemplo una fruta) Danka:ba.
tojo del grande	Jo:ri.
tojo del pequeño	Nunris.
toldo del carretón	Kamaro:te.
tomar beber	Ya:lo:we.
tomar café	Kapelo:ti'.
tomar chive preparado	Boya:lo.
tórax	Be'łała.
torcer algo	Damoyna.
torcer algo	Davulna.
torcerse	Ralcheł.
torcido	Salkacho.
tordo	Chi:ko'.
torrarse	Sedenni.
tortita de almidón de yuca	Mo'inchoba.
tortuga	So:no.
tos	Jo:wo.
toser	Jowo:kwa.
tostado	Deń'i.
tostar algo	Deńna.
tostar chive	Chawa:cho.
totachi	Tojtey.
totaí	Pu:rań.
totora	Pe:ra.
totora fina	Chukuwampa.
totora nudo ciega	Chompa.
trabajador	Tijkarimpa.
trabajar	Tijka:rim.
trabajar con una sola mano	Pasyiń.
trabajo	Tijkarimwa:nas.
trabajoso	Batejasra.
traer agua	Ja:mi.
traer algo	Jiwałe:na.
traer de vuelta	Salmołe:na.
traer el ganado	Ja:poy.
tragar	Kobe:łe.
tragar agua	Koka:mi.
tragar algo	Ko'na.
tragar algo pequeño	Koka:di.
tranquilidad	Jayawbaycho.
transparente	(por ejemplo el agua) I:lim.
trapo	Dońwanojbeń.
trasero	Kwanres.
traspasado	Dońpiń.
traspasar algo con algo punzante	Doka:piń.
trasplantar una planta	Dowajbojna.
traste	Dayajna.
trastes	Tijkaka:ra.
tratar a alguien mal con palabras groseras	Donkara:na.
tratarle	Lawajesna.
tratarle	Lawajesna.
travieso	Kwajtej.
traza de manechi	Judimlo:wes.
trazado	Sawi:pa.
trenzado	Samdinłew.
trenzar el pelo	Samadinłew.
trepador(a)	Welełpa.
trepar	Wele:łe.
trepar a un árbol o palo	Upa:vos.
tres	Tasra.
tribu desaparecida	Molo:we.
trinidad	Tirinra.
tripas	Chiraskwa.
tristeza	Da:yim.
tronar	Wurulcheł.
tronco	Bakwanłe:kwa.
tronco	Bobojkwa.
tronquito de árbol	Ko'ba:ri.
tropezarse	La'dimpoj.
truncar	Rujkapa:na.
tu	Ij.
tu	Ulkwań.
tucán	Wonowo'.
tucandera	Tu:we.
tucunaré	Bojkoń.
tuerto	Pascho:ra.
tuétano	Tava:lo.
tumbar algo de arriba	Loka:łe.
tumbar algo o a alguien	Łoka:poj.
tumbar árboles	Lata:boj.
tunante	Tolacho:pa.
tunar	Tola:cho.
tupido	Du:yuḿ.
turbarse	Sankapa:na.
turbio	Koybubu'.
turbión	Cheslo.
turo	(caracol del agua) Mejła.
turril	Turil.
tutuma	Sapa'mo.
tutumillo	Sapa'monana.
ubicarle un lugar a alguien	O:kawajna.
ubicar su lugar	O:kakawajcheł.
ubre de animal	Chajkwa.
ultrajarlo	Ke'a:ra.
una botella entera	Pe'bał.
una cosa	Sota'ra.
una cosa concluida	Joyra:ni.
una hora entera	Pe'o:ra.
una lágrima	Lodinkwa.
una noche con luna	Je:lew.
una sola persona	Soka'te.
una u otra persona	So:kate.
una vez	Sota'lo:maj.
un avión	Pencheł.
un montón	Sota'lo:ba.
uno	Sota'ra.
un poco más	Dochi'.
un racimo entero	Pe'pojeł.
untar	Jusna.
untar	Rińna.
uña del pie	Chorimpa.
uña del pie	Chorimpoj.
urucú	Chuchuchi.
usted	Ij.
usted	Ulkwań.
utensilios	Tijkaka:ra.
utensilios para guardar cosas	Amka:rim.
vaca	Wa:ka.
vaciar	Bońyełna.
vacío	Ama'kwa'a.
vagina	Ła:cho.
vaina	Dodo:kwa.
vaivenearse a causa de algo	Matoy'kałe:łe.
vaivennear	Matoy'kałe.
vale la pena	Wawalo:maj.
valiente	Da:rań.
vamonos	Jiyakweł.
vamos	Jiya.
vampiro	Wo'ray.
vapor	Ru:du.
vaquilla	Kaki:ya.
vara larga	Ku:ri:di.
varias cosas	Ta'ka:pa.
varilla cortita	Te:ridi.
varilla del mosquitero	Tu'chołwanri:di.
varita de madera	Kori:di.
varón	Alla:kwa.
vaso	Wa:so.
vaso	Ya:lowewamba:ni.
váyase	Jay'i.
vecino o compañero de vivienda	Asto'maj.
vejiga urinaria	Chojwamba.
vela	Ve'e:piń.
veloz	So:riń.
ven	Jela.
ven	Je'la.
venado	Poyyey.
venderlo	Rima:łe.
venga	Jela.
venga	Je'la.
vengarse	Bawpane:łe.
venidero	Telayni.
venir	Jiwa:wa.
venteador	Juḿwammo:ni.
venteando del sur	Kujuyti'.
ventear algo	Juḿna.
ventear algo	Kavujna.
ventilado	Kavu'ni.
ventón	(pez) Se:ya.
ver	Velna.
ver algo	Dewajna.
verano	Ewelwa:wa.
verdadero	Wawalo:maj.
verde	No'na.
vergonzoso	Chajanni.
verija	Pojsi.
ver las huellas de alguien o algo	De:wajna.
ver lo que alguien hace y no entenderlo	De:pa:na.
verter sangre	Chido:don.
vestimenta	Do'we.
vestimenta de las personas	Do'wewanra:ni.
vestirse	Do'we:cheł.
vete	Jay'i.
vi	(árbol) La:va.
viajar	Jo:be.
viajero	Jobewanne.
víbora	Mimi:di.
víbora yoperojobobo	Chondini:wa.
victima	Sanka:ye.
vida	Ite'niwa:nas.
vidrio	Todankwa.
viejito	Bito'.
viejo(a)	Bi:jaw.
viento	Powmuj.
viento del este	Jata'mu:muj.
viento del norte	Choymuj.
viento del oeste	Deke'mu:muj.
viento del sur	Kujuymuj.
viento fuerte	Dińmuj.
viento huracanado	Bubuyaka:pa.
vieras que estoy yeta	Je:ni.
vigilar a alguien	Pachołcha:ye.
violín	Pono:na.
viruela	Dorosba.
visible	Chondusłe.
visitar	Pa'kachołna.
visitar a alguien	Dulna.
visitar a personas	Dula:ye.
vistar a una mujer	Tola:cho.
viudo	Kayni:beł.
vivienda	Asna.
vivienda	Aswa:nas.
vivienda de la banda	Aldimmajye.
vivir juntos	Asu'tomajni.
vivir sufriendo	Łavo:ra.
volar	Javu:buḿ.
volcado	Jolkwa.
volcar	Paka:si.
volcarse	Pa'sine:łe.
volcarse de un lado para otro	Volkato:choł.
voltear el cuerpo	Vola:kwa.
volver	Salmo.
volver a casa	Chona'naj.
volverse en	Volrada.
volverse pesado	Dino'ni.
volverse rojo	Rapalni.
vomitar	Lelkwa.
vomitar un líquido	Choya:lo.
voz gruesa	Wurultu.
y	Che.
ya	Jayna.
yacuma	Ya:koma.
Yalawma	(apellido) Yalawma.
ya vuelvo	Sala'mo.
yo	Ił.
yo	Inła.
yo	Iń.
yomomal	Betełkwammo.
yomomo	Betełkwa.
yuca	Chinała.
yuca frita	Deńchołpa.
zambullir	Luḿluḿ.
zapallo	Wa:ris.
zaraso	Sanuyni.
Zelady	(apellido) Sela:di.
zorrino	Wa'wa.
zorro	Pa:kona:na'.
zunchar algo para ver qué es	Chu:na.
