abajo	Aynacha
abogar	Arxataña
abortar	Sulluña
abrazar	Qhumaña
abril	Yapu apthapi phaxsi
abrir	Jist'araña
absceso	Jinq'i
abuela	Awicha
abuelo	Achachila
acariciar	Munaraña
acicalado	Q'uma
acomodar	Uchaña
acompañar	Irpaña
acoplar	Wakthapiyaña
acordar	Amtaña
acrecentar	Mirayaña
acta	Amta qillqata
acuerdo	Amtawi, amuyt'a
adelantarse	Nayrt'aña
adherir	Lip'iyaña
adivinanza	Katjawi, chiqt'aña
adobe	Tika
adolescente	Yuqalla
adoptivo	Uywata
adorar	Yupaychaña
adornar	K'achachaña, sumachaña
afiche	Yatiqawi laphi
agitar (agitar haciendo movimientos en círculo)	Khiwiña
agosto	Thaya phaxsi
agradable	Suma, muxsa
agrandar	Jach'aptayaña
agua limpia	Ch'ika uma
águila	Paka
ahogo	Axskataña
ahora	Jichha
ajo	Ajusa
ala	Chhiqa
alborada	Willjta
alegre	K'uchi
alfabeto	Achakaja
algodón	Qhiya
almácigo	Mallki
alojado	Qurpa
alpaca	Allpachu
alzar (alzar con las manos, ver levantar)	Aptaña
amanecer	Qhantati, inti willjta
amar	Munaña
amarillo	Q'illu
amarrar	Chinuña, ñach'aña
amasar	Chapuña, ñatuña
amontonar	Phinaña
amontonar tubérculos	Qutuchaña
ampolla	Pullullu, phusullu
anaranjado	Churi q'illu
ancho	Qhanqha
anciana	Awicha
anciano o anciana	Chuymani
andén	Pata
andenería	Patapata
ángulo	K'uchu, kachja
ángulo agudo	K'ullk'u k'uchu
ángulo recto	Chiqa k'uchu
anillo	Siwi
animal	Uywa
animal doméstico	Axa uywa, uta uywa
animal enano	P'ilti
aniversario	Jach'a uru
ano	Jamaña
anochecer	Arumthapi, ch'amakthapi
anteayer	Walüru
año	Mara
apacheta	Apachita
apacible	Llamp'u chuymani
aportar (aportar dinero)	Ramaña
aprender	Yatiqaña
apuntalar	Saykatayaña
arado	Arma
araña	Kusikusi
árbol	Quqa
árcilla	Llinkí laq'a
arco iris	Kurmi, kutupi
arder	Nakhaña
arena	Ch'alla laq'a, aqu
arena fina	Ñut'u ch'alla
armadillo	Khirkhi
arrancar (arrancar hilo)	T'aqaña
arrear (arrear ganado)	Anakiña
arreglar	Askichaña
articular palabras	Aruña
asa de las vasijas	Jinchu
asado	Aycha kanka
asamblea	Mathapiña, tantachasiwi
asco	Axta
asfixia	Samana llupht'ata
asignar	Uñachayaña
asperjar	Ch'axch'uña
aspiración	Samantaña
asustar	Mulljaña
atado	Q'ipi
atardecer	Jayp'thapi
atrás	Qhipa
aula	Yatiqawi uta
aumentar	Yapaña
autoridad	Jilïri
avergonzar	Phinq'achaña
avergonzarse	Phinq'asiña
averiguar	Yatxataña
avisar	Yatiyaña
ayer	Masa uru
ayudar	Yanapaña
azufre	Asuphri
azul	Larama
bacteria	Jisk'a laq'u
bailar	Thuquña
bajar (bajar cosas, trasladarse)	Apaqaña, saraqaña
balsa	Walsa, wampu
bañarse	Jarisiña
barba	Sunkha
barranco	Axa
barriga	Puraka
barro	Ñiq'i
bastante	Alluxa, walja
bastón	Thujru
basura	T'una
basurero	T'una uchaña
batán	K'iyaña
batán	Piqaña
batán	Qhuna
batir	Jiruña
bayeta wayita, (un tipo de bayeta)	Kastilla wayita
besar	Jamp'atiña
bienes	Yänaka
bilis	Asu
blanco	Janq'u
blanco sucio	Churi
blando	Jasa
boca	Laka
bolsa (bolsa pequeña tejida)	Wayaqa
borde (borde del río, orilla del lago)	Jawira laka, quta laka
borde de un cuerpo	Qawaya
borla	K'anchila
borrar	Pichaña
bostezar	Ansaña
botar (cosas, botar agua o botar granos)	Jaqtaña , wartaña
brazada	Luqa
brillante	Qhisqha
brillar	K'ajaña, llijuña
brotar (salir la planta de la tierra)	Alsuña
bueno	Suma
buho	Juku
buitre	Siwiq'ara
burro	Asnu
buscar	Thaqaña
caballero	Wiraxucha
cabello	Ñik'uta
cabello rubio	Quri ñik'uta
cabeza	P'iqi
cabeza de familia	Awki
cactus	Achakaña
cadaver	Amaya
cadena	Axu
cadera	Thixni
cal	Q'atawi
caliente	Junt'u
calor	Inti lupi
calor solar	Lupi
calumniar	Lutiña, k'arintaña
cama	Ikiña
camellones	Waru waru
camino	Thaki
camisón	Allmilla
camote	Apichu
canica (fruto de baya negra)	Ch'uch'u
cansarse	Qariña
cantar	Waruriña
cántaro de barro	Yuru
cañihua	Qañiwa
capturar	Chakuña
capullo	Amucha
cara	Uñnaqa
cara (del ser humano y de los animales, superficie plana de los sólidos)	Ajanu
carachi	Qarachi
carbón	K'illima
cárcel	Mutüwi, wata uta
carga	Khumu
caries dental	Laka k'ama
carnavales	Anata
carne	Aycha
carne cocida	Chichi
carnívoro	Aycha manq'iri
carretera	Jach'a tupu, tupu
casa (casa en forma de cono)	Putuku
casa	Uta
cáscara	Sillp'i
cazar	Chakuña
cebada	Siwara
cebada pelada	Phata
cebolla	Siwilla
cecina	Ch'arki
celeste	Sajuna
cementerio	Amaya imaña uyu
ceniza	Qhilla
centena	Patakachata, patakanaka
centímetro	Mitru patakachjata
centro (centro o mitad de las cosas)	Chika
centro poblado	Juk'a tanta utanaka
cercanía (proximidad en el espacio y en el tiempo)	Jak'a
cerdo	Khuchi
cereal mal molido	Chhaku
cernir	Susuña
cernícalo	K'ilik'ili
cernidor	Susuña
cerro	Qullu
cerro tutelar	Pukara
chachacoma (planta medicinal)	Chachakuma
chacra	Yapu
chalona	Chaluna
charango	Khirkhi
chasqui	Yati apiri
chiste	Llarusiña yatiyawi
chullo	Ch'ullu
chuño (papa procesada por medio de la helada)	Ch'uñu
chupar	Ch'amuña
ciego	Juykhu
cien	Pataka
cilindro	T'uyu
cinco	Phisqa
cintura	Juch'usa jikhani
círculo, circunferencia	Muyu
claridad	Qhana
clase	Kasta
clavícula	Qhiwi ch'aka
cobarde	Axsariri
coca	Kuka
cocer cebada pelada	Phataña
cocido (cocido con el calor del vapor de agua hervida)	Phuti
cocinar	Phayaña
codo	Mujlli
codorniz	Khullu
cola	Wich'inkha
colgador	Warkuña
colgar	Warkuña
color blanco y negro entremezclado	Ch'ixa
color	Sami
color café, rubio	Ch'umphi
color rubio	Paqupaqu
colorear	Samichaña
columna vertebral	Jikhani k'ili
comadreja	Achuqalla
comenzar	Qalltaña
comer	Manq'aña
cómico (personaje cómico de una danza)	K'usillu
comida	Manq'a
compadre	Kumpayri
compañero	Yatiqiri masi
comparar objetos	Tupaña
competencia	Atipa
completar	Phuqaña
comprar, adquirir objetos con dinero	Alaña
comprar todo	Alsuña
concluir	Tukuña
condimento	Manq'a sumachiri
cóndor	Kunturi
cono	Pullu, putuku
consejo	Arxata, iwxa
construir andén	Patachaña
contador	Jakhuri
contagiar	Piyayaña, usu katyaña
contaminar	Q'añuchaña
contar	Jakhuña
contorno	Muyta
convertirse	Tukuña
corazón	Lluqu
cordel	Kira
cordillera	Khunu qullu
correo	Yati apiri
correr (correr del agua, andar de personas o animales)	Aywiña
cortar cosas	Khuchuña
cortar cabellos	Muruña
corteza	Sillp'i
cosas	Yänaka
cosechar tubérculos	Llamayuña
coser	Ch'ukuña
costa	Lamara tuqi suyu
costado (lado del cuerpo ubicado a la altura de los riñones)	Ch'illa
costalillo	Tupillu
costura	Ch'uku
crear	Uñstayaña
crecer	Jilaña
cresta	K'ara
cría (cría de animal en orfandad)	Chita
cría	Qallu
criar	Uywaña
crucigrama	Kitjata arunaka
crudo	Ch'uqi
cuaderno	Qillqaña panka
cuadrado	Pusi k'uchuni
cuarta	Chhiya
cuatro	Pusi
cucharón	Wislla
cuchillo, objeto cortante	Khariña
cuello	Kunka
cuento	Jawari
cuerpo	Janchi
cuesta	Amsta
cueva	Tiyi
cuidar	Uñjaña, uywaña
culebra	Asiru
culpa	Jucha
cultivar plantas	Yapuchaña
cultura	Yati
cuociente	Lakita
curar	Qullaña
cuy	Wank'u
danza (danza costumbrista que bailan después del techado de la casa)	Achuqalla
dañino, daño	Ñanqha
dar	Churaña
dar puñetazo	Ch'akuña
de ninguna manera	Janipuni
decena	Tunkacha, tunka
decisión	Amuyt'a
decolorido	Qaqa
defecar	Jamaña
defender	Arxataña
degollar	Khariña
delante	Nayraqata
delito	Jucha
denominador	Pachjiri
dentro	Manqha
departamento	Jach'a suyu
derecha	Kupi
desaparecer	Chhaqaña
desatar	Jararaña
descolorido	Churi
desear	Munaña
desenredar	Sanuña
desgracia	Chiji
deslumbrar	Llijuña
despeñadero	Axa
después	Qhipa
devolver	Kutt'ayaña
día	Uru
día siguiente	Qhara uru
dialogar	Parlakipaña, aruskipaña
diarrea	Jiphilla jaqukipata, kursu usu
diarrea	Wich'u
dibujar	Rixiña
diccionario	Aru pirwa
diciembre	Jallu qallta phaxsi
diente	Laka ch'aka
diez	Tunka
diferente	Mayja
dinero	Qullqi
dios	Tatitu
dios tutelar	Apu
dirigente	P'iqt'iri
discutir	Kutkatasiña
disminuir (disminuir cosas)	Apaqaña
distinto	Mayja
distrito	Jisk'a t'aqa suyu
dividendo	Lakiyasiri
dividir	Jaljayaña, lakiña
divisor	Jaljatiri, lakiri
divorciarse	Jaljtaña
doblar	Suk'aña
domicilio	Utjawi
domingo	Inti uru
dormir	Ikiña
dos	Paya
dulce	Muxsa
duro	Qhuru
echar líquidos o granos pequeños	Wartaña
echar agua	Qhallaña
él	Jupa
ella	Jupa
embarazada	Usuri
empujar	Nukhuña
encerrar	Llawintaña
encima	Pata
encontrar	Jakiña, katjaña
enfermar	Usuña
enfermedad	Usu
enfermo	Usuri
enjuagar	Aytiña
ensuciar	Q'añuchaña
enterrar	Allintaña
epilepsia	T'uku usu
época seca	Awti pacha
época lluviosa	Jallu pacha
equivocarse	Pantjaña
esa (pronombre)	Uka
esclavitud	T'aqisiyäwi
escoba	Pichaña
escoger frutos, vegetales y animales	Ajlliña
escozor	Jasi
escribir	Qillqaña
escrito	Qillqa
escrito en general	Qillqata
escuadra	K'uchu tupuña
escuchar	Ist'aña
escuela	Yatiña uta
escurrir	Ch'umaña
ese	Uka
eso	Uka
esófago	Mallq'a
espalda	Jikhani, ati
espiga	Pula, puya
espina	Ch'api
espiración	Samsuña
espíritu ancestral	Awicha
esta	Aka
estatura	Tansa, saya
este (lo que esta cerca de la persona que habla	Aka
esternón	Tujtuka
estiércol de oveja, llama o alpaca	Q'awa, wanu, thaxa
esto	Aka
estrella	Warawara
eterno	Wiñaya
excedente	Jila, jilt'a
excluir	Apsuña, chhijllamukuña
excremento	Jama
existir	Utjaña
extender	Janatataña, jant'akuña
extinguirse	Chhaqtaña
extraer	Apsuña
extraviar	Chhaqayaña
fábula	Yatichawini jawari
faja	Wak'a
familia de palabras	Arunaka phamilla
faz	Uñnaqa
febrero	Anata phaxsi
fémur	Chara ch'aka
feria	Qhatu
festejar	Phistachaña
feto	Sullu
fiesta	Phista, phunchawi, pura
fila	Siqi
finigénito	Chana
flecha	Mich'i
flor	Panqara
florecer	Panqaraña, phanchaña
fogón	Qhiri
fortaleza	Pukara
fracción	Pachjta
frazada	Chusi, ikiña
frío, muy frío, helado	Ch'uch'u
frío	Thaya
frotar	Qaquña
frustrarse	Qulluña
fruto (vegetales)	Achu
fuego	Nina
fuerza	Ch'ama
futuro	Qhipa
gallina	Wallpa
gallo	Chhanka, ququrichi
ganado	Uywa
garapata	Jamak'u
gastritis	Puraka tini
gato	Phisi
gavilla (pequeña gavilla de cebada)	Chulla
girar	Muyuña
golpear	Jawq'aña
gorro	Q'aspa
gota	Ch'aqa
grande	Jach'a
graneado	K'aja
granear	K'ajayaña
granero	Pirwa
granizo	Chhijchhi
gresca	Ch'axwa
gripe	Jurma usu, pisti
guanaco	Wanaku
guano	Wanu
guano de las islas	Mataxi
guardar	Imaña
guisar (guisar cereales)	Phataña
gusano	Laq'u
haba	Jawasa
hablador	Parliri
hablar	Parlaña, arsuña
hacer	Luraña
hacer producir	Achuyaña
halcón	Mamani
hambre	Awtja
harina de cereales cocidos	Aku
harina de cereales crudos	Aqallpu
harina de maíz	Tunqu jak'u
helada	Juyphi
hembra	Qachu
hermana	Kullaka
hermano	Jilata
hermoso	Suma
hervir	Wallaqiyaña
hierba cana	Qhanachu
hígado	K'iwcha
hija	Phucha
hijo	Yuqa
hilo de lana	Ch'ankha
hinchazón	P'usu
hito	Qurpa
hoja (hoja de plantas y de papel)	Laphi
hombre	Chacha
hombro	Taru, tarku
homogéneo	Khuskha
honda	Q‘urawa
hondonada	Phutunku
hormiga	K'isimira, qanlli
hoy	Jichha uru
hoz	Jusi
hueco	P'iya
huérfano	Iñu, wajcha
hueso	Ch'aka
huevo	K'awna
humear	Jiwq'iña
humo	Jiwq'i
ibis	Ch'uwankira
idéntico	Kikipa
identificar	Uñt'aña
igual	Kikipa
imaginarse	Samkaña
imán	Achkatasiri
impar	Ch'ulla
indice	Utjirinaka
infección	Añata
instrucción	Yatiñataki arunaka
inventar	Uñstayaña
ir	Saraña
iris	Nayra mami
izquierda	Ch'iqa
jabón	Jawuna
jaguar	Jach'a titi
jarro	Jaruchi
joven de sexo masculino	Wayna
juego	Anata
jueves	Ururi uru
jugar	Anataña
juguete	Anataña
junio	Juyphi phaxsi, willka kuti phaxsi
juntar	Mayachaña, apthapiña
junto (estar junto con otras personas)	Chika
kilo	Kilu
lado	Qawaya
ladrón	Jawq'a, lunthata
lagartija	Jararankha
lago	Quta
lago titicaca	Titiqaqa
lágrima	Jacha
lamer	Jallq'aña
lápiz	Lapisa
largo	Sayt'u
lavar (lavar la ropa, la cabeza)	Jariña, t'axsaña
leche	Millk'i, ñuxñu
leer	Ullaña, uñaña
legua	Tupu
lejanía (espacial y temporal)	Jaya
lengua	Aru
lengua oral	Arsuta aru
leña	Lawa, phayaña
lesión	Chhuxri
letra	Qillqa
letra mayúscula	Jach'a qillqa
letra minúscula	Jisk'a qillqa
levantar objetos largos, palos	Aytaña
levantar con las manos	Aptaña
levantar una masa o barro	Llawch'taña
levantar cereales entre los dos brazos	Marqtaña
levantar cereales entre las dos manos juntas	Phuxtaña
levantar ropa o tejidos entre los dos brazos	Quttaña
levantar palos en el hombro	Qhitaña
levantar en una manta pequeña cereales	Unktaña
levantar recipientes por su asa	Waytaña
levantar entre los dientes	Achtaña
levantar a bebés, niños y animales pequeños entre los brazos	Ichtaña
levantar la piedra con las manos	Ittaña
levantar prendas o una tela	Iqtaña
levantar cereales empuñándola con una sola mano	Jachtaña
levanta cosas en el regazo	Jarphtaña
levantar algo en una manta por sus cuatro puntas	Kalltaña
ley	Kamachi
leyenda	Jawari
libertad	Atiniña
libertador	Atiniñaptayiri
libro	Liwru
limpiar	Pichaña, q'umachaña
limpio	Q'uma
lindero	Qurpa
liviano	Suja
llama (camélido)	Qarwa
llamar	Jawsaña
llegada	Puriwi
llegar	Puriña
llevar	Apaña
llevar en brazos un bebé o persona	Ichuña
llevar en la mano objetos pequeños	Irnaqaña
llevar algo en la boca	Achuña
llorar dando gritos	Jachaña, k'ajaña
lluvia	Jallu
lodo	Ñiq'i
lombriz	Sillq'u
loro (variedad de loro)	K'allalla
luminoso	Qhisqha
luna	Phaxsi
lunes	Phaxsi uru
macho	Urqu
madeja	Juñi
madre	Tayka
maduro	Puquta
maíz	Tunqu
mala hierba	Wati qura
malagüero	Qhincha, watiqa
malo	Jani wali
mama	Ñuñu
mano, extremidad superior	Ampara
manta de mujeres para llevar cosas en las espalda	Q'ípxaru
manta pequeña multicolor para manejar coca	Istalla
manta que suelen usar los hombres para llevar cosas en la espalda	Mantiyu
manta multicolor de mujeres para llevar cosas en la espalda	Wayllasa awayu
manta de mujeres para protegerse la espalda	Thap'isiña awayu
mañana	Arumanthi
mar	Lamara
mariposa	Pilpintu
mariposa nocturna	Pharayli
martes	Ati uru
marzo	Achuqa phaxsi
masajear	Qaquña
mate	Pulu
matrimonio	Jaqichasiña, kasarasiña
mayo	Llamayu phaxsi
mayor	Jila
mayor que	Jilacha
mazamorra	Allpi
medianoche	Chika aruma
medida de pie	Kayu takt'a
medida del antebrazo	Mujlli tupuña
mediodía	Chika uru
medir	Tupuña
meditar	Amuyaña
menor	Sullka
menor que	Juk'acha
mentira	K'ari
mentón	K'achi
menudo (tubérculo menudo)	Llullu
mercado	Rikuwa
mes	Phaxsi
meta	Puriwi
metacarpio	Chhunqallu
metatarso	Chhunqallu
mezclar	Ch'axlluña, kitjaña
miedo	Axsaraña
miel	Misk'i
miércoles	Wara uru
mil	Waranqa
mina	Qhuya
minuto	T'ijuqa
moco	Jurma
modificador	Mayjachiri
mojado	Ch'araña
moler	K'iyaña, piraña, qhunaña
molle	Mulli
mono	K'usillu
montón	Qutu
morado,violáceo	Anti
morir	Jiwaña
mostrar	Uñachayaña
moteado	Allqa
mover	Unuqiyaña
mucho	Walja
mugre	Q'añu
mujer	Warmi
multiplicar	Mirayaña
mundo	Pacha
murciélago	Chiñi
muslo	Chara
nacer	Yuriña
nacido (recién nacido)	Asu wawa
nariz	Nasa
negro	Ch'iyara
nevada	Aqarapi, khunu
nido	Tapa
nieta	Allchhi
nieto	Allchhi
nieve	Khunu
no	Jani, janiwa
noche	Aruma
noche oscura	Payi
nombre	Suti
norma	Kamachi
noviembre	Awti phaxsi
nube	Qinaya
nudo	Chinu
nuevo	Machaqa
numerador	Pachjata
número	Jakhu
nunca	Jani mayampi, janipuni
paciente	Usuri
padecer	Mutuña, t'aqisiña
padre	Awki
página	Jalja laphi
país	Jach'a marka
paja	Jichhu
paja brava	Iru jichhu
pájaro	Jamach'i
palabra	Aru
palitos para tejer a mano	P'itaña
palma	Ampara qutaña
palma (medida de la palma de la mano)	T'axlli
palo	Lawa
paloma	Kitula
pan	T'ant'a
pantano	Juqhu
papa	Ch'uqi
papa sancochada	Qhati
papalisa	Ulluku
paralítico	Such'u
pararse	Sayt'aña
pared	Pirqa
pariente	Wila masi
parir (dar a luz de las mujeres)	Wawachaña, ususiña
paso	Chillqi
pastear	Awatiña
pasto	Q'achu
pecado	Jucha
pedazo	T'aqa
pedo	Sira
pegar, agredir	Nuwaña
pegar, unir con goma	Lip'iyaña
peinar	Sanuña
peine	Sanu
pelar (quitar cáscara)	Sillp'iraña
pelea	Ch'axwa
pena	Llaki
pendiente, en suspenso	Sayt'aña
penoso	Ch'ama
pensar	Amuyaña, lup'iña
pequeño	Jisk'a
perdiz	P'isaqa
perímetro	Muyta, qawaya
perinola	Phiriru
perro	Anu
persona	Jaqi
pesado	Jathi
pez	Challwa
picaflor	Luli
picar	Mich'iña
pico de las aves	Chhuru
pie	Kayu
piedra	Qala
piedra sagrada	Wak'a qala
piel	Janchi
pintar	Samichaña
pisar	Takiña
placenta	Jakaña
planeta	Pacha
planeta tierra	Aka pacha
planta medicinal	Qulla mallki
planta silvestre	K'ita mallki
plátano	Puquta
plato (plato de arcilla)	Chuwa
plato de barro	Ñiq'i chuwa
plomo	Ch'ikhu
pluma	Phuyu
poblador serrano	Thaya suyu jaqi
poco	Juk'a, pisi
podrirse	Ñusaña
poesía	Jarawi
pollera	Pullira
pollito	Chhiwli
pollo	Chhiwli
polvo	Laq'a
poncho	Punchu
poner	Uchaña, uskuña
porción de tiempo y espacio	T'aqa
posta médica	Qullaña uta
pozo	Phuju
precio de un objeto	Alapa,chani
predicado	Lurata
preguntar	Jiskhiña
preñada	Wallq'i
preparar	Wakichaña
préstamo	Chari
préstamo en dinero o productos	Manu
primavera	Phanchiri
primero	Nayrïri
primogénito	Jilïri
prisión	Wata uta
probar	Mallt'aña
probar alimentos	Yant'aña
procedencia	Yuriwi
producir (vegetales)	Achuña
profesor	Yatichiri
prohibir	Jark'aña
proteger	Arxataña
proteinas	Ch'amanchiri manq'a
provincia	Jisk'a suyu
puente	Chaka
pulmón	Chuyma
puna	Juyphi tuqi suyu, suni
punto	Ch'aqa
puñado	Phuxtu
puñetazo	Ch'aku
puño	Ampara muquchasita
pupiletras	K'anata aru
pututu	Pututu
quebrada	Qullu laya
quebrar	P'akjaña
quemar	Nakhaña, phichaña
quena	Qina
queso	Kisu
quinua	Jiwra, jupha
quishuar	Kiswara
rabo	Wich'inkha
raíz de los vegetales y de las palabras	Saphi
rana	K'ayra
rastrojo de tubérculos	Qhanuna, qallpa
ratón	Achaku
rayo	Illapa
rebaño	Tama
reboso	Chuku
receta para cocinar	Phayaña wakichawi
reciprocidad	Ayni
recoger	Apthapiña
recomendación	Arxata
reconocer	Uñt'aña
recordar	Amtaña
rectángulo	Wiskhalla
recuerdo	Amta
reflexionar	Amuyaña
regazo	Jarphi
región andina	Thaya tuqi suyu
regresar	Kutiña
relámpago	Llijulliju
remar	Jap'iña, ñuqiña
remo	Ñuqiña
remojar	Chulluchiña
renegar	Phiñaña
resfrio	Thayjata
residencia	Utjawi
residir	Utjaña
residuo	Jilt'a
respetar	Yäqaña
respirar	Samaña
responder	Kutkatasiña
respuesta	Kutt'ayaña
resucitar	Jakatatayaña
reunión	Mathapiña, tantachasiwi
reunir	Mayachaña
revender productos, objetos y animales	Alakipaña
reventar	Phallaña
revisar	Uñakipaña
rico	Qamiri
río	Jawira
robar	Apaqaña, lunthataña
rodear	Muyuña, muyuntaña
rodilla	Qunquri
rojo	Chupika
rompecabezas	P'iqi p'akjasiña
romper tela, papel	Jich'iña
romper objetos, palo	P'akiña
ronquera	Ch'aja
rosado	Janq'u wila
sábado	Kurmi uru
sacar	Apsuña
sacudir	Thalaña
sal	Jayu
salado	Jayuk'ara, k'ara
salida del sol	Inti jalsu
saltar	Thuqtaña, t'isktaña
saludar	Aruntaña
saludo	Arunta
sancochar con el calor del vapor de agua hervida	Phutiña
sangre	Wila
sapo	Jamp'atu
sarampion	Piyampiya usu
sarna	Qarachi
sebo	Lik'i
sebode alpaca y llama	Llamp'u
seco	Waña
sector	Jisk'a suyu irama
seguir a alguien	Arkaña
seleccionar	Lakiña, ajlliña, chhijllaña
selva	Muntaña tuqi suyu
sembrar cereales al voleo	Phawaña
sembrar	Sataña
sembrar cebada	T'imphantaña
semen	Jatha
semilla	Jatha
semilla de ají o de rocoto	Chira
señal	Chimpu, unancha
separar algo de un todo	Jaljataña
separar escogiendo o seleccionando	Lakiña
separarse	Jaljtaña
ser inerte	Jani jakiri
serpiente cascabel	Saqapani katari
setiembre	Llamp'u phaxsi
siembra	Sata
siembra de cebada, quinua	Qaraña
signo	Chimpu
signo de admiración	Musphaña chimpu
signo de interrogación	Jiskhiña chimpu
sílaba	Aru qallu
silbar	Khuyuña
silencio	Amukt'a
sistema circulatorio	Wila sirka kamana
sistema digestivo	Manq'a kamana
sistema muscular janchi kamana,	Muxsa janchi kamana
sistema oseo	Ch'aka kamana
soga	Chinuña
soga hecha de lana de alpaca o llama	Wiskha
sol	Inti
sólido	Qhuru
soltar los animales	Jararaña
sombra	Ch'iwu
sonaja	Suxu suxu
soñar	Samkaña
sorprender	Katjaña
suave	Jasa
sublevación	Sayt'awi
suciedad	Q'añu
sudor	Jump'i
sueño	Samka
sufrir	Mutuña, t'aqisiña
sujeto de la oración gramatical	Luriri
superficie plana	Pallalla
supervisar	Uñakipaña
surco	Suka
suspirar	Jayisiña
sustracción	Jakhuqawi
tallo	Ali lawa
tallo de quinua	Chäka
talón	Kayu wintu
tamizar	Susuña
tapa	Qhupiña
tapar	Qhupiña
tarde	Jayp'u
tejer	Sawuña
tejer a mano	P'itaña
tejido, prenda tejida	Sawu, sawuta isi
templo	Inlisya
tender	Janaña
teñir	Tiñiña
terminar	Tukuña
terrón	Khula
teta	Ñuñu
tiempo	Pacha
tiempo de hambruna	Mach'a pacha
tiempo pasado	Nayra pacha
tiempo presente	Jichha pacha
tierno, producto vegetal tierno	Llullu
tierra	Laq'a, uraqi
tierra de cultivo	Pachamama
tierra descansada	Puruma
tierra negra	Ch'iyara laq'a
tierra virgen	Puruma
tijeras	Khuchuña
timpanismo	Tini
tinaja	Wakulla
tipo	Kasta
tiznarse	Qhistiña
tizne	Qhisti
torbellino	Tutuka
torrentera	Lluxlla
tórtola	Qhurukutu
tos	K'aja
tos convulsiva	Ch'uxu
toser	K'ajaña, ch'uxuña
tostado	Jamp'i
tostador	Jiwk'i
totorilla	Qina
trabajar	Irnaqaña, luraña
trabalengua	Laxra chinja
trama, trama primero de los tejidos	Qipa pulu
trancar	Chakaña
transplantar	Mallkiña
traquea	Tunquri
trasladar	Jittayaña
trenza	K'ana
trenzar	K'anaña
triángulo	Mujina
trillar	Jawq'aña
tristeza	Llaki
trocar	Chhalaña
troje, tubérculos	Phina
troje de bosta	Pirwa
troje de totora	Sixi
tronco	Tullu
trueque	Chhala
tú	Juma
tubérculo asoleado	K'asuta, k'anuchata
tuberculosis	Tisiku
tupido	Phatu
último	Qhipïri
uña	Sillu
urdimbre	Asi
vagar	Muyuña
vapor de agua	Juwri
vaso de ceremonia	Qiru
vejiga	Yaq'allachi
vellón	Jawi
vena	Wilasirka
venado	Taruka
vencedor	Atipiri
vencer	Atipaña
vencido	Atipata
vender	Alxaña
venir	Jutaña
ventear	Khuyuña
ver	Uñjaña
verano	Panqara phaxsi
verbo	Parliri
verde	Ch'uxña
vergüenza	Phinq'a
vértice	K'achi
vestigio	Unancha
vicuña	Wari
vida	Jakawi
viejo (cosas)	Thantha
viejo (persona de edad)	Achachi
viento	Thaya
viga	Chakaña
vigilar	Uñjaña
viruela	Chuqu usu
viuda	Ijma warmi
viudo	Ijma chacha
víveres	Manq'aña
vivir	Jakaña
vizcacha	Wisk'achu
volar	Thuqtaña, jalaña
volver	Kutiña
yareta	T'ula
yo	Naya
yo y tu	Jiwasa
yugo	Lluku
zampoña	Siku
zorrino	Añuthaya
zorro	Qamaqi
