abajo	Uray.
abandonar	Saqiy, saqirpariy; wikch'uy.
abanicar	Wayrachiy.
abanico	Wayrachina.
abaratado	Uraykachisqa, pisiyasqa.
abarcar	Marq'ay, hapt'ay, aptay.
abatido	Ullpusqa, phutisqa.
abatirse	Ullpukuy, phutikuy.
abdicar	<span foreground="#660099">Cuz.</span> Haqiy; <span foreground="#660099">Aya.</span> Saqiy.
abdomen	Wiksa.
abeja	<span foreground="#660099">Aya.</span> Wayrunqu; <span foreground="#660099">Cuz.</span> Wanquyru.
abertura	Kicha, q'asa, raqra.
abierto	Kicha, kichasqa.
abigeato	Uywa suway.
abismo	Laqha, ukhu pacha.
ablandar	Llamp'uyachiy.
abobado	Upa, upayasqa.
abochornado	Ruphapakusqa, p'inqakusqa.
abochornarse	Ruphapakuy, p'inqarqukuy.
abofetear	<span foreground="#660099">Cuz.</span> Saqmay; <span foreground="#660099">Aya.</span> Laqyay, lapuy.
abolir	Qulluchiy, chinkachiy.
abollado	<span foreground="#660099">Cuz.</span> Q'apnu ~ q'apñu; <span foreground="#660099">Aya.</span> Taqñu.
abollar	<span foreground="#660099">Cuz.</span> Q'apnuy; <span foreground="#660099">Aya.</span> Taqñuy.
abominable	Millay, millana; chiqnipasqa.
abominar	Millay, chiqnipay.
abonar	Wanuchay.
abono	Wanu, q'upa.
aborrecer	Chiqniy, chiqnikuy.
aborrecible	Chiqnina, chiqnipaslla.
aborrecido	Chiqnisqa.
abortar	Sulluy.
aborto	Sullu.
abra	Q'asa.
abrasar	Ruphay, rawray.
abrazar	Mak'alliy, marq'ay.
abridor	Kachaq, kichariq.
abrigado	(lugar) Q'uñi.
abrigar	Qatay, quñichiy.
abrir	Kichay.\n(abrir la boca): hakariy, hanllariy, k'akchay.\n(abrir una flor): phanchiy.
abrochar	T'ipay.
absolver	Pampachay.
absorber	Ch'unqay, suquy.
abstinencia	Sasiy.
abuela	Paya.
abuelo	Machu.
abultar	Ch'upuy, punkiy, hatunyachiy.
abundante	Achkha, ancha, anchallaña.
aburrirse	Amipuy, amirquy.
abusar	Allquchay, mana allin ruray.
acá	Kaypi.
acabar	Tukuy, p'uchukay.
acallar	Upallachiy.
acanalar	Suk'ay, yarqhachay.
acardenalar	Q'uyuyachiy.
acariciar	Waylluy, khuyapay.
acarrear	Astay, apay.
acaso	Icha, ichapas, ichach, paqta.
acaudalado	Qhapaq, qullqiyuq, qullqisapa.
acceder	<span foreground="#660099">Cuz.</span> Huñiy, uyniy; <span foreground="#660099">Aya.</span> Awniy.
acechar	Watiqay, suyapayay.
acelerar	Utqhay.
acepillar	Llaqllay, llamp'uyachiy.
aceptar	Chaskiy, awñiy, awniy.
acequia	Yarqha.
acercar	Asuykachiy, ach'uykachiy, sichpaykachiy ~ hichpaykachiy.
acertar	Chayachiy, quykuy.
acertijo	Watuchiy, watuchina.
acicalar	Lluchk'achiy, llamp'uyachiy.
ácido	P'uchqu.
aclarar	Sut'inchay.\n(el agua): chhuyay.\n(la atmósfera): qicharikuy.
aclimatarse	Yachakuy.
acobardarse	Chinayayay, manchapakuy.
acocear	Hayt'ay.
acoger	Chaskiy, qurpachay.
acometer	Qallariy, atipakuy.\n(entre varios): waykay.
acomodar	Churay, allichay.
acompañante	Pusaq, tiyapayaq.
acompañar	Pusay, tiyaysiy.
aconchavarse	Kamachinakuy, rimanakuy.
acongojarse	Llakikuy, phutikuy.
acopiar	Huñuy, suntuy, tantay.
acoplar	Hap'ichiy, much'apunachiy.
acordar	Rimanakuy, kamachinakuy.
acordarse	Yuyarikuy.
acortar	Huch'uyachiy, taksayachiy.
acosar	Qatikachay, qatipayay.
acostarse	Sirikuy, ustukuy.
acostumbrado	Yachasqa.
acostumbrarse	Yachakuy.
acrecentar	Mirachiy, achkhayachiy, wiñachiy.
acreedor	Manuq, manuyuq.
activar	K'uchikachay, utqhayachiy.
actualmente	Kunan ~ kanan, kunallan, kunanpuni.
acuclillarse	<span foreground="#660099">Cuz.</span> Runkuykuy, <span foreground="#660099">Aya.</span> Unchuykuy.
acuchillar	T'urpuy, tuksiy.
acudir	(en socorro) Yanapay, amachay.
acueducto	Yarqha, pincha.
acumular	Huñuy, tantay, qutuy.
acuoso	Unu-unu, yakusapa; huq'u.
acurrucarse	Usthuy, unchukuy.
acusar	Tumpay, willay.
achacar	Huchayay, tumpay.
achacoso	Unquyaraq.
achatado	P'altayasqa, t'añusqa.
achatar	T'añuy, p'altayachiy.
achicar	Taksayachiy, huch'uyachiy ~ uchukyachiy.
achicharrar	Q'aspay, thiqtichiy, rupachiy.
achispar	Sinkachiy, machachiy.
adaptar	Tinkuchiy.
adaptarse	Yachakuy.
adelantar	Ñawpariy.
adelante	Ñawpapi.
adelgazar	(una persona o animal): tulluyay.\n(un objeto plano): llapsayay.\n(un objeto cilindrico): llañuyay ~ ñañuyay.
además	Chaymanta, astawan.
adentro	Ukhu.
aderezar	Sumaqyachiy, allichay.
adeudarse	Manukuy, manuchakuy.
adherir	<span foreground="#660099">Cuz.</span> K'askachiy, ratachiy; laqay.
adicionar	Yapay.
adiestrar	Yachachiy, riqsichiy.
adinerado	Qullqisapa, qhapaq.
adivinanza	Watuchiy, watuchina.
adivinar	<span foreground="#660099">Cuz.</span> Watuy; <span foreground="#660099">Aya.</span> Musyay.
adolescente	(hombre): maqta.\n(mujer): t'asqi.
adolorido	Nanasqa.
adonde	Mayta, mayman.
adoptar	(el hombre): churichakuy.\n(la mujer): wawachakuy.
adorar	Much'aykuy.
adormecer	Susunkay.
adornar	Allichay, sumaqyachiy.
adquirir	Tariy, tarikuy, rantiy.
adrede	Munaywan, yanqa.
adular	Llaqway, llunk'uy.
adúltero	Wasanchaq.
adulto	Kallpayuq, wiñay, hunt'asqa.
advenedizo	Mitma, hawaruna.
adversario	Awqa, tinkuqmasi.
adversidad	Ñak'arikuy, llakiy.
advertir	Willay, niy, yuyaykachiy.
adyacente	Qaylla, kaylla.
afable	Llamp'u sunqu, ñukñu sunqu.
afear	Millayyachiy.
afectar	Chayay.
afectuoso	Munaq, khuyakuq, sunquyuq.
afeminado	Chinanayaq.
afianzar	Takyachiy.
afición	Munapay, khuyapay.
afilar	Ñawch'iyachiy, ñañuyachiy.
afinar	(un objeto) Takyachiy.
aflicción	Llaki, phuti, muchuy.
aflojar	Wayayachiy, kachariy, paskariy.
afónico	Ch'aka.
afortunado	Samiyuq.
afrecho	Hamch'i.
afrenta	P'inqay.
afuera	Hawa.
agacharse	K'umuy, k'uytuy.
agarrar	Hap'iy.
agave	Paqpa, chuchaw.
ágil	<span foreground="#660099">Cuz.</span> K'uchi; <span foreground="#660099">Aya.</span> Tuki.
agitar	(líquido) Aytiy, aywiy.
aglomerar	Tawqay, ñit'iy.
agonizar	Wañunayay, p'itinayay.
agorero	Musyaq, yachaq, umu.
agotarse	(en el trabajo): sayk'uy, pisipay.\n(el agua): ch'akiy.\n(el tiempo): tukuy.
agradable	Sumaq, misk'i.
agradar	(causar placer): kusichiy.\n(al paladar): misk'iy.
agradecer	Yupaychay, riqsikuy.
agrandar	Hatunyachiy, wiñachiy.
agregar	Yapay.
agriar	P'uchquchiy, qamyachiy ~ qaymachiy.
agrio	P'uchqu.
agrietado	Raqrasqa.
agrupar	Huñuy, tawqay.
agua	<span foreground="#660099">Cuz.</span> Unu; <span foreground="#660099">Aya.</span> Yaku.
aguacero	Para.
aguar	Unuyachiy, yakuyachiy.
aguaitar	Watiqay.
aguardar	Suyay, suyaykuy.
agudo	Llañu ~ ñañu.
águila	Anka.
agujerear	T'uquy, huchk'uy, uchkuy.
agujero	T'uqu, huchk'u, uchku.
aguijón	Wach'i, t'urpuna.
aguja	Yawri, sirana.
agusanarse	Kuruy.
ahí	Chaypi.
ahijar	(el hombre): churiyay, yumay.\n(la mujer): wawachay.
ahogar	<span foreground="#660099">Cuz.</span> Hiq'ipachiy; <span foreground="#660099">Aya.</span> Iqipachiy.
ahondar	P'ukruchay, ukhuchay.
ahora	Kunan, kanan.
ahorcar	Siq'uy, warkuy.
ahuecar	<span foreground="#660099">Cuz.</span> Huchk'uy; <span foreground="#660099">Aya.</span> Uchkuy.
ahumar	Q'usñichiy.
ahuyentar	Ayqichiy, manchachiy, qarquy.
airado	Phiñasqa.
aire	Wayra.
aislar	Asuchiy, rakiy, sapanchay.
ajeno	Hukpa, runap.
ají	Uchu.
ajiaco	Ruqru, puqti.
ajustar	Mat'iy, chaqnay.
ala	Rapra, rikra.
alabar	Yupaychay.
alacena	T'uqu, churana.
alancear	Chukiy, tuksiy.
alargar	Suyt'uyachiy, hatunyachiy.\n(el tiempo): unayay.
alarido	Qapariy.
alarma	Ch'aqwa, manchay.
alba	Achikyay, pacha paqariy.
albañil	Pirqaq.
albedrío	Munay.
albergar	Qurpachay, samachiy.
alborear	Illariy, achikyay.
alboroto	Takurikuna, ch'aqwa.
alborozo	Quchukay, kusikuy.
alcanzar	\n(al que viene): taripay.\n(lo deseado): usachikuy, tarikuy.\n(algo a otro): hayway.
alcoba	Puñuna.
aldea	Ayllu, Llaqta.
aleccionar	Yachachiy.
alegrar	Kusichiy, quchuchiy.
alegre	Kusi.
alegría	Kusikuy.
alejar	Anchuchiy, karunchay; qarquy.
alentar	Kallpanchay, sinchichay.
aletear	Raprachakuy, raprapyay.
alfiler	T'ipana, t'ipa.
alforja	Wayaqa.
algo	Imapas.
algodón	Utkhu.
alguien	Pipas.
algunos	Wakin.
aliento	Samay.
aliarse	Kamachinakuy, rimanakuy.
alias	Nisqa, sutichasqa.
aligerar	(el peso): pisikachiy.\n(el paso): utqhay.
alimentar	Mikhuchiy, qaray.\n(las aves): umiy, unkay.
alimento	Mikhuy, mikhuna.
alinear	Siq'ichiy.
aliñar	Allichay.
alisar	Lluchk'ayachiy, llamp'uyachiy.
aliso	Ramran, ramras ~ lamras.
aliviar	(la enfermedad): alliyay, allinyay.\n(la carga): pisiyachiy.
almacén	Pirwa.
almohada	Sawna.
alocado	Musphaq, utikayaq.
alojamiento	Samana wasi, qurpachana; tampu.
alojar	Samachiy, qurpachiy.
alquilar	Mink'ay, aynichiy.
alrededor	Muyuriqman, muyuriqpi.
al revés	T'ikranpa, qhipanpa.
alterarse	Hukman tukupuy, hukmanyakurquy.
altercado	Kutipakuy, ninakurquy.
alternar	Mit'anay, mit'anakuy, chullachinakuy.
alto	Suni, hatunkaray.
altura	Sayay, sayaynin.
aluvión	Lluqlla.
alumbrar	(con una luz): k'anchariy, akchiy.\n(el día): illariy, achikyay.\n(relampaguear): illapay, lliplliy, wakriy.\n(dar a luz): wachay.
alzar	Huqariy.
allí	Chaypi, wakpi.
allanar	Pampachay, kuskachay.
amable	Munaypaq, sumaq sunqu.
amado	Munasqa, khuyasqa.
amalgamar	Taqruy.
amamantar	Ñuñuchiy.
amancebamiento	Uywanakuy, waynanakuy.
amanecer	Paqariy, achikyay.
amansar	Sunqu llamp'uyachiy, sunqu tiyachiy.
amante	Khuyaq, munaq, waylluq.
amar	Khuyay, munay, waylluy.
amargo	P'uchqu, qamya.
amarillo	Q'illu, qarwa.
amarrar	Watay, chaqnay.
amasar	Chapuy, masaray.
ambicioso	Munapayaq.
ambos	Puran, purantin, iskaynin, masintin.
ambulante	Puriq runa, purikuq.
amedrentar	Manchachiy.
amenazar	Manchachiy.
amígdala	Amuqllu.
amigo	Riqsinakuq masi, khuyaq masi.
aminorar	Pisichiy.
amistar	Riqsinakuy, khuyanakuy.
amo	Apu, wasiyuq.
amojonar	Sayway, suntuy.
amonestar	Anyay, kunay.
amontonar	Suntuy, qutuy, tawqay, qullqay, huñuy.
amor	Khuyay, munay.
amoratarse	Q'uyuy.
amordazar	Qallu chhipay.
amortajar	Aya p'achachiy, aya p'intuy.
amotinarse	Hatariy.
amparar	Amachay, yanapay.
ampolla	Phusullu, supullu.
amputar	Kuchuy, kutuy, qhuruy, wit'uy.
amurallar	Pirqay, qinchay, kanchay.
analfabeto	Ñawsa, mana ñawiyuq.
anciana	Paya.
anciano	Machu, yuyaq.
ancho	Kinray, hatun.
andar	Puriy, purikuy.\n(a gatas): lluqay.\n(tropezando): thampiykachay; tamraykachastin, mitkastin puriy.
andas	Rampa, wantuna.
andén	Pata.
andrajoso	Thanta runa, latapa runa.
anegar	Challpuy.
angina	Kunka unquy.
angosto	Kichki, k'ikllu.
ángulo	K'uchu.
anexar	Hukllay.
angustia	Llaki, phuti.
anhelar	P'ituy, munapay.
anidar	Q'isachay.
anillo	Siwi.
animar	Kamay, kawsachiy, kallpachiy.
aniquilar	Qulluy, chinkachiy.
ano	Siki, uquti.
anoche	Ch'isi, tuta.
anochecer	Ch'isiyay, tutayay.
anónimo	Mana sutiyuq.
ansia	Sinchi munay.
anteanoche	Qayna ch'isi, qayna tuta.
anteayer	Qayninpa p'unchaw.
anteceder	Ñawpay, ñawpariy.
antecesor	Ñawpaq kaq.
anteojos	Qispi ñawi.
antepasado	Ñawpa machu.
anterior	Ñawpa.
antes	Ñawpaq.
anticipar	Ñawpachiy, qallaykurquy.
antiguo	Ñawpa.
antipatía	Chiqniy.
antojo	Munapakuy.
antorcha	K'anchana, akchikuq.
antro	Mach'ay.
anual	Sapa wata, watan-watan.
anublarse	Llanthuy, phuyuy.
anudar	Khipuy, watay.
anunciar	Willay, yachachiy.
anverso	Uyan.
añadir	Yapay.
año	Wata.
añoso	Puqusqa, takyasqa.
apacentar	Michiy.
apacible	Llamp'u sunqu, qasi sunqu.
apachurrado	Thañusqa, llaphisqa.
apadrinar	(bautizo) Marq'ay.
apagar	(soplando): phukuy.\n(con agua): thasnuy.
apalear	Maqay, waqtay.
apañar	Pakay, hap'iy.
aparar	Kamariy, chaskiy.
aparear	Masachay, kuskachay.
aparecer	Rikhuriy, qispimuy.
aparentar	Tukuy.
apariencia	Rikch'ay.
apartar	Akllay, rakiy, anchhuchiy.
apearse	Uraykuy.
apedrear	Chamqay, chuqay.
apegarse	Ratakuy, k'askakuy.
apellidar	Sutichay, qayay.
apenado	Llakisqa.
apenas	Sasata, ñak'ayta.
apéndice	Yapana.
apersonarse	Rikhuriy, tinkuy.
apertura	Kichana, kichakuy.
apestar	Asnay.
apetecer	Munapayay.
apiadarse	Llakipayay.
apiñarse	Chhunkunakuy, ñit'inakuy, tawqanakuy.
aplacar	Sunqu tiyachiy, thanichiy.
aplanar	Pampachiy, kuskachiy.
aplastar	Ñit'iy.
aplaudir	Kusipayay, taqllay.
aplazar	Suyachiy, asuchiy.
apocado	Pisi sunqu.
apoderarse	Hap'ikuy.
apodo	Mana allin suti, hawa suti.
apolillar	Thutay, puyuy.
aporcar	Hallmay, aysay.
aportar	Chayay, apay.
aposentar	Qurpachay, samachiy.
apostema	Ch'upu, q'iya.
apoyar	Q'imiy.
apreciable	Khuyapaslla.
aprender	Yachakuy.
aprendiz	Yachapakuq.
apresar	Hap'iy.
apresurar	Utqhay.
apretar	Mat'iy, chaqnay.
aprisco	Kancha, qincha.
aprobar	Ari niy, uyniy, awniy.
apto	Allin, kusa.
apuntar	T'uqsiy.
apuñalar	T'urpuy, tuksiy.
aquel	Haqay, chaqay, wak.
aquí	Kaypi, kayman.
araña	Kusi-kusi.
arañar	Rachay, hasp'iy.
arar	Yapuy, chakmay.
árbol	Sach'a, yura.
arcilla	Llank'i, mit'u.
arco iris	K'uychi, chirapa.
arder	Rawray, ruphay.
arena	Aqu, t'iyu.
aroma	Q'apay, misk'i asnaq.
arraigar	Saphinchakuy.
arrancar	T'iray, chutay.
arrasar	Purunyachiy, pampayachiy.
arrastrar	Aysay, chutay.
arrear	Qatiy.
arrebatar	Waykay, ayqichikuy, qichuy.
arreglar	Allichay.
arremangar	Q'allpay, q'impirikuy.
arrepentirse	Wanay.
arrestar	Wichq'ay.
arriba	Hanaq.
arribar	Chayay, chayamuy.
arrimar	Asuykachiy, q'imiykachiy.
arrinconar	K'uchuchay.
arrodillarse	Qunqurikuy.
arrojar	Wikapay, chuqay, wikch'uy.
arroyo	Uchuk mayu, huch'uy mayu.
arruga	Sip'u, q'inti, q'aqñu.
arrumar	Tawqay.
asa	Rinri, hap'ina.
asado	Kanka, kusay.
asar	Kankay, kusay, q'aspay.
ascender	Siqay, wichay.
asco	Millay, millakuy.
ascua	Sansa.
asear	Chhuyanchay, mayllay, allichay.
asemejarse	Rikch'akuy, kaqlla kay.
asentar	Takyachiy, tiyachiy.
aserrar	Kuchuy, wit'uy.
asesinar	Wañuchiy.
aseverar	Ari niy, awniy.
así	Hina.
asiento	Tiyana.
asociar	Masinchay, masanchay.
asolar	Purunyachiy.
asolear	Rupaychay, mast'ay.
asomar	Rikhuriy, wichay.
áspero	Qachqa.
aspirar	(por la boca): hapkay.\n(por la nariz): sinq'ay.
asquear	Millakuy.
asustar	Manchachiy.
atacar	Atipay, qallariy.
atado	Q'ipi.
atajar	Hark'ay.
atalaya	Qhawana.
atar	Watay, chaqnay.
atemorizar	Manchachiy.
atender	Uyariy.
aterir	Chirayay.
atesorar	Qullqi huñuy.
atizar	Nina hast'iy.
atontarse	Utipuy, muspaykachay.
atorado	K'ichkipakusqa.
atrancar	Q'imiy.
atrapar	Hap'iy.
atrás	Qhipa.
atrasarse	Qhipakuy.
atrevido	Mana manchaq.
atropellar	Saruy, tanqakuy.
aullar	Wanyay.
aumentar	Mirachiy, yapay.
aunar	Hukllachay.
ausentarse	Ch'usay, illariy.
autorizar	Kamachiy, rurachiy.
auxiliar	Yanapay.
avanzar	Ñawpariy.
avaricia	Mich'akuy.
ave	Pisqu.
avecindarse	Mitmakuy, llaqtachakuy.
avejentarse	(el varón): machuyay.\n(la mujer): payayay.\n(un objeto): mawk'ayay.
aventajar	Yalliy, llalliy.
aventar	Wikapay.
avergonzar	P'inqachiy.
averiguar	Tapukuy.
avinagrar	P'uchquchiy.
avisar	Willay.
aviso	Willakuy.
avistar	Rikuy, qhawarquy.
ayer	Qayna p'unchaw.
ayudar	Yanapay, ruraysiy.
ayuno	Sasi.
ayuntar	Huñuy, t'inkiy.
azotar	Waqtay.
azuela	Llaqllana.
azucena	Hamank'ay.
azul	Anqas.
baba	Llawsa, lawsa.
bacín	Hisp'ana, hisp'akuna.
bailar	Tusuy, qachway.
bajada	Uraykuna, kinray.
bajar	(de precio): uraykachiy.\n(la cabeza): k'umuy.
balanza	Aysana.
balar	Waqay.
balbucear	Haklluy, aklluykachay.
baldío	Purun allpa; purun pampa.
baluarte	Pukara.
banda	(lado) Chimpa.
bandido	Manchana runa, waykakuq.
banquete	Mikhuna, upyana.
bañarse	Armakuy, mayllikuy.
baño	Armakuna, mayllakuna.
barato	Chanin, pisilla.
barba	Sunkha, sapra.
barbacoa	Pachamanka, watya.
barbechar	Chakmay, yapuy.
barca	Wamp'u.
barranco	Q'asa, wayq'u.
barrenar	Hutk'uy, uchkuy.
barrer	Pichay.
barriga	Wiksa.
barro	T'uru, mitu.
bastante	Achkha.
bastón	Tawna, k'aspi.
basura	Q'upa, wanu.
batalla	Awqay, maqanakuy.
batán	Maran, maray.
batir	Qaywiy, aytiy ~ aychiy.
bautizar	Uliyay, suti churay.
beber	Upyay, upuy.
bebida	Upyana.
belleza	Sumaq kay.
benefactor	Allin ruraq.
beodo	Machaq, sinka.
besar	Much'ay.
bicho	Uru, kuru.
bien	Allin.
bienestar	Allin kay, allin kawsay.
bienvenida	Sumaq chaskiy.
bilis	Hayaqin.
bisoño	Yachapakuq.
bisnieto	Willka.
blanco	Yuraq.
blancura	Yuraq kay.
bledo	Hat'aqu, qura.
boa	Amaru, wata puñuq.
boca	Simi; hutk'u, yaykuna.\n(abrir la boca): hanllay.
bocio	Q'utu.
bofes	Surq'an, k'ipchan.
bola	Rumpu, sinku, ruyru.
bolsa	Wayaqa, ch'uspa.
boñiga	Kharka, q'awa.
borde	Patan.
borrachera	Machay, upyay, sinkay.
borracho	Machasqa, upyasqa, sinkasqa.
borrar	Pichay, chinkachiy.
bosque	Sach'a-sach'a.
bosta	(de vaca): q'awa.\n(de equino): uchha.\n(de ovino): taqya.
bostezar	Hanllariy, hanllapakuy, hakapakuy.
botar	Wikch'uy, hitay; wikapay.
brasa	Sansa, nina.
bravo	Phiña, phiñasqa.
brazo	Rikra.
breve	(tiempo) Hukpachalla, utqhalla.
brillar	Llipipipiy, k'anchay, illay, akchiy.
brincar	P'itay, phawaykachay.
broma	Pukllay, sawkay.
brotar	(del suelo): phutuy.\n(del tallo): ch'ichiy.\n(la flor): mukmuy.
brujo	Layqa, musyaq.
bruma	Phuyu, wapsiy.
buba	Wanthi.
buche	Q'utu, uksu.
bueno	Alli, allin.
bufón	Asichikuq, sawka.
buho	Tuku, ch'usiq.
bulto	Q'ipi, palta, saway.
burbujear	Phullpuy.
burla	Sawka, pukllay.
buscar	Maskhay.
caballero	Wiraqucha; q'ala.
caballo	Kawallu, hatun uywa.
cabana	Ch'uklla.
cabecera	Sawna.
cabello	Chukcha.
caber	Kamay.
cabeza	Uma.
cabrillas	Qullqa, quyllur, qanchis quyllur.
cabuya	Ch'awar, paqpa.
cada	Sapa.
cadáver	Aya, wañu.
caer	Urmay.
caca	Aka, ismay.
cadera	Siki pata.
cal	Isku.
calavera	Aya uma, uma tullu.
calcinar	Kañay, uchphayachiy.
calcular	Yupaykukuy.
caldear	Ruphachiy, ninayachiy.
calentar	Q'uñichiy.
calmar	Samay, thaniy.
calofrío	Chukchuy, katkatyay.
calor	Ruphay.
calumnia	Tumpay, huchachay.
calvo	P'aqla uma, q'ala uma.
callar	Upallay, mana rimay.
cama	Puñuna, kawitu.
camarada	Riqsinakuq masi, khuyaq masi; yanasa.
camarón	Yukra.
cambiar	(trocar): rantiy, yankiy.\n(variar): huk hinaman tukuchiy.\n(trasladar): t'ikray.
camilla	Chakana, wantukuna.
caminar	Puriy, riy, kallpay.
camino	Ñan, purina.
camisa	Unkhu, ukhu p'acha.
camote	Apichu, misk'i papa.
campo	Pampa, purun.
cana	Suqu.
canal	Rarqa, yarqha, pincha.
canalla	Millay runa.
cancha	(maíz tostado) Hamk'a, kamcha.
canchón	Kancha.
candela	Sansa, nina.
canilla	Chaki tullu.
canjear	Rantiy, yankiy.
canoa	Wamp'u.
cansarse	Sayk'uy, pisipay; amirquy.
cantar	Takiy.
cántaro	P'uyñu; urpu.
capa	Yaqulla.
cara	Uya.
caracol	Ch'uru.
caracha	Qaracha.
carbón	K'illimsa.
cárcel	Watay wasi, samkay.
carcoma	Thuta, puyu.
cardar	Pillchay.
cárdeno	Q'uyu.
carear	Uya purachiy, tinkuchiy.
carestía	Muchuy, wanay.
carga	Winay, saway.
cargar	Churkuy, q'ipiy, chaqnay.
caricia	Waylluy, khuyapay.
cariño	Khuyay, munaychay.
carnaval	Hatun pukllay.
carne	Aycha.
caro	Ancha chaniyuq.
carta	Qillqa.
carrillo	K'aklla, uya.
carrizo	Suqus.
casa	Wasi.
casarse	Kasarakuy, yananchakuy.
cascada	Phaqcha.
cascajo	Suqlla rumi.
cascara	Qara.
caserío	Wasi wasi.
caserón	Raqay.
casi	Yaqa, yaqalla.
casta	Ayllu, yawar, rikch'aq.
castaño	Ch'umpi.
castigar	Muchuchiy.
catarro	Chhulli unquy.
catre	Kawitu, sirina.
causar	Ruray, raykuy.
cavar	Hasp'iy, t'uquy, hutk'uy, uchkuy.
caverna	Mach'ay.
cavilar	Yuyaymanay.
caza	Chaku.
cecina	Ch'arki.
cedazo	Suysuna.
cegar	Ñawsayay.
ceja	Qhisipra, qhichipra.
celaje	Antaqa, antay ruphay.
cementerio	Ayap samanan, aya pampana.
ceniza	Uchpha.
centella	Lliplliq, achikyaq.
centena	Pachak.
centro	Chawpi.
cera	Mapa.
cerca	Sichpa, hichpa.
cerco	Qincha.
cerdo	Khuchi.
cernícalo	K'illichu, k'illiwara.
cernir	Suysuy.
cerradura	Wichq'ana.
cerrar	Wichq'ay.
cerro	Urqu.
certeza	Sut'inmanta yachay.
cerumen	Rinri wira.
cesar	Tukuy, thaniy, p'uchukay.
césped	Ch'ampa.
cesto	Runku.
cicatriz	Q'illa, sira.
ciego	Ñawsa, mana ñawiyuq.
cielo	Hanaq pacha.
cien	Pachak.
cieno	T'uru t'uru.
cierto	Chiqan, sut'illa.
ciervo	Lluychu.
cigarra	Qisqis.
cinco	Pichqa.
cintura	Wiqaw.
ciudad	Hatun llaqta.
cizaña	Qura.
clara	(agua): ch'uya unu.\n(del huevo): runtup yuraqnin.
clarificar	Ch'uyayachiy.
clase	Rikch'aq.
clasificar	Rakiy, akray.
clavar	Takay, sat'iy.
coagular	Tikayachiy.
cobarde	Llaklla, pisi sunqu, manchakuq.
cobardía	Llakllay, manchay.
cobijar	Qatay.
cobrar	Mañay, mañapuy.
cobre	Anta.
coca	Kuka.
cocear	Hayt'ay.
cocinar	Wayk'uy, yanuy.
codiciar	Munapayay, ancha munay.
codo	Kuchus, kuchuchu.
coger	Pallay, hap'iy.
cogote	Much'u.
coincidir	Tinkunakuy.
cojear	Hank'ayay, wiqruy.
cojo	Hank'a, wiqru.
cola	(rabo): chupa.\n(pasta): k'askachina, laqaq.
colaborar	Yanapay, ruraysiy.
colar	(filtrar): Suysuy.
coleccionar	Huñuy.
colecta	Tanta.
colega	Masi, kaq masi.
cólera	Phiñay, phiñakuy.
colgar	Warkuy.
colibrí	Q'inti.
cólico	Wiksa nanay.
colmar	Hunt'achiy.
colmillo	Waqsa.
colocar	Churay.
columpio	Wayllunk'ukuna, wayllunchakuna.
collar	Wallqa, kunka watu.
comadreja	Achuqalla, unchuchukuy.
combatir	Maqanakuy.
comenzar	Qallariy.
comer	Mikhuy.\n(harina): hak'uy.\n(coca): akulliy.\n(lamiendo): llaqway, lluspiy.
comezón	Siqsi.
comida	Mikhuy, mikuna.
comienzo	Qallariynin.
comisionar	Kachay.
como	hina.
cómo	Imayna.
compañero	Masi.
comparar	Tinkuchiy, rikch'achiy.
compatriota	Llaqtamasi, llaqtapura.
competir	Tinkunakuy, llallinakuy.
compilar	Huñuy, suntuy.
complacer	Kusichiy, q'uchuchiy.
completar	Tukuy, hunt'ay.
componer	Allichay.
comprar	Rantiy.
comprender	Yachay, yacharquy.
comprimir	Ñit'iy ~ mat'iy.
comprometerse	Huñiy, aniy.
comunicar	Willay, yachachiy.
comunidad	Ayllu, llaqtantin.
concebir	(la hembra) Wiksayakuy, chichuyay.
conceptuar	Yuyaymanay.
concluir	Tukuy, p'uchukay, qispichiy.
concordar	Tinkuchiy.
conculcar	Sarunchay.
concuñada	Qhachun masi, llumchuy masi.
concuñado	Qatay masi, masa masi.
concurrir	Riy, huñunakuy.
condensar	Pipuyachiy, putkayachiy.
condiscípulo	Yachaq masi.
condolerse	Llakipayay, nanachikuy.
cóndor	Kuntur.
conducir	Pusay, apay.
confeccionar	Ruray.
confesar	Willakuy.
confín	Tukuynin, p'uchu kaynin.
confinar	Tinkuy, tupay.
confluencia	Tinkuy, tupay.
confronta	Tinkuchiy.
confundir	Chhaqruy, taqruy.
congelar	Qasay, chullunkuy, rit'iyachiy.
congoja	Llaki, phuti.
congraciarse	Munachikuy, khuyachikuy.
congregar	Tantay, huñuy.
conjeturar	Hamurpayay, yuyaymanay.
conjunción	(de la luna) Wañu, musuq killa.
conmemorar	Yuyariy, yupaychay.
conmigo	Nuqawan.
conmover	Kuyuchiy.
conocer	Riqsiy, yachay.
consanguíneo	Yawar masi, ayllu masi.
conseguir	Tariy, usyachikuy.
consejo	Kunay, willay, kamachiy.
consentir	Huniy, awniy.
conservar	Waqaychay.
considerar	Hamurpay, yuyaymanay.
consolar	Sunqu tiyachiy, kusichiy.
construir	Ruray, hatarichiy.
consultar	Tapuy.
consumar	P'uchukay, tukuy.
contador	Yupaq.
contagiar	Ratachiy, ratakuy, mismiy.
contar	(números): yupay.\n(avisar): willay.
contento	Kusi sunqu, hawka.
contestar	Kutichiy, rimariy.
contienda	Maqanakuy.
contigo	Qamwan.
continuamente	Pasaqlla.
contorno	Muyuntin, muyuriqnin.
contraerse	Qintikuy.
contumaz	K'ullu sunqu, munasqan ruraq.
convalecer	Allinyay.
convenir	Kamachinakuy, rimanakuy, ninakuy.
conversar	Rimay, parlay.
cooperar	Yanapay, ruraysiy.
copioso	Sinchi, achkha, nanaq.
corazón	Sunqu.
corcovado	Q'umu wasa, muqu wasa.
cornear	Waqray.
corona	Pillu.
corral	Kancha, qincha.
corregir	Wanachiy, anyay.
correo	Chaski, qillqa apaq.
correr	Phaway, kallpay.
corresponder	Kutichiy.
corroer	Kuchkuy.
corromperse	Ismuy, p'uchquyay.
cortar	(objetos compactos): kuchuy.\n(objetos alargados y fibrosos): rutuy.
corteza	Qara.
cosa	Ima.
cosecha	Kusicha, kuhichu, kallchay.
coser	Siray.
cosquilla	Chikuchay.
costado	Waqta, rikra.
costa	(del mar) Mama qucha patan, hatun quchap patan.
costal	Kutama, runku.
costilla	Waqta tullu.
costra	Qara, k'iri.
costura	Sirana, sirasqa.
cotejar	Tinkuchiy.
cotidiano	Sapa p'unchaw.
coz	Hayt'ay.
cráneo	Uman tullu.
creador	Kamaq, paqarichiq, ruraq.
crear	Kamay, paqarichiy.
crecer	Wiñay, miray, hatunyay.
creciente	(luna) Wiñay killa, wiñaq killa.
creer	Iñiy.
crepúsculo	Tutaykuy.
crespo	K'uspa.
cresta	K'akara.
cría	Wawa, uña.
criado	Yana, uywa.
criar	Uyway.
criatura	Llullu wawa, ñuñuq wawa.
criba	Suysuna.
crimen	Hatun hucha.
cristal	Qispi.
crucificar	Chakatay.
crudo	Chawa, mana chayasqa, llullu.
cruzar	Chakay, chakachiy.
cuadrar	Tinkuchiy, kamaylla kamay.
cuál	Mayqan, mayqin.
cuándo	Hayk'ap, imaypacha.
cuánto	Hayk'a.
cuatro	Tawa.
cubrir	(proteger) Qatay, kirpay, p'ampay.
cuclillas	(estar en) Runk'uy, unchuykuy.
cucharón	Wislla.
cuello	Kunka, tunquri.
cuerda	Waskha, q'aytu.
cuerno	Waqra.
cuero	Qara.
cuerpo	Ukhu; aycha; kurku.
cuesta	(arriba): siqana, wichana.\n(abajo): uraykuna.
cueva	Mach'ay.
cuidar	Qhawapay, waqaychay.
culebra	Machaqway.
culén	Wallwa.
culminar	Qispiy.
culo	Siki.
culpa	Hucha.
culpar	Huchachay.
cultivar	Llamk'ay, yapuy.
cumbre	Uma.
cumplir	Hunt'achiy.
cuna	K'iraw.
cuñada	Qhachun ~ qhachuni, llumchuy.
cuñado	Masa.
cuota	Tanta qullqi.
curar	Hampiy, alliyachiy.
curandero	Hampiq.
curvo	Q'iwi.
cuy	Quwi.
chamuscar	Qaspay, kankay.
chancear	Pukllaykachay.
chancro	Wanthi.
chancho	Khuchi.
charco	Huq'u-huq'u; qucha.
charlar	Rimay.
charlatán	Rimaysapa, llumpay rimaq.
chico	Huch'uy, uchuk, taksa.
chicote	Hasut'i, waqtana.
chicha	Aqha.
chichón	Punkisqa.
chismear	Simi apaykachay.
chismoso	Simi apaq, iskay simi.
chiste	Asina.
chocar	Takakuy.
chorrear	Sutuy, phaqchay.
choza	Ch'uklla.
chueco	Wist'u, wiqru.
chupar	Ch'unqay, suquy.
dadivoso	Qukuq, mallichikuq.
danza	Tusuy.
dar	Quy.
debajo	Urapi, ukhupi.
deber	(como tarea): rurana, kamachikuy.\n(como deuda): manukay.
débil	Mana kallpayuq.
decapitar	Uma qhuruy, uman kuchuy.
decena	Chunka.
decir	Niy, rimay.
declarar	Rimariy, willakuy.
decrecer	Huch'uyay, taksayay, uchukyay.
dedo	Ruk'ana, maki pallqan.
deducir	Hurquy, rakiy.
defecar	Akay, hisp'akuy.
defender	Amachay.
defraudar	Qichuy, suway.
deglutir	Millp'uy.
degollar	Nak'ay, sipiy, kunka kuchuy.
dejadez	Qillarikuy.
dejar	Saqiy, kachariy.
delante	Ñawpaq, qaylla.
deleite	Misk'illikuy, kusikuy.
deleznable	Tukukuq, thuñikuq.
delgado	(ser humano): tullu.\n(objeto laminado): llapsa.\n(objeto cilindrico): ñañu, llañu.
deliberar	Yuyay, yuyaykuy.
delicado	Llaqlla.
delicioso	Quchuchikuq, misk'i kusichiq.
delincuente	Huchayuq.
delinquir	Huchallikuy, huchapakuy.
delirar	Musphay, musphaykachay.
delito	Hatun hucha.
demanda	Mañakuy.
demasiado	Ancha, nanaq, llumpay.
demoler	Thunichiy, paskay.
demonio	Supay, awqa.
demora	Unay, unakuy.
demorar	Unaykachiy.
demostrar	Kaqta qhawachiy.
demudarse	Hukyay, hukmanyay.
denegar	Mana munay.
denso	Pipu, sankhu.
dentado	Kiruyuq, kirusapa.
dentro	Ukhu, ukhupi.
denunciar	Willay, yachachiy.
depositar	Waqaychay, churakuy.
depósito	Waqaychana; pirwa, churana.
depredar	Suway, qichuy, waykay.
depurar	Pichapay, ch'uyanchay.
derecha	<span foreground="#660099">Cuz.</span> Paña; <span foreground="#660099">Aya.</span> Alliq.
derogar	Chinkachiy.
derramar	Hich'ay, usuchiy.
derredor	Muyun, muyuriqnin.
derretir	Chulluchiy, yakuyachiy.
derribar	Thuñichiy, kumpay, saqmay.
derrocar	Urmachiy.
derrochar	Qullqi tukuy, wischuy.
derrotar	Atipay, ayqichiy.
derrumbarse	Thunipuy, tiyarquy.
desabrido	Q'ayma, qamya, qhatqi.
desabrigarse	Mana mayt'ukuy.
desacertar	Pantay.
desaguar	Unu chakichiy, yakun hakichiy.
desaliñado	Mana allichakuq.
desalojar	Qarquy.
desamorado	Mana munakuq, mana khuyakuq.
desamparar	Haqiy, saqiy.
desangrar	Yawarchay.
desanimar	Manchachiy.
desanudar	Paskay.
desaparecer	Chinkay.
desasear	Qhillichay, qanrachay.
desatar	Paskay.
desbaratar	Waqllichiy.
descabezar	Uma qhuruy, uma hurquy.
descalzo	Q'ala chaki.
descanso	Samay, samana.
descansar	Samay.
descargar	Paskay, uraykachiy.
descender	Uraykuy.
descifrar	Yacharqapuy, musyay.
descolgar	Uraykachiy.
desconocer	Mana riqsiy, pantay.
desconsolar	Llakichiy, phutichiy.
descontar	Rakiy, hurquy.
descoser	Paskay.
describir	Willay, willakuy.
descubrir	Tariy, rikuchiy.
desdentado	Mana kiruyuq, kirunnaq.
desdicha	Chhiki, llaki.
desdoblar	Mastay.
deseable	Munanalla, munapaslla.
desear	Munay, munapay.
desechar	Wikch'uy, wischuy, mana munay.
desecho	Puchuq, q'upa.
desenredar	Paskay.
desenterrar	Hasp'iy, hurquy.
deseo	Munay, munapayay.
desertor	Ayqikuq.
desgajar	K'allmay, siptiy.
desgarrar	Qhasuy, llik'iy.
desgracia	Llaki, chhiki.
desgranar	Muchhay, iskuy.
desgreñado	T'ampa, champa uma.
deshojar	Tipiy, rapichay.
deshonesto	Map'a, qanra.
desierto	Purun, chunyaq.
desistir	Saqiy.
desleír	Chulluchiy.
desligar	Paskay.
desligarse	Lluchkhakuy, suchuykuy.
deslumbrar	Utirayachiy, ñawi utichiy.
desmayarse	Wañuriy.
desmenuzar	Ñut'uy.
desmochar	Uma mut'uy, qhuruy.
desmoronarse	Thuniy.
desnudar	Llat'anay, chutuy.
desnudo	Llat'an, q'ala.
desobediente	Mana uyakuq, mana kasukuq.
desocupar	Astay, purumay.
desocuparse	Samay, qasikuy.
desolado	Llaki nanasqa, sinchi llakisqa.
desollar	Lluch'uy, llustiy.
desorientarse	Pantay.
despacio	Allillamanta.
despachar	(enviar): kachay, richiy.\n(vender): qhatuy, rantikuy.
desparramar	Usuchiy.
despedazar	Llik'iy.
despedida	Kacharpariy.
despensa	Mikhuy churana wasi.
despeñarse	Qaqapay, kuchpakuy.
desperdiciar	Usuchiy, hich'ay.
despertarse	Rikch'ay.
despiojar	Usachay.
desplegar	Mast'ariy.
desplomarse	Urmay, thuniy.
despoblado	Purun, chunyaq.
despojado	Qichuy.
después	Chaymanta, hinamanta, hinaspa.
despuntado	Mut'u, qhurusqa.
destapar	Kichay.
desterrar	Qarquy.
destetar	Hanuk'ay.
destilar	Sut'uchiy.
destripar	Ch'unchulchay.
destrozar	P'akiy, ch'alluy.
destruir	Chinkachiy.
desunir	Rakiy.
desvariar	Musphay.
desventura	Llaki.
desvergüenza	Mana p'inqakuy.
desvestir	Llat'anay, chutuy.
desviado	Pantasqa.
desyerbar	Quray.
detener	Hark'ay.
detestar	Millay, amiy.
detonar	T'uqyay.
detrás	Qhipa, wasa.
deudo	Ayllu masi, yawarmasi.
deudor	Manu, manukuq.
devolver	Kutichiy, qupuy.
devorar	Millp'urquy.
día	P'unchaw ~ p'unchay.
diablo	Supay, awqa.
dialogar	Rimanakuy.
diarrea	Q'icha.
dicha	Sami, kusikuy.
dichoso	Samiyuq, kusisqalla.
diente	Kiru.
diestra	Paña, alliq maki.
diestro	Yachaq.
diez	Chunka.
difamar	Wasachay, wasanpi rimay.
diferente	Huk, sapaq.
diferir	Qhipachiy, suyachiy.
difícil	Sasa.
difundir	Mirachiy, mismichiy, riqsichiy.
difunto	Aya, wañuq.
digno	Kamaqnin, allin.
dilapidar	Usuchiy.
diligente	K'uchi.
diluido	Chullusqa.
diluir	Chulluchiy.
diluvio	Lluqllay para.
dimanar	Lluqsimuy.
dimensión	Tupu.
diminuto	Huch'uylla, llumpay taksa, akapa.
dinero	Qullqi.
Dios	Yaya.
dirigir	Pusay.
discípulo	Yachakuq.
discurrir	Yuyaymanay.
disecar	Ch'akichiy.
diseminar	Tarpuy, yapuy, maqchiy.
disfrazarse	Saynatakuy.
disgustado	Phiñasqa, amisqa.
disimular	Mana yachaqtukuy.
disipar	Wischuy.
dislocarse	Q'iwikuy.
disminuir	Pisiyay.
disolver	Chulluchiy.
dispersar	Ch'iqichiy.
disputa	Kutipanakuy, ninakuy.
distancia	Karu kay.
distante	Karu.
distinguir	Riqsiy, rikuy.
distinto	Huk niraq, sapaq.
distribuir	Aypuy, rakiy.
divagar	Pantaykachay, musphaykachay.
diversidad	Imaymana, tukuy rikch'aq.
dividir	Rakiy, aypuy.
divieso	Ch'upu.
divisa	Unancha.
divisar	Rikuy, qhaway.
divisible	Rakina, aypuna.
divulgar	Willaykachakuy.
doblar	(tela o papel) Pataray.
doble	(de espesor) Raktha.
doblez	Iskay sunqu, iskay rimay.
docente	Yachachiq.
dócil	Llamp'u sunqu.
docto	Hamawt'a.
doler	Nanay.
dolor	Nanay.
domar	Uywa q'iwikachay, mansay.
donar	Quy.
dónde	Maypi.
dorado	Qurichasqa.
dorar	Qurichay, qurinchay.
dormilón	Puñuy siki.
dormir	Puñuy.
dormitorio	P'uñuna wasi.
dos	iskay.
duda	Tunki.
dueño	Wasiyuq.
dulce	Misk'i.
dulcificar	Misk'iyachiy.
durable	Wiñay kawsaq.
duradero	Takyaq, mana tukuriq.
durar	Takyay, unay kawsay.
duro	Anaq.
ebrio	(estar): machasqa, upyasqa.\n(ser): machaq, upyaq, sinka.
eclipsarse	(el sol): inti wañuy.\n(la luna): killa wañuy.\n(parcialmente): inti unquy, killa unquy.
economizar	Churakuy.
echar	(arrojar): wikch'uy, ch'uqay, wikapay,qarquy.\n(líquido): hich'ay, maqchiy.\n(la culpa): huchachay.\n(vaciar): talliy, hillp'uy.
echarse	(de cubito ventral): thallay, pilatay.\n(de un lado): qichqapakuy.\n(de cubito dorsal): hantarakuy, antarpakuy.
edad	Wata, wiñay.
edificar	Ruray, hatarichiy.
educar	Yachachiy.
efectivamente	Chiqaqmanta, chiqanpi.
efímero	Tukukuq, chinkaqlla.
ejecutar	Ruray, hinay.\n(dar muerte): wañuchiy.
él	Pay.
ella	Pay.
elástico	Chutakuq, wiñariq.
elección	Akllay.
elegir	Akllay, akllakuy.
elevar	Huqariy, hatarichiy.
eliminar	Hurquy, anchuchiy.
embadurnar	Llusiy, llut'ay.
embajador	Kacha; rantin.
embarazada	Chichu, wiksayuq.
embarcación	Wamp'u.
embarrar	Llut'ay, t'uruchay, mituchay.
embellecer	Sumaqyachiy.
emblanquecer	Yuraqyachiy.
emborracharse	Machay, sinkarquy.
embravecer	Phiñayay, phiñatukuy.
embrollar	Pantaykachachiy.
embrujar	Layqay, hampirquy.
embudo	Hillp'una.
embustero	Llulla.
embutir	Winay, sat'iy.
emigrar	Mitmay.
empacharse	Wiksa punkichikuy, saksapakuy.
empalagarse	Amikuy.
empalmar	T'inkiy, kaninachiy.
empañar	Antayachiy, qanrayachiy.
empapar	Huq'uyachiy, nuyuchiy.
emparedar	Pirqay.
emparejar	Kuskachay, masachay.
emparentar	Aylluchakuy.
empedrar	Rumichay.
empeine	(enfermedad) Mirkha.
empellón	Tanqay.
empeñar	Haqikuy, saqikuy.
empezar	Qallariy.
emplear	Rurachiy, llamk'achiy.
empobrecer	Wakchayay.
empollar	Uqllay.
empreñar	Chichuyachiy, wiksayachiy.
empujar	Tanqay.
empuñar	Hap'iy, aptiy.
enano	Umutu, akapalla.
enantes	Ñaqa.
encadenar	Watay, chaqnay, t'inkiy.
encajar	Winay, sat'iy.
encalar	Iskuchay.
encanecer	Suquyay.
encarcelar	Wichq'ay.
encargar	Kunakuy, apachikuy.
encender	Rawrachiy, ruphachiy, ratachiy.
encerrar	Wichq'ay.
encima	Hawapi.
enclenque	Umpu; iqu.
encogerse	Q'intikuy.
encolerizar	Phiñachiy.
encontrar	Tariy, taripay.
encontrarse	Tinkuy, tupay, tinkunakuy.
encorvarse	K'umukuy.
encrucijada	Pallqa.
encubrir	Pakay, p'ampay.
encuentro	Tinkuy, tupay.
endulzar	Misk'ichay.
endurecer	Rumiyachiy.
enemigo	Awqa, chiqniq.
enemistarse	Awqanakuy, phiñanakuy.
enfadar	Phiñarichiy.
enfermar	Unquy.
enfermizo	Unqurayaq; iquyasqa.
enfermo	Unquq.
enflaquecer	Tulluyay; ch'arkiyay.
enfrente	Chimpa, chimpapi.
enfriarse	Chiriyay.
enfurecido	Phiñasqa.
engañar	Llullakuy, pantachiy.
engendrar	Yumay, churiyay.
engordar	Wirayay, puquyay.
engrandecer	Hatunyachiy, wiñachiy, mirachiy.
engrasar	Wirachay.
engrosar	Rakhuyachiy.
engullir	Rakray, millp'uy.
enigma	Watuchina, musyana.
enjuagar	Ch'uyanchay, aywiy.\n(la boca): muqch'ikuy, chumchikuy.
enjundia	Rurun wira.
enjuto	Chakisqa, tulluyasqa.
enlodar	T'uruchay, mituyachiy.
enloquecer	Utiqyay.
enmarañar	Arwiy, t'ampayachiy.
enmienda	Wanakuy.
enmohecerse	Ismurikuy.
enmudecer	Upallay.
ennegrecer	Yanayay.
enojarse	Phiñakuy.
enojo	Phiñachikuq.
enorme	Hatun hatun, hatunkaray.
enredadera	Arwi arwi.
enredarse	Arwikuy, t'ampachikuy.
enriquecerse	Qhapaqyay, apuyay.
enrojecer	Pukayachiy.
enronquecido	Ch'akayasqa.
enroscar	Q'iwiy, arwiy.
ensanchar	Hatunyachiy.
ensangrentar	Yawarchay.
ensayar	Yachachiy, yachaykachiy.
ensebar	Wirachay.
enseña	Unancha.
enseñar	Yachachiy.
ensordecer	Upayachiy.
ensuciar	Qhillichay, qanrachay.
entender	Unanchay, hamut'ay, riqsiy, yachay.
entendimiento	Unanchay, hamut'ay, yuyay.
enternecer	Llakichiy, waqachiy.
enterrar	P'ampay.
entibiar	(de frío a caliente): q'uñirichiy.\n(de caliente a frío): chiriyachiy.
entonces	Chaypacha, chikaqa, hinaptin, hinaptinqa, nispaqa.
entrada	Yaykuna, haykuna, q'asa.
entrañas	Wiksa ukhu.
entrar	Yaykuy, haykuy.
entregar	Chaskichiy, quy.
entretanto	Chaykama.
entreverar	Taqruy, takuy, chapuy.
entristecer	Llakichiy, phutichiy.
entrojar	Pirway, qullqay.
entumirse	Umphuyakuy.
enturbiar	Putkayachiy, qunchuyachiy.
enumerar	Yupay.
en vano	Qasilla, yanqalla, yanqamanta.
envejecer	(el hombre): machuyay.\n(la mujer): payayay.\n(hombre y mujer): yuyaqyay.\n(las cosas): mawk'ayay.
envenenar	Miyuchiy, hampiy.
enviar	Kachay, apachiy.
envidia	Chhikikuy.
envoltorio	Mayt'u, q'ipi.
envolver	Mayt'uy, p'istuy, pintuy.
epidemia	Hatun unquy.
epilepsia	Wañuy unquy.
epístola	Qillqa.
época	Pacha.
equipaje	Q'ipi.
equivocarse	Pantay.
era	(tiempo): wiñay, pacha.
erguirse	Huqarikuy, suniyakuy.
eriazo	Purun pampa, sumaq allpa.
eructar	Hapay, khakyay.
erudito	Hamawt'a.
errado	Pantasqa.
errar	Pantay, musphaykachay.
escabullirse	Chinkariy, lluptikuy.
escalar	Siqay, lluqay.
escalofrío	Chirayay, katkatay.
escampar	Usyariy.
escaparse	Qispikuy, pawariy, lluptikuy.
escarabajo	Aka tanqa.
escarbar	Hasp'iy.
escarcha	Qasa, chullunkuy.
escarmenar	T'isay.
escarmentar	Wanay, wanakuy.
escarpado	Ranra-ranra, rumi-rumi.
escasear	Pisiyay.
escasez	Muchuy, wanay.
escoba	Pichana.
escocer	Siqsiy, ruphay.
escoger	Akllay.
esconder	Pakay, p'ampay.
escondite	Pakakuna, chinkana.
escribir	Qillqay.
escritor	Qillqaq.
escuchar	Uyarikuy.
escudriñar	Maskhaykachay, tapuykachay.
escupir	Thuqay.
escurrir	Ch'umay, sut'uchiy.
escurrirse	Qispikuy, lluptikuy.
ese	Chay.
esa	Chay.
eso	Chay.
esfuerzo	Kallpachakuy.
eslabonado	T'inki-t'inki, t'inkisqa.
esmerarse	Sumaq ruray, allin ruray.
esófago	Tunquri.
espalda	Wasa, qhipa.
espantar	Manchachiy.
esparcir	Ch'iqichiy, mast'ay, maqchiy.
especial	Sumaq, akllasqa.
espejo	Lirpu ~ rirpu, qhawakuna qispi.
espera	Suyay, suyana.
esperar	Suyay, suyakuy.
espeso	Sankhu, pipu.
espía	Qhawaykachaq.
espigar	Parwayay.
espina	Kichka.
espinilla	Chaki sinqa.
esplendor	Llipipiq, k'anchaq.
espontáneamente	Kikillanmanta, munayninmanta.
espulgar	Pikichay.
espuma	Phusuqu.
esputo	Thuqay, llawsa.
esqueleto	Aya tullu, mallki.
esquilar	Rutuy.
esquina	K'uchu, muyuykuna.
estable	Takyaq, kakuq.
establecerse	Tiyapuy, yachakuy.
establo	Kancha.
estaca	Takarpu.
estación	(del año) Mit'a.
estallar	T'uqyay.
estanque	Qucha.
estar	Kachkay.
estatura	Sayay, chhikan.
este	Kay.
esta	Kay.
esto	Kay.
estéril	Qumi, urwa.
estiércol	Wanu, q'awa, taqya.
estimar	Yupaychay, khuyay; chaninchay.
estirar	Chutay, aysay.
estómago	Wiksa.
estorbar	Hark'ay, amachay.
estornudar	Achhiy, hachiy.
estrangular	Siq'uy, sipiy.
estrechar	Mat'iy, kichkichay.
estrella	Quyllur.
estrujar	Q'apiy, llapiy.
estudiante	Yachaq, yachakuq.
estudiar	Yachay.
eterno	Wiñay kaq, wiñay kawsay.
evaporar	Wapsiy.
evasión	Qispikuy.
evidente	Sut'in, kaqlla.
evitar	Anchukuy, asukuy.
examinar	Tapupayay, qhawapayay.
excavar	Hasp'iy.
exceder	Llalliy, yalliy.
excelente	Qullanan, sumaq.
exceptuar	Sapaqchay, rakiy.
excesivo	Achkha, ancha, llumpay.
excluir	Rakiy, akllay.
excremento	Aka, hatun hisp'ay.
exhalación	Samay, wapsiy.
exhibir	Qhawachiy, rikuchiy.
exhortar	Anyay, rimapayay.
exigir	Mañapay.
eximir	Wakichiy.
existente	Kaq, kawsaq.
existir	Kay, kawsay.
exonerar	Wakichiy, saqiy, rakiy.
expatriar	Qarquy.
expectar	Qhaway, rikuy.
expeler	Wikch'uy, wikapay.
experimentar	Yachay, malliy.
expiar	Muchuy.
explicar	Yachachiy, willay.
explorar	Maskhay, tapuykachay.
explosión	T'uqyay.
explotar	Mirachikuy, hurqukuy, qichukuy.
expresar	Rimay, willakuy.
exprimir	Ch'away, q'apiy, llapiy.
expulsar	Qarquy, wischuy.
extender	(algo): mast'ay.\n(la mano): hayway.\n(los brazos): ch'akatakuy.\n(los pies): ichiy, pallqay.\n(el cuerpo): chutakuy, chutapakuy.\n(la ropa al sol): masay.
exterior	Hawan.
exterminar	Qulluchiy, chinkachiy, paqwarichiy.
extinguir	Tukuchiy, wañuchiy.
extraer	Hurquy, chutay.
extranjero	Hawa runa.
extraño	Huk rikch'aq.
extraviarse	Pantapakuy, chinkapakuy.
fabricar	Ruray.
fácil	Ruranalla.
faena	Minka, ayni.
faja	Chumpi.
fajarse	Chumpikuy, watakuy.
falaz	Llullakuq.
falda	(prenda): miqllay, millqay.\n(del cerro): pata,waqta; qhata.
faldear	(un cerro) Kinray.
falso	Llulla, yanqa.
falta	Hucha.
faltar	(escasear): mana kay, muchuy, pisiyay.\n(no asistir): mana riy, mana hamuy.\n(cometer una falta): huchallikuy.
fallecer	Wañuy.
famélico	Yarqasqa.
familia	Ayllu.
famoso	Yachasqa, riqsisqa.
fanfarrón	Rimay siki.
fango	T'uru-t'uru, mitu-mitu.
fantasma	Manchachikuq.
fardo	Q'ipi, palta.
fastidiar	Amichiy, phiñachiy.
fastidioso	Amichikuq, phiñachikuq.
fatigarse	Sayk'urikuy, pisipay.
favor	Yanapay.
favorito	Munasqa.
faz	Uya, rikch'ay.
fecha	P'unchaw, pacha.
felicidad	Kusi sami, kusi kawsay.
felicitar	Napaykuy, rimaykuy.
feliz	Kusi samiyuq, kusi kawsakuq.
femenino	Warmi, china.
fémur	Maman tullu, chaka tullu.
fenecer	Tukukuy, chinkay, wañuy.
feo	Millay.
feraz	Ruruq, miraq.
féretro	Aya wantuna, aya apana.
fermentar	Puquy.
fermento	Qunchu, puquchina.
feroz	Phiña-phiña.
festejar	Yupaychay, kusichiy.
fetidez	Asnay.
feto	Sullu.
fiambre	Quqaw, milkapa.
fiar	Manuy.
fibra	Hank'u.
fiebre	Ruphay unquy.
fiero	Phiña runa.
fierro	Qhillay.
fiesta	Hatun p'unchay.
figura	Rikch'ay, niray.
fila	Siq'i.
filo	Ñawch'i.
filtrar	Sut'uchiy, suysuy.
fin	P'uchukay, tukuynin.
finado	Wañusqa.
fingir	Tukuy.
finito	Tukukuq, p'uchukaq.
fino	Sumaq.
firmar	Suti qillqay, suti churay.
firme	Takyaq.
flaco	Tullu, iqu.
flagelar	Waqtay, hasut'iy.
flauta	Qina, pinkullu.
flecha	Wach'i.
flema	Llawsa, lawsa.
flojera	Qilla kay, qillanakuy.
flojo	(algo suelto) Waya.
flor	T'ika, wayta; sisa.
florecer	T'ikay, sisay.
flotar	Tuytuy, wamp'uy.
fluir	Sutuy, unyay.
fogón	Q'uncha, tullpa.
fondo	Ukhu, ukhun.
forado	Utkhu, uchku.
forastero	Hawa llaqta runa.
forma	Rikch'ay.
fornicador	Wach'uq runa, map'a runa.
forraje	Q'achu, chhalla, qura.
fortalecer	Sinchiyay, kallpanchay.
fortaleza	Pukara.
fortuna	Sami.
forzudo	Kallpayuq, kallpasapa.
fosa	P'ukru, uchku.
fracturar	P'akiy.
fragancia	Q'apay, misk'i asnay.
frágil	P'akinalla.
frangollar	Chhamqay.
frazada	Qata.
fregar	Qaquy, pichay.
freír	Thiqtichiy.
fréjol	Purutu.
frente	Mat'i, urku.
frío	Chiri, alalay.
frontera	Tukuynin, p'uchukaynin.
frotar	Qaquy.
fructífero	Ruruq, wayuq.
fruncir	Sip'uy.
frustrar	Waqllichiy.
fruta	Ruru.
fuego	Nina.
fuelle	Phukuna, wayrachiq.
fuente	Pukyu.
fuera	Hawa.
fuerza	Kallpa.
fuga	Chinkay, qispikuy.
fundar	Tiqsiy, qallarichiy.
fundir	Chulluchiy.
futuro	Hamuq, qhipa hamuq.
gacho	K'umu.
galardonar	Kusinchay, saminchay.
galga	Kumpa rumi, kuchpa.
gallina	Wallpa.
gallinazo	Suyuntuy, ullatu.
gallo	K'anka, utulu.
ganado	Uywa.
ganar	Huñukuy, mirachikuy.
gangoso	Qanqa, qanqa rimaq.
gangrena	ismuy unquy.
garabatear	Siq'iy, yanqata qillqay.
garganta	Kunka, tunquri.
garra	Sillu.
garrapata	Hamak'u, usa.
garrote	Maqana, k'aspi.
garúa	Iphu.
gastar	Tukuy, p'uchukay.
gatear	Rat'ay, lluqaykachay.
gato	(doméstico): misi.\n(montes): usqullu.
gavilán	Anka, waman.
gaviota	Qiwlla ~ qillwa.
gemir	Anchiy, llakikuy.
género	Masi, rikch'aq.
generoso	Qukuq.
gente	Runa.
genuflexión	Qunqurikuy.
germen	Muru.
germinar	Wach'iy, wiñay.
gestación	Wiksayakuy.
gigante	Hatunkaray.
girar	Muyuy.
glotón	Mikhuysapa.
gobernar	Kamachiy.
golpe	Takay.
golpear	Takay, maqay, saqmay.
gordo	Wira, wirasapa.
gorgojo	Puyu, uru.
gorro	Ch'ullu.
gotear	Sut'uy.
gozar	Hat'alliy, kusikuy.
grada	Pata-pata.
grande	Chhika hatun.
granero	Qullqa, pirwa.
granizo	Chikchi, runtu.
grano	Muru.
grasa	Wiswi, map'a.
gratis	Ñanqalla. (yanqalla?)
grato	Misk'i, sumaq.
greda	Llank'i allpa, mitu.
grieta	Raqra.
grillo	Ch'illikutu, chilliku.
gris	Ch'iqchi, muru-muru.
gritar	Qapariy.
grosero	Map'a simi, qanra simi.
grosor	Rakta, rakhu.
grupo	Qutu, suntu.
gruta	Mach'ay.
guapear	Qapariy.
guardar	Waqaychay.
guardia	Waqaychaq.
guarecerse	Qurpakuy.
guerrear	Awqanakuy, maqanakuy.
guía	Pusaq.
gusano	Kuru, uru.
gustar	Malliy, misk'ichikuy.
haber	Kay.
hábil	Yuyayniyuq, umayuq.
habitación	Wasi, tiyana.
habitar	Tiyay, kawsay, yachay.
habituarse	Yachaymanakuy, yachakay.
habla	Rimay, simi, rimaynin.
hablar	Rimay, rimarquy.
hacedor	Kamaq, ruraq.
hacer	Ruray, hinay.
hacinar	Qutuy, arkuy, pirway.
halagar	Waylluy, wayllipay.
halcón	Waman.
hálito	Samay.
hallar	Tariy.
hallazgo	Ñawincha.
hambre	Yarqay, mikhunayay.
hambriento	Yarqasqa.
haragán	Qilla.
harapo	Thanta, latapa.
harina	Hak'u, machka.
hartarse	Saksay, saksaykuy.
harto	Achkha.
hastío	Amiy, millay.
hebra	Q'aytu.
hechizar	Layqay, umuy.
heder	Asnay.
hediondo	Asnaq.
helada	Qasa.
helar	Qasay.
helecho	Raki-raki.
hembra	China.
hemorragia	Yawar unquy.
hemorroide	Uquti unquy.
henchir	Hunt'achiy, winay.
hender	Raqrachiy, ch'iqtay.
hendidura	Raqra.
herida	K'iri.
hermafrodita	Maqlla.
hermana	(de hermana): ñaña.\n(de hermano): pana, pani.
hermano	(de hermano): wawqi.\n(de hermana): tura, turi.
hermoso	Sumaq.
hermosura	Sumaq kay.
hervir	T'impuy.
hez	Qunchu, tallpu.
hiel	Hayaq.
hielo	Qasa; chullunkuy.
hierba	Qura, qhachu.
hierro	Qhillay.
hígado	K'ipchan.
hija	(del padre) Ususi.
hijo	(del padre): churi.\n(de la madre): wawa.
hilar	Puchkhay.
hilo	Q'aytu, watu.
hincar	T'urpuy, tuksiy.
hincharse	Punkiy.
hipo	Hik'i, hikchuy.
hipócrita	Isqay sunqu, pallqa sunqu.
hogar	Wasi.
hoja	Rap'i ~ raphi, rapra.
holgazán	Qilla, purikuq.
hollar	Saruy.
hollejo	Qara.
hollín	Qhichincha, qitya.
hombre	Qhari, runa.
hombro	Rikra.
homenaje	Yupaychay.
homogéneo	Chay rikch'aqlla.
honda	Warak'a.
hondo	Ukhu.
hondón	P'ukru.
hondonada	Wayq'u.
hongo	K'allampa.
honrar	Yupaychay.
hora	Pacha.
horadar	Hutk'uy, uchkuy.
horca	Warkuna.
horcón	Kallapa.
hormiga	Sisi.
hospedar	Qurpachay, samaykachiy.
hostigar	Amichiy.
hostil	Awqa.
hoy	Kunan, kanan.
hoya	Wayq'u, p'ukru.
hoz	Rutuna.
hozar	Uksiy, untiy.
hueco	T'uqu, hutk'u, uchku.
huella	Yupi.
huérfano	Wakcha.
huero	Lluqllu, luqlu.
huerta	Muya.
hueso	Tullu.
huésped	Qurpachakuq, samapakuq.
huevo	Runtu.
huir	Ayqiy, qispiy.
humanidad	Runa kay.
humear	Q'usñiy.
humedad	Huq'u, nuyasqa.
humillar	K'umuchikuy, ullpuykachiy.
humo	Q'usñi, wapsi.
hurtar	Suway, suwakuy.
husmear	Mutkipakuy, muskikachay.
huso	Puchkha.
idear	Yuyay, yuyaykuy.
idéntico	Kaqlla, paqtalla, kuskalla.
idioma	Simi, rimay.
idiota	P'anra, mana yachaq.
ignorar	Mana yachay.
igual	Kuska, hinalla.
igualar	Kuskachay.
iluminar	K'anchachiy.
ilustrar	Yachachiy.
imagen	Rikch'ay.
imaginar	Yuyaykuy.
imborrable	Mana pichakuq, mana chinkaq.
imitar	Qatichiy, yachapakuy.
impar	Ch'ullan.
impedir	Hark'ay, mich'akuy.
imperecedero	Mana tukukuq.
implorar	Mañay, mañarikuy.
impotente	Qumi, urwa.
imputar	Huchachay.
inacabable	Mana tukuq.
inamovible	Mana kuyuchina.
inaudito	Mana uyarisqa.
incansable	Mana sayk'uq, mana pisipaq.
incapaz	Mana atiq.
incendiar	Ruphachiy, kañay.
incinerar	Uchphayachiy.
incipiente	Qallariq.
incitar	Yachachiy.
inclinarse	K'umukuy.
incomodar	Phiñachiy.
incompleto	Mana hunt'asqa, mana tukusqa.
incomprensible	Mana hamutana. (hamut'ana?)
inconsciente	Mana hamutaq. (hamut'aq?)
incontable	Mana yupana.
incorregible	Mana wanaq.
incremento	Miray.
incubar	Uqllay.
inculcar	Willapayay, kunapayay.
inculpar	Huchachay, tumpay.
incurable	Mana alliyaq.
indagar	Tapuykachay.
ndecible	Mana rimana.
indeleble	Mana pichakuq, mana chinkariq.
indemnizar	Kutichipuy, qupuy.
indicar	Riqsichiy, rikuchiy.
indigente	Wakcha.
indignado	Phiñasqa.
indisponer	Chiqnipachiy.
indocto	Mana yachaq.
indolente	Mana llakikuq.
indomable	Sallqa.
inducir	Tanqay.
indulto	Pampachay.
inequívoco	Mana pantana.
inexistente	Mana kawsaq.
infamar	Wasan rimay.
infante	Wawa.
inferior	Sullk'a, urayninpi.
infinito	Mana tukuq, tupunnaq.
inflamar	Rawray.
inflar	Phukurquy.
informar	Willay.
infringir	Sarunchay, p'akiy.
ingenioso	Hamutaq, yachaysapa.
inhumación	P'ampay.
injuriar	Allquchay, qamiy.
inmiscuirse	Chhaqrukuy.
inmortal	Mana wañuq.
inmundo	Qhilli, qanra.
inocente	Mana huchayuq.
inolvidable	Mana qunqana.
inquirir	Tapuykachay.
insaciable	Mana saksaq.
insecto	Uru.
inseparable	Mana rakikuq.
insignia	Unancha.
insípido	Q'ayma, qamya.
insoluble	Mana chulluq.
inspector	Qhawaq.
instruir	Yachachiy.
insultar	Q'amiy.
intacto	Kaqlla, chaynalla.
íntegro	Lliw, llapan.
inteligente	Umayuq, yuyayniyuq.
intercalar	Chawpichay.
interceder	Mañapuy, rimapuy.
interés	Wachaynin.
interior	Ukhu.
intermedio	Chawpin.
interminable	Mana tukuq.
internar	Yaykuchiy.
interpelar	Tapupayay.
interrogar	Tapuy.
interrumpir	Hark'ay.
intestinos	Ch'unchulli.
intimar	Qatiriy.
intimidar	Manchachiy.
intrépido	Mana manchaq.
introducir	Yaykuchiy, pusaykuy, sat'iy, usthuchiy.
inundar	Lluqllay.
inútil	Yanqa.
invadir	Yaykuy.
inventar	Rikhurichiy, paqarichiy.
invertir	Chaquy, t'ikray.
investigar	Maskhay.
ir	Riy.
ira	Phiña kay.
iracundo	Phiña sunqu.
izquierdo	Lluq'i, ichuq.
jadear	Sayk'uy.
jalar	Chutay, aysay.
jamás	Mana imaypas, mana hayk'aq.
jarana	Machay, upyay.
jardín	Muya.
jarro	P'uyñu, wisina.
jeta	Wirp'a.
jiba	Muqu, k'umu.
jornalero	Llamk'aq.
joven	(varón): warma, wayna.\n(mujer): warma, sipas.
jovial	Sumaq sunqu.
juego	Pukllay.
jugador	Pukllaq.
jugo	Wiqin.
juguete	Pukllana.
juicio	Yuyay.
juicioso	Yuyayniyuq.
junta	Tantanakuy, huñunakuy.
juntar	Tantay, huñuy.
junto	Kuska, pura.
justo	Chanin.
justicia	Chaninchay.
labio	Wirp'a.
labor	Rurana.
laborioso	Llamk'akuq, rurakuq.
labrar	(cualquier cosa): llamk'ay.\n(la madera): llaqllay.\n(la tierra, arar): yapuy, chakmay.
labriego	Llamk'aq, chakraruna.
lactar	Ñuñuy.
ladear	Waklliy, waqlliy.
ladera	Waqta, kinray.
lado	(derecho): paña, alliq.\n(izquierdo): lluq'i, ichuq.\n(del frente): chimpa.\n(hacia un lado): kinrayman.\n(a lado): kuska.
ladrar	Anyay.
ladrillo	Sañu tika.
ladrón	Suwa.
lagartija	Sukullukuy, qaraywa.
lago	Qucha.
lágrima	Wiqi.
laguna	Qucha.
lamentable	Waqanapaq.
lamer	Llaqway, llunk'uy.
lana	Millwa, millma.
lancha	Wamp'u.
langosta	Aqarway.
lanza	Chuki.
lanzar	Wikch'uy, qarquy, wikapay.
largo	Suyt'u, suni, hatun.
laringe	Tunqur, tunquri.
lastimarse	Kirikuy.
lastimoso	Llakinapaq.
látigo	Hasut'i, waskha.
lavar	(ropa y cabeza): t'aqsakuy.\n(manos y pies): mayllakuy.\n(la cara): uphakuy.\n(el cuerpo): armakuy.\n(la boca): muqch'ikuy, chumchikuy.
lazo	Qara waskha.
leche	Ñuñu.
lecho	Puñuna.
lechuza	Ch'usiq, tuku.
legaña	Ch'uqñi, wiqti.
lejano	Karu.
lengua	Qallu.
leña	Llamt'a, yanta.
león	Puma.
letrado	Hamawt'a, yachaq.
levadura	Qunchu, p'uchqu.
levantar	(alzar): huqariy.\n(poner verticalmente): sayachiy.\n(en brazos): marq'ay.
levantarse	Hatariy, sayariy.
liar	Wankuy, watay.
libélula	Kachi suwa, chukcha k'utu.
libertar	Qispichiy.
libre	Munayniyuq.
licuar	Unuyachiy, yakuyachiy.
lidiar	Maqanakuy, takanakuy.
liendre	Ch'iya.
ligar	Watay.
ligero	Utqhaq, k'uchi, wayralla.
límite	Qayllan, tukuynin.
limpiar	Pichay.
limpio	Ch'uya, pichasqa.
lindo	Ima sumaq, ancha sumaq.
línea	Siq'i.
líquido	Unu-unu, yaku-yaku.
lirio	Hamank'ay, amankay.
liso	Lluchk'a, llamp'u.
liviano	Llapsalla, chhallalla.
loco	Utiq.
locuaz	Rimaysapa.
lodo	T'uru, mitu.
loma	Pata.
lombriz	K'uyka.
lomo	Wasa.
longevo	Ruku, yuyaq.
loro	Uritu.
lucero	Ch'aska quyllur.
luciérnaga	Pinchi kuru, nina uru.
lucir	K'anchay, llipipiy.
lucro	Miray, miraynin.
luchar	Maqanakuy, qatipanakuy, awqanakuy.
lumbre	Nina, sansa.
luna	Killa.\n(nueva): musuq killa.\n(creciente): wiñay killa, llullu killa.\n(llena): pura killa, puquy killa.\n(conjunción de la luna): wañuy killa.
lunar	Ana.
lustroso	K'anchaq, llipikyaq.
luz	K'anchay, achikyay.
llaga	K'iri.
llama	(de fuego) Rawray, nina.
llamar	Waqyay, qayay.
llanura	Pampa.
llave	Kichakuq.
llegar	Chayay, chayamuy.
llenar	Hunt'ay, winay.
lleno	Hunt'asqa.
llevar	(a alguien): pusay.\n(algo): apay.\n(en brazos): marq'ay.\n(arrastrando): aysay.\n(en camilla): wantuy.\n(en la espalda): q'ipiy.\n(empuñando): hapt'ay.\n(en la falda): millqay.
llorar	Waqay.\n(a gritos): qapariy.
llover	Paray, paramuy.
llovizna	Iphu.
lluvia	Para.
macizo	Anaq.
machacar	Chhamqay.
macho	Urqu.
machorra	Qumi, urwa.
machucar	Ñit'iy.
madera	K'ullu, k'aspi.
madrastra	Qhipa mama.
madre	Mama.
madrugar	Tutapay.
madurar	Puquy.
maduro	Puqusqa, chayasqa.
maestro	Yachachiq.
magnánimo	Sunquyuq, allin runa.
maguey	Chuchaw, paqpa.
maíz	Sara.\n(tierno): chuqllu.\n(sancochado): mut'i.\n(tostado): hamk'a, kamcha.\n(duro): muruchu.\n(envoltorio): p'anqa.\n(tallo): chhalla.\n(flor): parwa.
mal	Mana allin.
malbaratar	Usuchiy, chinkachiy.
maldad	Mana allin kay.
maldecir	Ñakay.
maldito	Ñakasqa, supay runa.
maleficio	Layqay, runap makin.
malestar	Mana allin kay.
maleza	Qura-qura, sach'a-sach'a.
maliciar	Watupakuy, musyapakuy.
malo	Mana allin.
maltratar	Maqay.
malvado	Millay runa.
mamar	Ñuñuy, chuchuy.
mamífero	Ñuñuyuq.
manada	Michina uywa.
manantial	Pukyu.
manar	Phullpuy, lluqsimuy.
manco	Ch'ullan maki, kutu maki.
mancha	Qhilli, map'a, qanra.
mandar	(enviar): kachay.\n(ordenar): kamachiy, willay.
mandíbula	K'aki, k'akichu.
manera	Hina.
mango	(de herramienta) Hap'ina.
maní	Inchik.
mano	Maki.\n(derecha): paña maki, alliq maki.\n(izquierda): lluq'i maki, ichuq maki.\n(de mortero): qulluta.\n(de batán): tunaw, tunay.
manojo	Mayt'u, aptiy, hapt'ay.
manosear	Llap'ipayay, llamk'apayay.
manso	Llamp'u sunqu.
manta	Phullu, lliklla.\n(de cama): qatakuna.
mantener	Uyway, mikhuchiy.
manubrio	Hap'ina.
mañana	(día siguiente): paqarin, q'aya p'unchaw.\n(por la mañana): tutamanta.\n(pasado mañana): minchha.
mañoso	Yachaysapa.
mar	Mama qucha.
maraña	T'ampa, ch'aska, arwi.
marca	Sananpa.
marchar	(viajar) Riy, puriy, illariy.
marchitarse	Ch'akikuy, qawikuy.
maricón	Maqlla.
marido	Qusa.
mariposa	Pillpintu.
martillo	Takana.
más	Aswan.
mascar	(cosas duras): khachuy.\n(cosas jugosas): mullmuy.\n(coca): akuy, akulliy.
masticar	Qamuy, khachuy.
máscara	Saynata.
masculino	(humano): qhari.\n(animal): urqu.
mata	(planta) Yura, sach'a.
matar	Wañuchiy.
materia	(pus) Q'iya.
mayor	(de edad) Kuraq.
mazamorra	Api.
mazorca	Sara kaspa.
mear	Hisp'ay.
mecer	Kuyuchiy, wayllunchay.
mediano	Taksa.
mediar	Chawpichay, amachay.
medicamento	Hampi.
médico	Hampiq, alliyachiq.
medida	Tupu, tupuna.
medio	Chawpi.
medir	Tupuy.
meditar	Yuyaymanay.
medroso	Manchaq.
mejilla	Uya.
mejor	Aswan allin.
mejorar	Allinyay.
melancolía	Llakikuy, phutikuy.
meloso	Misk'i, misk'isapa.
memoria	Yuyay.
mendigar	Uskakuy, mañakuy.
menear	Qaywiy, kuyuchiy.
menor	(en edad) Sullk'a.
menos	Pisi, aslla.
menoscabar	Pisiyachiy.
menospreciar	Allquchay.
mensajero	Kacha, kachasqa.
menstruar	Map'akuy.
mensual	Killanpiq, sapa killa.
mentalmente	Umallapi.
mente	Uma, yuyay.
mentir	Llullay, llullakuy.
menudo	Ñut'u, akapa.
meollo	Ñutq'u.
mercado	Qhatu.
merendar	Mikhuy.
mérito	Kamaynin.
mermar	Pisiyay, chinkariy.
mes	Killa.
mesón	Tampu, samakunawasi.
meter	(algo o a alguien): yaykuchiy.\n(embutir): sat'iy.\n(en un costal): winay.\n(por un hueco): usthuchiy.
mezcla	Chhaqru, chapu.
mezclar	Chhaqruy, chapuy.
mezquino	Mich'aq.
miedo	Manchay.
miedoso	Manchakuq.
miel	Misk'i.
miembro	(genital) Ullu, rani.
mientras	Chaykama.
mierda	Aka.
mil	Waranqa.
mimar	Waylluy.
mina	Q'uya.
mío	Ñuqap.
mirar	Qhaway.
miserable	(avaro): mich'a.\n(desgraciado): wakcha.
mismo	Kiki.
mitad	Ch'iqta.
mitigar	Thaniy.
moco	Qhuña, ñuti.
mocho	Mut'u, kutu.
moderno	Musuq, wamaq.
modo	Hina.
mojar	Huq'uchay, nuyuchiy.
mojón	Saywa.
mole	Wank'a.
moler	Kutay.
molestar	K'uchichiy, phiñachiy.
momia	Mallki.
mono	K'usillu.
montaña	(cerro): urqu.
valle	yunka.
montaraz	K'ita, sallqa.
montón	Tawqa, qutu, suntu.
mordaz	Hayaq simi.
morder	Kaniy.
moreno	Yana.
moribundo	Wañunayaq.
mortaja	Aya p'acha.
mortero	Muchk'a, mutk'a.
mosca	Ch'uspi.
moscardón	Wanquyru, wayrunqu, t'ankayllu.
mostrar	Rikuchiy, qhawachiy.
motín	Hatariy.
motivar	Raykuy.
mover	Kuyuchiy.\n(los líquidos): qaywiy.
móvil	Kuyuq.
movimiento	Kuyuy.
moza	Sipas, p'asña.
mozo	Wayna, maqta.
mucosidad	Llawsa, lawsa.
muchacho	Warma.
mucho	Achkha.
mudar	Tukuy.\n(de domicilio): astakuy.\n(de parecer): t'ikrakuy.
mudo	Upa, mana rimaq.
muela	Maray kiru.
muerte	Wañuy.
muerto	Wañuq, wañusqa, aya.
mugre	Wiswi, qanra.
mujer	Warmi.
muladar	Wanu pata, q'upa-q'upa.
muleta	Tawna, k'aspi.
multiplicar	Mirachiy.
mundo	Tiqsi muyu, pacha.
muñeca	(juguete): wawa pukllana.\n(parte del brazo): maki muqu.
muralla	Pirqa.
murciélago	Masu.
muro	Pirqa.
mutilar	Qhuruy, kutuy.
muy	Ancha, llumpay.
nacer	Paqariy, yuriy; wiñay.
nada	Ch'usaq, mana imapas.
nadar	Wayt'ay.
nadie	Mana pipas.
nalga	Siki, qhipa.
nariz	Sinqa.
narrar	Willay.
naturaleza	Kaynin.
neblina	Phuyu.
necesitar	Muchuy.
negar	Mana niy.
negrear	Yanayay.
negro	Yana.
nervio	Hank'u.
nevada	Rit'i.
nevar	Rit'iy.
nido	Q'isa, q'isacha.
niebla	Phuyu, wapsi.
nieto	Willka.
nieve	Rit'i.
nigua	Piki.
ninguno	Mana pipas.
niño	Wawa.
no	Mana.\n(prohibitivo): ama.
noche	Tuta.
nombrar	Sutinchay.
nombre	Suti.
nosotros	(inclusivo): Ñuqanchik.\n(exclusivo): ñuqayku.
noticia	Willay, willakuy.
nube	Phuyu.
nublar	Phuyuy; llanthuy.
nuca	Qhipa kunka.
nudo	Khipu.
nuera	Qhachun, llumchuy.
nuevamente	Musuqmanta.
nueve	Isqun.
nuevo	Musuq.
nulo	Ñanqa.
numerar	Yupay.
numeroso	Achkha.
nunca	Mana haykap, mana imaypas.
obedecer	Uyakuy, kasukuy.
oblongo	Suyt'u.
obra	Rurana, llamk'ana.
obsequiar	Qukuy.
observar	Qhaway.
obstáculo	Hark'aq.
obstruir	Kirpay, wichq'ay.
ocasión	Rayku.
ocasionar	Raykuy.
ocaso	Intip yaykunan.
ociosidad	Qilla kay, qillanakuy.
ocioso	Qilla.
ocultar	Pakay, p'ampay.
ocho	Pusaq.
odiar	Chiqniy.
ofender	Qamiy, phiñachiy.
ofrecer	Qukuy.
oír	Uyariy.
ojo	Ñawi.
ola	Quchap puqchin.
oler	(percibir): muskhiy.\n(exhalar buen olor): q'apay, sumaq asnay.\n(exhalar mal olor): asnay.
olfato	Sinqa.
olvidar	Qunqay.
olla	Manka.
ombligo	Pupu, puputi.
opinar	Hamutay, yuyaymanay.
oprimir	Ñit'iy.
opulento	qullqisapa.
orar	Mañakuy.
ordenar	(mandar): kamachiy.\n(las cosas): allichay.
ordeñar	Ch'away, qapiy.
oreja	Rinri.
oriente	Intip lluqsimunan.
origen	Qallaykuynin.
orilla	Pata.\n(la otra): chimpa.
orinar	Hisp'ay.
oro	Quri.
ortiga	Kisa, itana.
oscuro	Tuta.
oso	Ukumari.
otro	Huk.
ovar	Runtuy, churay.
ovillo	Kurur.
oyente	Uyariq.
paciencia	Muchuy.
pacificar	Amachay, hawkayachiy.
pacífico	Llamp'u sunqu, qasi sunqu.
pactar	Rimanakuy, ninakuy.
padecer	Ñak'ariy, muchuy.
padrastro	Qhipa tayta.
padre	Yaya, tayta.
padrino	(de bautizo) Marq'aqi.
país	Llaqta.
paisano	Llaqta masi.
paja	Ichu.
pájaro	Pisqu.
palabra	Simi, rimay.
paladear	Malliy, misk'ichikuy.
pálido	Q'illu.
palizada	Qincha.
palmear	T'aqllay.
palo	K'aspi.
paloma	Urpi, urpay.
palpitar	P'atatay, t'ipuqyay.
pan	T'anta.
pantano	T'uru-t'uru, millp'u, siniya.
panteón	Aya wasi.
pantorrilla	Ch'upa.
panza	Wiksa.
pañal	Aka wara.
papá	Yaya, tayta.
papera	Q'utu.
papirote	T'inkay.
par	Yanantin, masantin.
parada	Samana, paskana, sayk'una.
paralizar	Thanisqa, sayk'usqa.
páramo	Purun pampa.
parar	Sayay.
pararse	Sayariy, hatariy.
pardo	Ch'umpi, uqi.
parear	Yananchay, masanchay, kuskachay.
parecer	Rikch'akuy.
pared	Pirqa.
parejo	Kuskalla, kuskapura.
parentela	Ayllu masi, ayllupura.
pariente	Ayllu, yawar masi.
parir	Wachay, wachakuy.
parlar	Rimaykachay.
parpadear	Chimlliykachay, qimllaykachay.
partir	Ch'iqtay, rakiy.
parto	Wachay, wachakuy.
párvulo	Wawa.
pasado	(tiempo) Ñawpaq, qayna.
pasear	Puriykachay.
pasión	Ñakay, ñakariy, muchuy.
paso	Thatkiy, ichiy.
pasto	Q'achu, qiwa.
pastear	Michiy, michipay.
pastor	Michiq, michipakuq.
patear	Hayt'ay.
patata	Papa.
patituerto	Wist'u chaki.
patria	Llaqta.
patrón	Uywaq.
paz	Allin kawsay, qasi kawsay.
peca	Mirkha.
pecado	Hucha.
pecar	Huchallikuy.
pecho	Qhasqu.
pedir	Mañay, mañakuy.
pedo	Supi.
pedregal	Rumi-rumi, ranra-ranra.
pegar	(golpear): maqay.\n(adherir): k'askachiy, laqachiy.
peinar	Ñaqch'ay.
peine	Ñaqch'a.
pelado	Q'ara, q'ala.
pelar	T'iqpay, siplay.
pelear	Maqanakuy, awqanakuy.\n(a trompadas): takanakuy.\n(a puntapiés): hayt'anakuy.\n(a palos): wipyanakuy.
peligro	Ch'iki, manchay.
pelo	Chukcha.
pellejo	Qara.
pellizcar	T'ipiy, t'ipsiy.
pena	Llaki, ñak'arikuy.
pene	Ullu, p'inqay.
penetrar	Yaykuy, usthuy.
pensamiento	Yuyay, yuyaymanay.
pensar	Yuyay, yuyaykuy.
penuria	Muchuy pacha, yarqay pacha.
peña	Qaqa, wank'a.
peón	Llamk'aq.
peor	Aswan mana allin.
pepa	Ruru, muhu.
pequeño	Huch'uy, uchuk.
perder	Chinkay.
perdiz	P'isaq, yuthu.
perdonar	Pampachay.
perecer	Qulluy, tukukuy, wañuy.
pereza	Qillakuy.
perfecto	Sumaq.
perforar	Hutk'uy, uchkuy, tuquy..
perfume	Q'apaq, misk'i asnaq.
pericia	Yachay.
pericote	Huk'ucha.
perito	Yachaq.
permanecer	Kaqlla kay, hina kay.
permitir	Huniy, aniy.
permutar	Rantinakuy.
pero	Ichaqa.
perpetuar	Wiñaychay, unaychay.
perro	Allqu.
perseguir	Qatikachay, qatipay.
persona	Runa.
persuadir	Hunichiy, awnichiy.
perturbar	Chaquy, waqllichiy.
pervertir	Wakllichiy, waqllichiy.
pesado	Llasa, llasaq.
pesar	Llasay.\n(en la balanza): warkuy.\n(dolor): llakikuy.
pesarse	Llakikuy, phutikuy.
pescado	Challwa.
pescar	Challway, challwa hap'iy.
pescuezo	Kunka.
pésimo	Millay-millay.
peso	Llasa, llasaynin.
pesquisa	Tapupayay.
pestaña	Qhichipra.
peste	Muchuy-unquy.
petrificado	Rumiyachisqa.
pez	Challwa.
pezón	Ñuñu, chuchu.
pica	Hatun chuki.
picante	Hayaq.
picar	(al paladar): hayay.\n(la víbora o la pulga): kaniy.\n(las aves): tupsay.
pico	T'apsa, tupsa.
picotear	T'apsay, tupsay.
pie	Chaki.
piedra	Rumi.
piel	Qara.
pierna	Chanka.
pillar	Suway.
pinchar	T'urpuy, tuskiy.
pintar	Llusiy.
piojo	Usa.\n(de gallina): itha, chuchuy.\n(de otros animales): hamak'u.
pisada	Yupi, sarusqa.
pisar	Saruy.
pito	(ave): hak'akllu.\n(instrumento): wisyana, sukana.
placer	Q'uchukuy, kusikuy.
planicie	Pampa.
planta	(vegetal): yura, sach'a, mallki.\n(del pie): saruna.
plantar	Yuray, tarpuy.
plata	Qullqi.
plato	P'uku, mat'i.
playa	Mayu pata, qucha pata.
plazo	Suyana.
plegar	Pataray.
pleno	Hunt'a.
plomizo	Uqi.
plomo	Titi.
pluma	Phuru.
población	Llaqta.
pobre	Wakcha.
pobreza	Wakcha kay.
pocilga	Khuchi wasi.
poco	Pisi, aslla.
podar	Ch'apray.
poder	Atiy, atipay.
poderoso	Atipaq.
podre	Q'iya.
podredumbre	Ismuy.
podrido	Ismusqa.
polilla	Thuta; puyu.
polvo	Allpa.
pomada	Llusikuna.
poner	Churay.
poniente	Intip yaykunan, intip churakunan.
ponzoña	Miyu.
porquería	Qhilli, wiswi, qanra.
portada	Punku.
portar	Apay, apamuy.
portátil	Apanalla.
portillo	Q'asa.
porvenir	Q'aya, hamuq.
posada	Tampu, samakuna.
poseer	Uyway.
positivo	Chiqaq.
posponer	Qhipanchay.
posteridad	Qhipa hamuq.
posterior	Qhipa kaq.
potable	Upyanalla.
potaje	Mikhuy, mikhuna.
potente	Atipaq, kallpayuq.
poyo	Pata.
practicar	Yachapakuy, rurapakuy.
pradera	Waylla pampa.
preceder	Ñawpariy.
precio	Chanin.
precioso	Sumaq.
precipicio	Qaqa, kuchpana.
precisar	Utqhachiy.
precursor	Ñawpariq.
predecir	Watuy, musyay.
pregonar	Waqyaykachay, qayaykachay.
preguntar	Tapuy.
premiar	Saminchay, chaninchay.
prenda	Manu rantiy.
prender	T'ipay, hap'ichiy.\n(la planta): saphichakuy.\n(la vacuna): hap'iy, ratay.\n(la luz): hap'ichiy.
preñada	Wiksayuq, chichu.
preparar	Kamariy, allichay.
presagiar	Watupakuy, musyapakuy.
presencia	Ñawki.
presentar	Rikuchiy, riqsichiy.
preservar	Waqaykachay.
preso	Hap'isqa, watasqa.
prestar	Mañay, manuy.
presuroso	Phawaq, utqhaq.
primero	Ñawpaq.
principal	Qullanan.
principiar	Qallariy.
prisa	Utqhay.
prisión	Watay wasi, wichq'ana.
privar	(despojar) Qichuy.
probar	Malliy.
producir	Wachay, miray.
profundo	Ukhu.
profuso	Achkha, nanaq.
prohibir	Hark'ay, ama niy.
prohijar	(el varón): churichakuy.\n(la mujer): wawachakuy.
prójimo	Runa masi, niraq masi.
proletario	Wakcha, mana imayuq.
prolongar	Unachiy.
propagar	Mirachiy, mismichiy.
propalar	Willaykachay.
propietario	Kaqniyuq.
prorrogar	Suchuchiy.
proteger	Amachay, yanapay.
provincia	Suyu.
prueba	Mallina.
publicar	Yachachiy, willaykachay.
pudrir	Ismuy.
pueblo	Llaqta.
puente	Chaka.
puerta	Punku.
pues	Ari.
pujar	Qamay.
pulga	Piki.
pulir	Lluchk'ayachiy, llamp'uyachiy.
pulmón	Surq'an.
pulverizar	Ñut'uchiy.
punta	Ñawch'i.
punzar	T'urpuy, tuksiy.
puñada	Takay.
puñado	Hapt'ay, phuqtuy, putquy.
pupila	Ñawi ruru.
purificar	Ch'uyayay.
puro	Ch'uya sunqu.
pus	Q'iya.
putrefacto	ismusqa.
qué	Ima.
quebrada	Wayq'u.
quebrar	P'akikuy.
quedar	Qhipay.
quehacer	Rurana.
quemado	Ruphasqa, kañasqa.
quemar	(el sol): ruphay.\n(el fuego): kañay.
querer	Munay, khuyay.
quién	Pi.
quieto	Qasilla.
quijada	K'aki, kakichu.
quitar	Qichuy, waykay.
quizás	icha, ichapas, paqta.
rabia	Phiñay, phiñakuy.
rabiar	Phiñakuy.
rabioso	Phiña.
rabo	Chupa.
racional	Yuyayniyuq.
radicarse	Saphinchakuy.
raíz	Saphi.
rajado	Ch'iqtasqa; raqrasqa.
rajar	Ch'iqtay.
rama	K'allma, ch'apra.
rana	K'ayra.
rapar	Rutuy.
rápido	Utqhay, phaway.
rapiña	Suway, waykakuy.
rascar	Hasp'iy, achpiy.
rasgar	Llik'iy.
raspar	Thupay.
rastrear	Yupipay.
rastro	Yupi.
rato	Pacha, chaylla.
ratón	Huk'ucha.
raya	Siq'i.
rayos	(del sol) Intip wach'in, intip sapran.
razón	Yuyay, unanchay.
realidad	Chiqan.
realizar	Ruray.
reanimar	Kallpanchay.
rebajar	(el precio) Uraykachiy.
rebaño	Michina.
rebelde	Mana munaq, mana kasukuq.
rebelión	Hatariy.
recaer	Musuqmanta urmay.
recapacitar	Hamutakuy, yuyaymanay.
recaudar	Huñuy.
receloso	Manchakuq.
recibir	Chaskiy.
recién	Chayraq, chaylla.
reciente	Wamaq, musuq.
recio	Sinchi, rakhu.
reclinar	Sirichiy.
recluir	Wichq'ay.
recodo	K'uchu.
recoger	Pallay; tantay, huñuy.
recolectar	Huñuy, tantay, suntuy.
recompensar	Kutichiy.
reconocer	Riqsiy.
reconvenir	Anyay, kunay.
recordar	Yuyay.
recorrer	Puriykachay.
recortar	Kuchupay.
recostarse	Waqtapakuy.
recoveco	Q'inqu.
recrearse	Hawkakuy, waynarikuy, kusikuy.
rectificar	Chiqanchay.
recto	Chiqan, allin.
recuerdo	Yuyay.
recurrir	Mañakuy, riy.
redil	Kancha.
redimir	Qispichiy.
redondear	Muyuchay, ruyruchay.
redondo	Muyu, ruyru.
reducir	Taksayachiy, huch'uyachiy, pisiyachiy.
referir	Willay.
reflexionar	Yuyaykuy, yuyaymanay.
reformar	Allichay.
refregar	Qaquy.
refrescar	Chiriyachiy.
refugiarse	Pakaykukuy.
refulgir	Lliplliy, k'anchariy.
regalar	Quy, quykuy.
regañar	Phiñaykachakuy.
regar	(la sementera): qarpay, parquy.\n(para barrer): ch'aqchuy.\n(rociando): ch'allay, maqchiy.
regazo	Millqay.
región	Suyu.
regir	Kamachikuy.
registrar	Qhaway, qhawapayay.
regocijarse	Quchukuy, kusikuy.
regoldar	Hap'ay, kakyay.
regresar	(allá): kutiy, kutiriy.\n(acá): kutimuy, kutirimuy.
rehacer	Kutipay, rurapay.
rehuir	Ayqiriy.
rehusar	Mana munay.
reina	Quya.
reír	Asiy, asikuy.
rejuvenecer	(el varón): waynayay.\n(la mujer): sipasyay.
relámpago	Illapa, wakri.
relampaguear	Llipyay, wakriy.
relatar	Willay, willakuy.
relucir	Llipipiy, k'anchay.
rellenar	Hunt'achiy, winay.
remanente	Puchu, puchun.
rematar	Tukuy, tukupuy, p'uchukay.
remedar	Yachapayay.
remediar	Allichay, allichapuy.
remedio	Hampi, allichay.
remendar	Ratapay.
remitente	Apachiq.
remolino	(de agua): puyunkuy, mayu millp'u.\n(de viento): antay qunchuy, muyuq wayra.
remoto	Kara.
remover	Kuyurichiy.
renacuajo	Huq'ullu, ultu.
rencor	Chiqniy; chiqnikuy.
rendija	Raqra.
renovar	Musuqyachiy.
renunciar	Haqipuy, mana munay.
reñir	Anyay, k'amiy.
reo	Huchallikuq.
reparar	Allinyachiy.
repartir	Aypuy, rakiy, rakipay.
repasar	Kutipay.
repelar	Rutuy; t'iray.
repeler	Chuqay, wikapay.
repentinamente	Qunqaylla.
repetir	Kutipay.
repleto	Hunt'a, usuy-usuy.
reponer	Churapuy, kutichipuy.
reposar	Samakuy, tiyakuy.
reprender	Anyay.
reprobar	Millay, chiqniy.
reprochar	Uyanchay.
reproducir	Miray, wiñachiy.
reptil	Lluqaq uywa.
repugnante	Millana, millachikuq.
resbalar	Lluchkhay ~ lluchk'ay.
reservar	(guardar): waqaychay.\n(ocultar): pakay.
resfriarse	Chiriyakuy.
residir	Tiyay, yachakuy.
residuo	Puchu, puchun.
resina	Sach'ap wiqin.
respetar	Yupaychay.
respirar	Samay.
resplandor	K'anchay, llipikyay.
responder	Kutichiy, rimariy.
restante	Puchuq, puchun.
restituir	Kutichipuy.
restregar	Qaquy.
resucitar	Kawsariy.
resuello	Samay.
retardar	Unachiy, unayachiy.
retazo	Llik'i, ch'iqtay.
retirarse	Anchhukuy, achhuriy.
retoño	Yura, mallki.
retorcer	Q'iwiy.\n(el hilo): k'antiy, kawpuy.
retornar	Kutiy, kutichiy.
retozar	Pukllaykachay, phawaykachay.
retrasar	Qhipachiy.
retroceder	Kutiriy, qhipaman kutiy.
retumbar	T'uqyay.
reumatismo	Tullu unquy, tullu nanay.
reunir	Huñuy, tantay.
revelar	Willay.
reventar	T'uqyay.\n(la flor): phanchiy.
reverenciar	Yupaychay.
revivir	Kawsariy.
revolcarse	Qhuchpakachay.
rezagarse	Qhipakuy.
rezar	Mañakuy.
rico	Qhapaq, qullqiyuq.
riesgo	Ch'iki.
rincón	K'uchu.
riña	(de manos): maqanakuy.\n(de palabras): k'aminakuy, phiñakuy.
riñon	Ruru.
río	Mayu.
risa	Asiy.
robar	Suway.
robo	Suwasqa.
robusto	Kallpasapa, sinchi.
roca	Qaqa, wank'a.
rocío	Sulla.
rodar	Muyuy, sinkuy; suchuy.
rodear	Tumay, muyuriy.
rodilla	Qunqur, muqu.\n(ponerse de): qunquriy, qunquray.
roer	K'utkuy ~ k'uchkuy.
rogar	Mañay, mañakuy.
rojo	Puka.
rollo	Mayt'u.
romper	(cosa sólida): p'akiy.\n(telas): llik'iy, llipchiy.\n(hilo): p'itiy, tipiy.
ronco	Ch'aka.
ropa	P'acha.
rostro	Uya.
rotoso	Ratapa.
rubio	P'aqu, puka.
rueca	Pallqa, piruru.
rumiar	Kutipakuy.
sabandija	Uru.
saber	Yachay.
sabio	Hamawt'a, yachayniyuq.
saborear	Malliy, malliykuy.
sabroso	Misk'i.
sacar	Hurquy.
saciarse	Saksay.
sacudir	Chhapchiy, taspiy.
saeta	Wach'i.
sagaz	Yachaysapa.
sahumar	Q'usñichiy.
sal	Kachi.
salar	Kachichay.
salida	Lluqsina.
salir	Lluqsiy.
salitre	Qullpa.
saliva	Thuqay.
salpicar	Ch'allay, maqchiy.
saltar	P'itay, phaway.
saludar	Napaykuy.
salvador	Qispichiq.
sanar	Allichay.
sancochar	Wayk'uy, yanuy.
sandalia	Husut'a, usuta.
sangrar	Sirk'ay.
sangre	Yawar.
sano	Allin, qharilla.
sapo	Hamp'atu.
saquear	Waykay, suway.
sarna	Qaracha.
sarpullido	Muru-muru, mullkhu.
satisfacerse	Saksaykukuy.
sauce	Wayaw.
saúco	Rayan.
sebo	Wira.
seboso	Wirasapa.
secarse	Ch'akiy.
sed	Ch'akiy, yakunay.
sedimento	Qunchu.
segar	Rutuy.\n(el maíz): kallchay ~ karchay.
seguir	Qatiy.
según	Hina.
seguro	(cierto) Chiqaq.
seis	Suqta.
selva	Sach'a-sach'a.
semblante	Uyan, rikch'ay.
sembrar	Tarpuy.
semejante	Niraq, rikch'aq, kaqlla.
semen	Yumay.
sementera	Chakra.
semilla	Muhu, muru.
senectud	Rukuyay, yuyaqyay.\n(el hombre): machu kay, machuyay.\n(la mujer): paya kay, payayay.
seno	Uqllay, qhasqu.
sentarse	Tiyay, tiyakuy.
señal	Unancha, sananpa.
señalar	Sananpay, unanchay.
señor	Wiraqucha.
separar	Rakiy.
sepelio	Aya p'ampay.
sepultar	P'ampay.
sepultura	Aya p'ukru, aya uchku.
sequía	Ch'aki mit'a.
ser	Kay.
serpiente	Amaru, machaqway.
serranía	Sallqa.
sesgo	Wiksu, kinray.
seso	Ñutq'u.
sesudo	Yuyaysapa.
sí	Arí.
siega	Kallchay mit'a, rutuy.
siembra	Tarpuy mit'a.
siempre	Wiñay.
siete	Qanchis.
sífilis	Wanthi.
silbar	Wisyay, sukay.
silencio	Chunyaq, ch'inyaq.
silvestre	Sallqa, k'ita.
silla	Tiyana.
simultáneo	Kuska, kuskalla.
sitiar	Intuykuy, tumay.
sobaco	Wallwak'u.
sobar	Qaquy.
soberbia	Apuskachay.
sobornar	Waqllichiy.
sobra	Puchu.
sobrar	Puchuy.\n(exceder): yalliy, llalliy.
sobre	(encima) Hawa.
sobresaliente	Yalliq.
socavar	Hasp'iy, uchkuy.
socio	Kaq masi.
socorrer	Amachay.
sofocar	Ruphapakuy.
soga	Waskha.
sol	Inti.
soldar	Tinkiy, laqay, k'askachiy.
soledad	Sapan kay.
solicitar	Maskhapayay.
solidificarse	Tikayay.
sólido	Rumiyasqa.
solo	Sapan, sapallan.
soltar	Kachariy, paskay.
sollozar	Anchiy, waqay.
sombra	Llanthu.
sombrearse	Llanthukuy.
sonámbulo	Musphaq.
sonar	Uyarikuy, waqay.\n(sonarse la nariz): pichakuy.
sonrojarse	P'inqarikuy.
soñar	Musquy.
sopapear	Saqmay, lapyay, laqyay.
soplar	Phukuy.
sorber	Upiy, upuy, suquy.
sordera	Upayay.
sordomudo	Upa.
soso	Q'ayma, q'amya.
suave	Ñukñu.
suavizar	Llamp'uyachiy.
subir	Wichay, siqay.
subsanar	Allichay.
subsistir	Kakuy, kawsakuy.
sucesor	Qatiq, rantin.
sudar	Hump'iy.
suelo	Pampa.
suelto	Kacharisqa, paskasqa.
sueño	(dormir): puñuy.\n(soñar): musquy.
suerte	(buena) Sami.
sufrir	Ñak'ariy, muchuy.
suicidarse	Wañuchikuy.
sumar	Huñuy, yapay.
sumergir	Challpuy.
sumiso	Uyakuq.
superar	Yalliy, atipay.
superficie	Muyuynin.
superior	Qullana.
suplicar	Mañakuy.
suprimir	Qulluchiy, chinkachiy.
surcar	Suk'ay, yapuy.
surco	Suk'a.
suspirar	Anchiy.
sustento	Mikhuna, kawsay.
sustituto	Ranti.
susto	Manchay.
sustraer	Rakiy, t'aqay.
tabaco	Sayri.
tacaño	Mich'a.
tajar	Kuchuy.
taladrar	Hutk'uy, uchkuy.
talega	Wayaqa, ch'uspa.
talla	Sayay.
tamaño	Chhikan.
tamboril	Tinya.
tamiz	Suysuna.
tanto	Chhika.
tapadera	Kirpana, kirpakuq.
tapar	Kirpay.\n(con la tierra): p'ampay.\n(con lodo): llut'ay.\n(abrigar): qatay.\n(encubrir): pakay.
tapia	Pirqa.
tapir	Sach'a waka.
tardar	Unay, unakuy.
tarde	Ch'isi.
tartamudo	Hakllu, akllu.
tasajo	Ch'arki.
tasar	Chaninchay.
tea	K'anchachina, akchikuq.
techar	Wasi qatay.
tejer	Away.
tela	Awasqa.
telaraña	Llika.
temblar	Chukukukuy, khatkatay.
temblor	Pacha kuyuy.
temer	Manchay.
temor	Manchay.
tender	Mant'ay, mast'ay, masay.
tenderse	Sirikuy, waqtapakuy.
tendón	Hank'u.
tener	(poseer) Kapuy,uyway.
tentación	Watiqay.
teñir	Tullpuy.
terciana	Chukchu.
terminar	Tukuy, p'uchukay.
terremoto	Pacha kuyuy.
terreno	Allpa, chakra.
terrible	Manchana.
terrón	K'urpa.
testa	Uma.
testículo	Q'uruta, runtu.
teta	Ñuñu, chuchu.
tibia	Chaki tullu.
tiempo	Pacha.
tierno	Llullu, llamp'u.
tierra	(planeta): tiqsi muyu, pacha.\n(suelo): pampa, allpa.\n(de sembrío): chakra.
tiesto	K'analla, kallana.
tigre	Uturunku.
tímido	Llakllaq, manchaq.
tinaja	Urpu, raki.
tirar	(arrojar): chuqay, chamqay.\n(jalar): chutay, aysay.\n(con arma): t'uqyachiy.\n(con honda): warak'ay.
tiritar	Khatatay.
tizne	Qhichincha, qitya.
tocar	(la puerta): takay.\n(un instrumento musical): waqachiy.\n(palpar): llamkhay.\n(manosear): llapiy.
todo	Llapan, tukuy.
todopoderoso	Llapan atiq.
tomar	(coger): hap'iy.\n(aceptar): chaskiy.\n(beber): upyay.
tonto	P'anra, upa.
toparse	Tinkunakuy.
torcer	Q'iwiy.\n(la lana): k'antiy, kawpuy.
tordo	Chiwaku.
torre	(fortaleza) Pukara.
tórtola	Kullku.
tos	Uhu.
tostado	(maíz) Hamk'a, kamcha.
total	Llapantin, huñuntin.
trabajar	Llamk'ay, ruray.
traer	(una cosa): apamuy, aysamuy.\n(una persona): pusay, pusamuy.
tragar	Millp'uy.
trama	(tejido) Mini.
trampa	Tuqlla.
tranca	Q'imina.
tranquilizar	Sunquyachiykuq, hawkayachiykuq.
transeúnte	Puriq, purikuq.
transitable	Purinalla.
transparente	Ch'uya.
transpirar	Hump'iy.
trapo	Ratapa.
tráquea	Tunquri.
trasegar	Hillp'uy, talliy.
trasero	Siki.
trasladar	(allá): apay, astay.\n(acá): apamuy, astamuy.
traspasar	(con un objeto). T'urpuy, tuksiy.
trasquilar	Rutuy, kuchuy.
trastornarse	Musphakuy.
través	Kinrayninta.
travieso	Pukllakachaq.
trenza	Simp'a.
trenzar	Simp'ay.
trepar	Lluqay, siqay.
tres	Kimsa.
trillar	Saruy, saruchiy.
trinar	Wichichichiy, pichiwyay.
tripa	Ch'unchull, ch'unchulli.
triste	Llakisqa, phutisqa.
tristeza	Llakiy, llakikuy.
triturar	Chamqay.
triunfar	Atiy.
trocar	Rantiy, chhalay, yankiy.
troja	Qullqa, pirwa.
trompear	Saqmay, takay.
tronco	K'ullu, k'aspi.
tropezar	Mitk'ay.
tú	Qam.
tuerto	Ch'ulla ñawi.
tumbar	Urmachiy, saqtay.
tumor	Ch'upu.
turbio	Q'ata, qhunchu, putka.
turnarse	Mit'anakuy.
turno	Mit'a.
ubre	Ñuñu.
último	P'uchukaq.
uncir	Watay, t'inkiy.
único	Sapan, sapallan.
unidad	Huk kay.
unificar	Hukllachay.
unir	Huñuy, hukllachay, t'inkirquy.
uno	Huk.
untar	Llusiy.
unto	Wira.
uña	Sillu.
urdir	Allwiy.
usado	(objeto) Mawk'a.
usurpar	Qichupakuy, waykarquy.
útil	Allin.
vaca	Waka.
vaciar	Talliy, hillp'uy.
vacío	Ch'usaq.
vacilar	Iskayay.
vadear	Chimpay.
vago	Purikuq.
vagina	Raka, chupi.
vaho	Wapsiy.
valiente	Sinchi.
valor	(de las cosas): chanin.\n(virtud): sinchi kay.
vampiro	Masu.
vanamente	Yanqalla.
vapor	Wapsiy.
variar	Hukman rikch'achiy.
varón	Qhari.
vasija	P'uyñu, urpu.
vedar	Hark'ay, amaniy.
vejez	(del varón): machuyay.\n(de la mujer): payayay.\n(de las cosas): mawk'ayay.
veloz	K'uchi, wayralla.
vello	Millma, millwa.
vena	Sirk'a.
venado	Taruka, lluychu, luychu.
vencer	Atipay.
vender	Rantiy, rantikuy.
veneno	Miyu.
venerar	Yupaychay.
venir	Hamuy.
ventaja	Llalliy, yalliy.
ventana	T'uqu.
ventear	Wayrachiy.
ventosear	Supiy.
ventura	Kusi, sami.
ver	Rikuy, qhaway.
verdad	Chiqan.
verde	Q'umir.
vergüenza	P'inqay.
verruga	Tikti.
verter	Hillp'uy, talliy.
vestido	P'acha.
vestigio	Yupi.
vez	Kuti, mit'a.
vía	Ñan.
viajar	Puriy, illay.
viajero	Puriq.
vianda	Mikhuna.
víbora	Katari.
vida	Kawsay.
vidrio	Qispi.
vieja	Paya.
viejo	Machu.
viento	Wayra.
vientre	Wiksa.
vigilar	Qhawapayay.
vigor	Kallpa.
virtud	Allin kay.
viruela	Muru unquy.
visible	Rikunalla, qhawanalla.
visitar	Watukuy, napaykuy.
vista	Rikuy, qhaway.
vivienda	Wasi.
viviente	Kawsaq.
vivir	Kawsay.
vocablo	Simi, rimay.
vocear	Waqyaykachay, qayaykachay.
volar	Phaway.
volcar	T'ikray.
voltear	(una prenda): t'ikray.\n(dar vueltas): muyuy.
voluntad	Munay.
volver	(regresar allá): kutiy, kutiriy.\n(regresar acá): kutimuy, kutirimuy.
vomitar	Wikch'upakuy, wischuy.
voz	Kunka, rimay.
vuelo	Phaway.
vuelta	Muyuy, kutiy.
yacer	Chutarayay.
yerba	Qura, qachun.
yermo	Purun.
yerno	Qatay, masa.
yerro	Pantay.
yerto	Chutarayaq, chiriyasqa.
yeso	Pachas.
yo	Ñuqa.
zambullirse	Challpuy, challpukuy.
zancudo	Wanwan.
zángano	Qilla.
zapatear	Tusuy, qhachway.
zonzo	P'anra, upa.
zorro	Atuq.
zorrillo	Añas.
zorzal	Chiwaku.
zurdo	Lluq'i maki, ichuq maki.
zurrar	Waqtay, hasut'iy.
zurriago	Hasut'i, wipyana.
zurrón	Ch'uspa.
