abajo	Uray, ukhu
abceso	Ch'upu
abdomen, barriga	Wiksa
abeja	Wanquyru
abofetear	T'aqllay, ch'aqlay
abono	Wanu
abortar	Sulluy
abra	Q'asa
abrazar	Marq'ay, uqllay
abrir	Kichay
abrir cosas blandas	Llik'iy
abrojo	Kichka, qipu
abuela, anciana	Mamaku, yuyaq warmi, paya
abuelo, anciano	Machula, yuyaq
acercarse	Chimpay, asuykuy, qayllachay
achicoria	Pilli pilli
achiote	Achiyuti
achira (planta)	Achira
ácido (comidas y bebidas)	K'arku
aclarar	Achikyay, sut'iyay
acné, espinilla, barro	Muchi
adelante	Ñawpaq
adelgazar	Llaqllay, ñañuyachiy, tulluyay
adivinanza	Watuchiy
adorar	Much'ay
adornar	Achalay, allichay, sumaqyachiy
adosar, levantar pared, pircar	Pirqay
adulación, adular	Llunk'uy
adversario	Awqa
afeitar	Thupay
afeminado	Maqlla
aflojar la tierra	Allay, yapuy, chakmay
afrecho	Chhapa
aftas	Phatku
agarrar	Hap'iy, chaskiy
ágil, listo, vivo	K'uchi
agitar	Chhapchiy, thalay
agonizante, moribundo	Wañunayaq
agradecimiento, agradecer	Añaychay
agrio, ácido	K'arku, p'uchqu
agrupar	Huñuy, tantay
agua	Unu, yaku
aguacero	Para
aguila	Anka
aguja de arriero	Yawri
agujero	Hutk'u, t'uqu
agusanado	Kurusqa
ahogar, asfixiar	Hiq'ipay, mukiy
airampo (cacto)	Ayrampu
ají	Uchu
ajustado	Mat'i
alabar, venerar, honrar	Yupaychay
alacrán	Sirara, sira sira, nina q'ara
alas, extremidades superiores	Rapra
alcanzar	Hayway, aypay, taripay
alegrar, festejar	Kusikuy, q'uchukuy
alejar	Anchuy, karunchay
alejarse	Ayqiy
alga	Laqu
algodón	Utku
alma, espíritu	Nuna
almacigal, semillero	Wampal
almas penando	Kukuchi
almohada	Sawnana
alojar	Qurpachay
alpaca	Paqucha
alto, altura	Sayaynin, hatun
alumbrar, brillar	K'anchay
alumno(a)	Yachakuq
alzar	Huqariy, wichachiy
amanecer	Illariy, sut'iyay, achikyay, paqariy
amar, querer	Munay, khuyay
amaranto, sangoracha	Kiwicha, achita
amargo, picante	Haya
amarillear, madurar	Paruyay, puquy
amarillo(a)	Q'illu
amarrar	Watay, khipuy
amarrar palos	Ch'atay
amasar	Q'apiy, ñatuy
ambrosía (planta), artemisa	Markhu
amigo(a), compañero	Masi, wawqi, ñaña
amparar, proteger, defender	Amachay
ampolla	Suphullu
amuleto	Illa
analfabeto	Ñawsa
anaranjado	Quri q'illu, puka q'illu, chiwanway
anciana	Paya, yuyaq, mamaku
anciano	Machu, yuyaq, machula
andenes	Pata pata
andrajoso	Chhachu, thanta
anémico	Upichu
ángulo	K'uchu, ch'ullpa
anillo, sortija	Siwi
animar	Kallpachay
ano	Uquti
anochecer	Ch'isiyay, tutayay
antes	Qayna
antes, primero	Ñawpaq
antiguo	Machu, ñawpa
año	Wata
apacheta	Apachita, q'asa
apaciguar	Amachay
apagar fuego	Wañuchiy, thasnuy
apagar la sed	Thasnuy
apartar	Anchuy
apedrear	Ch'aqiy
aplanar	Pampachay
aplaudir, dar palmadas	T'aqllakuy
apoderarse	Kaqnichakuy
aprender	Hap'iy, yachay
aprehender	Hap'iy
aquel, aquella	Chaqay
arado, tirapié	Taklla, chaki taklla
araña grande, tarántula	Apasanqa
árbol	Sach'a
árbol frutal	Mallki
arcilla, greda	Llanka
arcilla comestible	Ch'aqu, phasalli
arco	Iris K'uychi
arder	Rawray
arder herida	K'aray
ardilla	Waywacha
arena	Aqu, t'iyu
arete	Tulumpi
arista	Tupra
armadillo	Kirkinchu
arrastrarse, reptar, deslizarse	Suchuy, lat'ay, lluqay
arrear	Qatiy
arriba	Hanaq, wichay, pata
arrodillarse	Qunqurikuy
arrojar, botar	Wisch'uy
artemisa (planta), ambrosía	Markhu
arvejas	Alwirhas
asado	Kanka
asamblea	Huñunakuy
asco (tener ___ )	Millakuy
asno	Asnu
asfixia	Mukiy, hiq'ipay
asiento	Tiyana
asperjar, rociar	Ch'allay, ch'aqchuy
atado, bulto	Q'ipi, khipu
atajar	Hark'ay
atar, amarrar	Watay
atadito, manojo	Mayt'u
atocar	Llamkhay
atorarse	Chakachikuy
atraer jalando	Aysay
atragantar	Chakachikuy
atrás, último	Qhipa, wasa
aumentar	Miray, yapay
autoridad	Kamachiq
ave centinela	Liqi liqi
avestruz, ñandú	Suri
avispa	Urunquy
axilas	Wallwak'u
ayer	Qayna p'unchaw
ayuda prestada, contrato	Mink'a
ayudar, colaborar	Yanapay
azada	Ruk'ana
azadón	Allachu
azufre	Sallina rumi
azul	Anqas
baba, flema	Llawsa
bailar	Tusuy
bajar	Uraykuy
bajo	Huch'uy
bañarse	Armakuy
bandera	Wiphala
barba	Sunkha, sapra
barbechar, roturar terreno	Chakmay, yapuy
barbilla	K'aki
barrer, borrar, limpiar	Pichay
barro	T'uru
bastante	Achka, llasaq, nanaq
bastón	Tawna
basura	Q'upa
batán	Maran
batea de mate	Anqara
batido de quinua	P'isqi
batir	Qaywiy
bayeta	Wayita
bebé	Wawa
beber, tomar	Upyay, ch'unqay
beber licor	Machay
begonia	Achanqaray
berro	Uqururu
besar, adorar	Much'ay
bienvenido	Hampuy
bilis	Hayaqin
bizco	Lirq'u
blanco(a)	Yuraq
blando	Llamp'u
boca	Simi
bocio	Q'utu
bola	K'umpa, rump'u
boleadora	Riwi
bolitas	Chuwi
bolsa para coca	Ch'uspa
bolsa grande, talega	Wayaqa
bombo	Wank'ar
bonito	Munay
bóñigas ovaladas	Taqya, uchha
borde, orilla	Pata, muyuriq
bosque	Sach'a sach'a
bostezar	Hanllariy
brasa	K'illimsa, sansa
brazada	Marq'a
brazo	Maki
brillar	K'anchay, llipipipiy, achikyay
brindar	Quy, t'inkay, ch'allay
brotar	Phuturiy, ch'ichiy
brujo	Layqa, paqu
búho	Tuku
burlarse	Allquchakuy, k'umuchiy, sarunchay, ullpuchay
burro	Asnu
caballo	Kawallu
cabello	Chukcha
cabeza	Uma
caca, heces fecales, excremento	Aka
cacto	Waraqu, kichka
cada uno, una	Sapanka
cadáver	Aya, wañusqa
cadera	Thiqni, chaka tullu
caer	Urmay
caerse estrepitosamente	Laq'akuy
café (color ___ )	Ch'umpi
cagar	Akay
caigua	Achuqcha
cal, piedra caliza	Isku
calabacín	K'usi
calabaza	Puru, lakawiti
calandria	Tuya
calcular	Tantiyay
calentar	Q'uñichiy, kañay, ruphachiy
caliente	Q'uñi, ruphaq
callado	Amu, ch'in
callar	Ch'inyachiy
camarón	Yukra
camaroncillo negro	Ch'ichi, unu piki
camellón	Wachu
camellones	Waru waru
caminar	Puriy
caminar de 4 patas	Lat'ay, lluqay
camino, vía	Ñan
camiseta	Unku
camote	Apichu
canjear, trocar	Chhalay
canal	Pincha, rarqa
canasta	Isanka
canchón	Kancha
cangrejo	Apanquray
canicas, bolitas	Chuwi
cansancio	Sayk'uy
cantar, canción	Takiy
cántaro	Chatu
cántaro alargado	P'uyñu
cántaro para cargar chicha	Mak'as
cántaro para jalar agua	Chatu
canto agrícola	Wanka
canto triunfal	Haylli
cantuta	Qantu
caña de maíz	Wiru
cañahua	Qañiwa
capatáz	Khipu, llamk'achiq
cara	Uya
caracol	Ch'uru
caramelo	Misk'i
carbón	K'illimsa
carcomido	Mullphasqa, mullpha
carencia	Muchuy
cargar	Apay, q'ipiy
carnaval	Pukllay
carne	Aycha
casa	Wasi
casarse	Masachakuy, kasarakuy
cascabel (instrumento musical)	Chanrara
cascada	Phaqcha
cáscara	Qara
cáscara de cebada	Chhapa
castaño (color)	Ch'umpi
castigar	Maqay, wanachiy, hasut'iy
catar, degustar	Malliy
catarata, nube de los ojos	Quyru
catarro, gripe	Chhulli
catre	Kawitu, puñuna
causa o motivo	Chay hawa
caverna, cueva	Mach'ay, qaqa wasi, chinkana
caya (oca deshidratada)	Khaya
cazar	Chakuy
cebada	Siwara
cebolla	Siwulla
cecina, chalona	Ch'arki
ceniza	Uchpa
centellear	K'anchay, llipipipiy
centena	Pachak
centro	Chawpi
cepillar	Llaqllay
cerámica	Sañu
cercano	Qaylla, kaylla
cerco, corral	Kancha
cerda	Ch'awar
cerdo	Khuchi
cereal cocinado	Phata, phatasqa
cerebro, seso	Ñutqhun
cernícalo	K'illichu
cernidor, cedazo	Suysuna
cerrar	Wichq'ay
cerro	Urqu
césped	K'urpa, ch'ampa
chacra, cultivo	Chakra
chairo (plato)	Chayru
chancar	Ch'aqiy
chala, tallo seco de maíz	Chhalla
chalona	Ch'arki
charango	Charanku
charapa (tortuga de río)	Charapa
chicha	Aqha, aswa
chicchipa, hierba aromática	Chikchipa
chispa	Pinchi
choclo	Chuqllu
choza	Ch'uklla
chuño	Ch'uñu
chuño blanco	Muraya, tunta
chupar	Ch'unqay
chupe de chuño, chairo	Chayru
cicatríz,	K'illa
ciego	Ñawsa
ciempiés	Pachak chaki
cien	Pachak
cifra	Khipu
cigarra	Q'isqis
cintura	Wiqaw
círculo	Muyu
ciudad	Llaqta
claridad	Sut'i, ch'uya
coágulo	Llukllu
cobarde	Waqati
cobre	Anta
coca (3 hojas de ___ )	K'intu
cocinado al vapor	Phasi
cocinado	Chayasqa, wayk'usqa
cocinar	Wayk'uy
codo	Kuchuch
codorníz	Yuthu
coger	Hap'iy
cojo	Hank'a, wiqru, wist'u
cola	Chupa
colar	Ch'umay, suysuy
colina (cerro)	Chupa
collar	Wallqana
colli (variedad de árbol)	Qulli
color	Llimp'i
colorear	Llimp'iy, tullpuy
columpio	Wayllunku
comadreja	Achuqalla, qataycha, chukuru
comer	Mikhuy
comida espesa de harinas	Phiri
compañero(a)	Masi, wawqi, ñaña
completo	Hunt'a
comprar	Rantiy
comunidad	Ayllu, (hawa llaqta)
condenado	Kukuchi
cóndor	Kuntur
conducir	Pusay, aysay
congelado	Qasasqa
conjuntivitis	Willkachuqa
cono	Chuqu
conocer	Riqsiy
conquistar	Atipay, llalliy
consejero (anciano ___ )	Awki, yuyaychakuq
contagiar mal	Ratachiy, unquy hap'ichiy
contrato	Mink'a
conversar, dialogar	Rimanakuy, rimay
convidar	Quy
convivir extramaritalmente	Qhilli kawsay
corazón	Sunqu
cordillera, jalca	Suni
corona de flores	Pillu
coronilla	Mukuku
corral	Kancha
correa	Chumpi
correcto	Chanin, chiqan
correr, volar	Phaway
cortadera (planta)	Niwa
cortar	Kuchuy, wit'uy, rutuy, k'utuchiy
cortar en rodajas	Q'allay
corte de pelo	Rutuchiy
cosecha (café)	Pallay
cosechar con segadera	Rutuy
cosecha de maíz	Kallchay
cosechar arrancando	T'iray
cosechar tubérculos	Allay
coser	Siray
costa (región…)	Chala
costurar	Siray
crear	Kamay, ruray, paqarichiy
crecer	Wiñay, hatunyay
creer	Iñiy
crespo	K'upa
cría	Uña
criado con biberón	Chita, chitasqa
crin	Ch'awar
criar ganado	Uyway
cristal	Qispi
crucero, abra	Apachita
crudo	Chawa, hanku
cruz	Chakata
cruzar	Chimpay
cuál	May, mayqan
cuándo	Hayk'ap
cuánto	Hayk'a
cuatro	Tawa
cubo	Machina
cubrir, envolver	Ch'uwiy, p'istuy
cucharón	Wislla
cuidado que …	Paqtataq
cuidar	Rikuy, qhaway, michiy
cuello	Kunka
cuento, narración	Hawariy, ñawpa willakuy
cuernos, astas	Waqra
cuero	Qara
cuerpo cilíndrico	Tuquru
cuerpo geométrico	Pirwa
cueva	Mach'ay, chinkana
cuidar ganado	Michiy, qhaway
culebra	Mach'aqway
culpa	Hucha
cuña	Chillpa
curandero	Hampikuq, paqu
curar	Hampiy
cuy	Quwi
cuy macho	Kututu
dar	Hayway, quy
dar a luz, parir	Wachay
dar fuerzas	Kallpachay
decena	Chunka
decir, hablar	Niy, rimay
declamar	Yarawiy
dedo	Ruk'ana
defecar	Akay
defender	Amachay, hark'ay
degustar	Malliy
degollar	Nak'ay
dejar	Saqiy
delgado	Ñañu
delirar	Musphay
demasiado	Ancha, sinchi, nanaq
demonio	Supay, saqra
dentro, interior	Ukhu
derecha	Paña, alliq
derretir, remojar	Chulluy, apiyay
desabrido	Q'ayma
desatar	Paskay
desbastar	Llaqllay
descripción	Sut'inchay, riqsichiy
descubrir	Kamay, tariy
desenlazar	Paskay
desgranar	Muchhay, iskuy
deshacer	Paskay
deshierbar	Quray
deshonesto	Map'a
desigual	Ch'ulla
desleído	Api
desleir	Muk'uy
deslindar	Ch'uyanchay
desmenuzable con los dedos	Phapu
desmenuzar	Khakuy
desmenuzar a golpes	Q'asuy, maruy, k'upay
desorejar	Mut'uy, qhuruy
despedida	Kacharpariy
después…	Hinaqa
desterronar	Q'asuy, maruy, k'upay
detener	Hark'ay, sayachiy
detenerse	Sayay
deteriorado	Mawk'a
deuda	Manu
devolver	Kutichiy
día	P'unchaw
diablo	Supay, saqra
diafragma	Wisq'an
diálogo, asamblea	Rimanakuy
diarrea, disentería	Kursus, yawar q'ichay
dibujar	Siq'iy
dientes	Kiru
diez	Chunka
dificultar	Sasachay
difunto	Aya, wañusqa
dinero, plata	Qullqi
dios tutelar	Apu
discutir	Ch'aqway
disentería	Kursus unquy
dislocadura	Wiqu, q'iwisqa
distante	Karu
dirigente	Umalliq
doblar	Pataray, Kawpuy
doler	Nanay
dolor	Nanay
dominico (ave), china linda	Allqamari, aqchi
dónde	May, maypi
doña, señora	Mama
dormir	Puñuy
dos	Iskay
dulce, caramelo	Misk'i
duro, seco	Qhuru, chuchu, ch'aki
él, ella	Pay
echar	Hich'ay, talliy, wisch'uy
echarse de cúbito ventral	Thallay
elegante, elegancia	K'acha
él mismo	Kikin
embarazada, preñada	Unquq, chichu
embarcación, bote	Wamp'u
embarrar arrojando	Laq'ay
emborracharse, embriagarse	Machay
embustero	Atuq, llulla, yukakuq
emplasto	Q'ipichasqa
empujar	Tanqay
enano(a) y gordo(a)	T'inri
enantes	Ñaqha
encima	Pata
encuentro	Tinkuy, tarinakuy, tupay
endurecer	Ch'akiy, rumiyay
en medio	Chawpin, kuskan
enemigo	Awqa
energía	Kallpa
enfermedad	Unquy
enfermero	Hampikuq
enfriarse (grasas)	Tikayay
engañador	Atuq, yukakuq
engañar	Yukay
enlucir, embarrar	Llut'ay
enojado	Phiña
enrollar, ovillar	Kururay, khiwiy
ensartar	Llutkhuchiy, sinriy
ente, existente	Kaq
enterrar	P'ampay
entonces…	Hinaqa
entrar	Yaykuy
en vano	Yanqa
envasar	Hillp'uy, hunt'achiy
enviar, remesar	Kachay, apachiy
enviar encomienda	Suchiy
envidia, envidiar	Ch'ikikuy, chiqnikuy,
envolver pita o lana	K'uyuy
envolver cuerpos	Ch'uwiy, p'istuy
época, tiempo	Mita
equivocarse, errar	Pantay
erosión terrena o carnal	Mikhuy
eructar	Khasay
escabullirse	Llutkhuy
escaldadura	Llillisqa
escapar	Ayqiy, qispiy
escarabajo	Aka tanqa
escarbar	Hasp'iy, allay
escarcha	Chhullunku
escarmenar	T'isay
escocer	Siqsiy
escoger, seleccionar	Akllay, pallay
escogidas (las ___ )	Akllakuna
esconder	Pakay
escribir	Qillqay
escuela	Yachana wasi
escupir, esputo	Thuqay
escurrir	Ch'umay
ese, esa	Chay
esfera	Rump'u
esférico (objeto)	K'umpa
esófago	Millp'uti
espacio	Pacha
espalda	Wasa
espantapájaros	Manchachi
esparcir cereales	T'akay, wisniy
espejo	Rirp'u
esperanza	Suyapakuy
esperar	Suyay
espina, espino	Kichka
espinilla	Muchi
espíritu	Nuna
espíritu de los cerros	Apu, awki
esposo	Qusa
esputo	Qhutu, thuqay
esquilar, repelar	Rutuy
esquina de tejidos	Ch'ullpa
esquina	K'uchu
estaño	Yuraq titi, chayanta
éste, ésta, este	Kay
estera de totora	Q'isana
estiércol apisonado	Khanka
estirar	Chutay, aysay
estrecho	K'ichki
estrella	Quyllur
estreñimiento	Aka ch'aki
exágono regular	Machina
excremento	Aka
excremento de ovinos y camélidos	Taqya, uchha
excremento de vacunos	Q'awa
explosionar	T'uqyay, phatay
exprimidas (hojas ___ )	Hawch'a
exprimir	Ch'irway,
extender	Mast'ay
extraviar	Chinkay
fábula	Aranway
faja, correa	Chumpi
faldellín de criaturas	Phalika, p'istu
fastidiarse	Amikuy
femur	Phaka
feo	Millay
feroz	Manchakuna
festejar	Kusikuy, raymichay
feto	Sullu
fiambre	Quqaw
fibra, lana	Millwa
fiesta (ritual)	Raymi, kusikuy p'unchaw
fila (ponerse en ___ )	Sinrichakuy
filósofo	Amawta
flaco, delgado	Tullu
flamenco	Pariwana
flauta, quena	Pinkullu
flauta de madera	Arqa
flauta de pan, zampoña	Antara, siku
flecha de arco	Wach'i
flema	Llawsa
flor	T'ika, wayta, sisa
fogón	Q'uncha
fontanela	Pukyun, mukuku
forraje, hierba tierna	Q'achu
fortalecer	Kallpachay
fortaleza	Pukara
fósil	Rumiyasqa
fractura, quebrado	P'akisqa
frazada	Qatana, chusi
freir	Thiqtiy
frente	Mat'i
frijoles	Purutu
frío	Chiri, ch'uñu
frotar, sobar	Qhaquy, hawiy, llusiy
fruta	Misk'i ruru
fruto	Ruru
fruto de un cacto	Sank'ayu
fuego	Nina
fuera	Hawa
fuerza	Kallpa
fundar, crear	Paqarichiy, kamay
gallareta	Chhuqa
gallina	Wallpa
gallinazo	Suwa q'ara, suyuntuy
gallito de los	Andes Puku puku
gallo	K'anka
ganado	Uywa
ganar, vencer, conquistar	Atipay
ganso andino	Wallata
garrapata	Hamak'u
garrote, porra	Maqana
garúa	Iphu
gas, vapor	Wapsi
gatear	Lat'ay, lluqay
gato	Misi
gato montés	Titi misi, usqullu
gavilán, halcón	Waman, Anka
gaviota	Qillwa
gelatinoso, natado	Llukllu
gente, persona, hombre	Runa
germinar, brotar	Ch'ichiy, phuturiy
gigantón (cacto)	Hawaq'ullay
girar	Muyuy
girar cuerdas, cola	Maywiy
glúteo	Siki
golondrina	Khallwa, wayanay
goloso	Hillu
golpear	Maqay, takay
golpear en batán	Chamqay
golpear terrones	Maruy, q'asuy
gordo, gordura	Wira, rakhu runa
gorrión	Pichitanka, pichinku
gorro con orejas	Ch'ullu
grado o año de estudios	Ñiqi
granadilla	Apinquya
grande, alto	Hatun
granizar	Chikchiy
granizo, granizada	Chikchi
gratitud	Añaychay
greda	Llanka
grillo	Ch'illiku, ch'illi k'utu
gripe	Chhulli unquy
gris	Ch'iqchi, uqi
gritar	Qapariy
grueso	Rakhu
grueso en lanas y molienda	Chhaku
grupo, reunir	Huñuy, tantay, t'aqa
guanaco	Wanaku
guano	Aka, wanu
guardar	Waqaychay, churay
guardián de chacras	Arariwa
guayabo	Sawintu
guiar, acompañar	Pusay
gusano	Kuru
haba	Hawas
haba sancochada	Phuspu
hacer girar	Maywiy
hacha	Champi
halar	Aysay
halcón	Waman, anka
hambre	Yarqay
harina, harinoso	Hak'u, kuta
harto	Achka, llasaq, nanaq
hartarse	Amikuy
hastiarse	Amikuy
heces fecales	Aka
hechicero	Layqa
helada	Qasa
hembra (plantas y animales)	China
herida, llaga	K'iri
hermana de la mujer	Ñaña
hermana del varón	Pana
hermano del varón	Wawqi
hermano de la mujer	Tura
hervir	T'impuy, chhallchay
híbrido alpaca llama	Warisu
hierba aromática	Asnapa
hierba silvestre	Qura
hielo	Chhullunku
hierro, metal	Q'illay
hígado	Kukupin, k'ipchan
hija del varón	Ususi
hijo del varón	Churi
hilar	Puchkay
hinchar	Punkiy
hipar	Hik'iy
hito	Saywa, qurpa
hoja	Rapi
hollín	Qhichincha
hombre	Runa, qhari
hombro	Rikra
hondonada, cóncavo	P'ukru
hongo comestible	K'allampa, quncha
hormiga	Sisi
horqueta	Tanka
hoy, ahora	Kunan
hoz, segadera	Ichhuna
hozar	Uksiy
hueco	Hutk'u, t'uqu
huella	Yupi
huérfano	Wakcha
hueso	Tullu
huevo, óvulo	Runtu
huir	Ayqiy, chinkay, k'itakuy
húmedo	Api, huq'u
humillar, burlarse	K'umuchiy, sarunchay, allquchakuy
humita	Humint'a
humo	Q'usñi
huracán, remolino	T'uyur wayra, muyu wayra
hurra	Haylli
idéntico	Kikin
identificar	Kikinchay, tariy
igualar	Chaninchay, kuskachay, paqtachay
imaginarse	Yuyaychakuy
impar	Ch'ulla
impúdico	Map'a
imputar, inculpar	Tumpay
incendiar	Kañay, ruphachiy
inconcluso	Allqa
inocente	Llumpaq, mana huchayuq
insípido, desabrido	Q'ayma
insultar	K'amiy
inteligente	Umayuq
intercambiar	Chhalay
intestinos	Ch'unchull
inúltilmente	Yanqa, qasi
inventar	Kamay, paqarichiy
invitar	Mink'akuy
invocar	Waqyay
ir, caminar	Riy, puriy
isaño, mashua (tubérculo)	Añu
ispi (pececillo)	Ispi
izquierdo(a), zurdo	Lluq'i, Ichuq
jaguar	Uturunku
jalar	Aysay, chutay
jardín acorralado	Muya, inkill
jaspeado	Saqsa, ch'iqchi
jora para chicha	Wiñapu
jorobado	Qhupu
joven, muchacha	Sipas, p'asña
joven, muchacho	Wayna, maqt'a
jugar, practicar deporte	Pukllay
juntar, reunir	Huñuy, tantay
juntarse	K'askay, ratakuy, huñunakuy, tantanakuy
justicia (hacer ___ )	Chaninchay, paqtachay
justo	Chanin
labios	Wirp'a
labrar en piedra	Ch'iquy
ladera, pendiente	Kinray, qhata
ladrar, ladrido	Kanikuy
lagartija	Qaraywa
lago, laguna	Qucha
lágrima	Wiqi
lamer	Llaqway, llunk'uy
lana	Millwa, ñañu sapra
langosta	Tinti
llanto	Waqay
lanzar, arrojar	Wisch'uy
lápiz	Qillqana k'ullucha
largo	Sunin
laringe	Tunqur
lavar cosas	Maqchiy
lavar manos o pies	Mayllay
lavar ropa	T'aqsay
lavarse la cara	Uphakuy
leche	Ñukñu, ñuñu
lechuza	Ch'usiq
leer	Ñawinchay
legaña	Ch'uqñi
lejía para masticar coca	Llipt'a
lejos	Karu
leña	Yamt'a
lengua	Qallu
lengua oral	Rimasqa simi
levantar	Huqariy
levantarse, rebelarse	Hatariy, sayariy
ley	Kamachiy
libélula	Chukcha k'utu, q'ara tisi, tisi tisi
liberar, perdonar	Qispichiy, lluqsiy, pampachay
libro, texto	Liwru, qillqasqa mayt'u
liendre	Ch'iya
límite, lindero	Qurpa, saywa
limpiar, borrar	Pichay, ch'uyanchay
linaje, casta	Panaka
lindo	Munay
liso, resbaloso	Lluchk'a
listo, vivaracho	K'uchi
litro, medida de capacidad	Winku
llaga	K'iri
llama, camélido sudamericano	Llama
llamar	Waqyay
llanura, terreno plano	Pampa
llaulli (planta)	Llawlli
llenar líquidos a otro envase	Hillp'uy, hunt'apay
lleno	Hunt'a
llevar	Apay
llevar bajo el sobaco	Lluk'iy
llorar	Waqay
llovizna	Iphu
lluvia	Para
lóbrego	Laqha, tutayaq
lograr	Atipay, tariy
lombriz, solitaria, tenia	K'uyka
loro	K'alla, uritu
lucero, venus	Ch'aska
luciérnaga	Pinchin kuru, nina kuru
lúcuma	Lukma
luego…	Hinaqa
lugar	Hawa
luna, mes	Killa
luxación	Wiqu, wist'u
macho	Urqu
machucar	Chamqay
madera	K'ullu
madero	Kurku
madre, mamá	Mama
maduración, madurar	Puquy
madurar	Paruyay
maguey	Paqpa
maycha (planta), ramilla	Maych'a
maíz	Sara
maíz cocinado y seco	Chuchuqa
maíz sancochado	Mut'i
maíz tostado	Hamk'a, kamcha
mala hierba	Qura
malaria, terciana	Chukchu
maldecir	Ñakay
malvado	Millay, supay, saqra,
manantial	Pukyu
manchado	Allqa
manco	Willu maki
mandar	Kachay, apachiy
maní	Inchik
mano	Maki
mano del batán	Tunaw
mano del mortero	Qulluta
manojo	Mayt'u
manosear	Llamkhay, q'apiy
manta	Lliklla
mantilla de cabeza	Chukulli
mantilla de espalda, capeta	Phullu
mantita para fiambre	Khipuna
mañana	Paqarin, minchha
mar, océano	Lamar, mama qucha
marchitar	Naq'iy
marearse, perder control	Muyunayay, uma muyuy
mariposa	Pillpintu
mariposa nocturna	Taparaku
marrón (color)	Ch'umpi
más	Astawan
mashua (tubérculo)	Añu
masticar	Khamuy, k'utuy
matrimonio	Masachakuy
mayor	Kuraq
mazamorra	Lawa, api
mazorca	Chuqllu
mear, orinar	Hisp'ay
mediano	Taksa, tinku, malta
médico	Hampikuq
médula, tuétano	Chillina
memoria	Yuyay
menor en edad	Sullk'a
menos	Pisi, aslla
menospreciar	K'umuchiy, allquchakuy
menstruar	K'ikuy
mentira, mentiroso(a)	Llulla
mentiroso	Nina qallu
mentón	K'aki
menudo	Huch'uy, ñut'u, khullu
mercadillo, (día de) plaza	Qhatu
mes	Killa
mesa	Misa
metal	Q'illay
metro	Thatkiy
mezclar	Chaqruy
miedo (tener), espantarse	Manchakuy
miel de abeja	Wanquyru misk'i
millar	Waranqa
millón	Hunu
mina	Qhuya
mirar, observar	Qhaway, rikuy
mochuelo	Paqpaka, ch'usiq
moco	Ñuti, qhuña
mojado	Api
moler	Kutay
molino de piedras	Qhuna
mono	K'usillu
montera	Muntira, chuku
montón	Qutu
montón protegido	Phina
morado	Kulli, q'uyu
moraya (chuño blanco)	Muraya
morder	Kaniy, k'utuy
morder cosas semiduras	Khachuy
morir	Wañuy
mortero	Mutk'a
mosca	Ch'uspi
moscardón	Tankayllu
mote	Mut'i
moteado, manchado	Allqa, Ch'iqchi, muru
mover	Kuyuy
muchacha	P'asña, sipas
muchacho	Maqt'a, wayna
mucho	Achka, ancha, nanaq
mudo	Amu, mana rimaq
mugre	Khanka
mugriento	Wiswi
mujer, esposa	Warmi, mama
mujer aseñorada	Mamaku
multiplicar, reproducir	Miray
murciélago	Masu
mutilar	Mut'uy, willuy
muy, mucho	May, ancha
nacer	Paqariy
nada	K'ata
nadar, flotar	Wayt'ay, tuytuy
nalgas	Siki
nariz	Sinqa
nata	Llukllu
natación	Wayt'ay
neblina	Pacha phuyu
negro(a)	Yana
nervio	Hank'u
nevar	Rit'iy
nido	Q'isa
nieto(a)	Willka
niña	P'asñacha, irqi
niño	Maqt'acha, irqi
no (negativo)	Mana
no (prohibitivo)	Ama
noble, distinguido	Riqsisqa, hatunkaray
noche	Tuta
nodriza	Wawa uywaq
nube	Phuyu
nube de la vista	Ñawi phuyu, quyru
nuca, cogote	Much'u
nudo	Khipu, muqu
nudos estadísticos	Khipu
nuera	Qhachun
nueve	Isqun
nuevo, nueva	Musuq
obedecer, obediencia	Kasukuy, uyarikuy
objeto de arcilla	Sañu
observar	Rikuy, qhaway
oca (tubérculo)	Uqa
oca deshidratada	Khaya
océano	Lamar, mama qucha
ocho	Pusaq
ocioso(a), flojo(a)	Qilla
ocultar	Pakay
odiar	Chiqniy
ofrecer	Hayway, munachiy
oír, escuchar	Uyariy
ojos	Ñawi
ojota	Usuta, llanki
oler, olfatear	Mutkhiy
olla	Manka
olluco, papa lisa	Ulluku
olor	Q'apay
olor desagradable	Asnay
ombligo	Pupu
orar	Mañakuy
ordenar	Kamachiy, ñiqichay
ordeñar	Ch'away
orejas	Rinri
orilla de río	Mayu pata
orilla de laguna	Qucha pata
orina, orinar	Hisp'ay
oro	Quri
ortiga	Kisa
oscuro	Laqha, tutayaq
oso	Ukuku, ukumari
otro	Huk, wak
ovacionar, vitorear	Haylliy
oveja	Uwiha
ovillar	Kururay
ovillo	Kurur
óvulo	Runtu
oxidado	Kurusqa q'illay
padecer	Ñak'ariy
padre, don, sacerdote	Tayta
página	Rapi, uya
país	Mama llaqta
paja	Ichhu
paja brava	Iru
pájaro	Pisqu
pájaro bobo	Waqsalli, waq'ana
pájaro carpintero	Hak'akllu
palangana	Puruña
palmadas	T'aqllakuy
palo	K'aspi
paloma	Urpi
palpar	Llamiy, llamkhay, tupapayay
palta, aguacate	Paltay
paludismo	Chukchu
pampa	Pampa
pan	T'anta
panal	Lachiwa
páncreas	K'ayrapin
pantalón	Wara
panti panti (planta)	Panti panti
pantorrilla	Ch'upa
papa	Papa
papa asada	Watya
papagayo	Wakamayu
papaya	Papaya
par	Masa
paralítico	Such'u
pared	Pirqa
partir	Phatmay, rakiy
paso	Thatkiy
pastorear	Michiy
pata	Chaki
patear	Hayt'ay
pato macho	Khaka
pecado	Hucha
pecar	Pantay
pedo	Supi
pedregal	Ranra ranra
pegar con golpes	Maqay
pegar objetos	K'askachiy
peinar	Ñaqch'ay
peine, peineta	Ñaqch'a
peine de pita	Illawa
pelar	T'iqpay
pellizcar	K'ichiy, t'ipiy
pelota	Hayt'ana, qara t'iqichu
pena (tener ___ )	Anchiy, llaki
pendiente, declive	Kinray, qhata
pene	Ullu
pensar	Hamut'ay, yuyaychakuy
pequeño	Huch'uy, khullu
perder	Chinkachiy, atipachikuy
perderse	Chinkakuy
perdíz	P'isaq
perdonar	Pampachay
perro	Allqu
pesado	Llasa
pescar	Challway, hap'iy
pescuezo	Kunka
pestañas	Qhichipra
pez	Challwa
piar (pollitos)	Waqay, chiw chiw niy
picaflor	Q'inti, luli
picante	Haya, uchu
picar el ave	T'apsay, chhapchay
pico	T'apsa, chhuruna
pie	Chaki
piedra	Rumi
piedra preciosa	Umiña
piel	Qara
pierna	Chakan
pimiento, rocoto	Ruqutu
pintar	Llimp'iy
piojo	Usa
pircar	Pirqay, pirqa hatarichiy
pita de maguey	Ch'awar
planeta	Tierra Allpa
planta	Yura
plántula	Mallki
platillo de la rueca	Phillillu
plato	P'uku, chuwa
plomo	Uqi
plomo metal	Titi
pluma	Phuru
poderoso	Qhapaq
podrir	Ismuy
poema, poesía	Yarawi
poleo	Muña
polilla	Thuta
pollera	Pullira
pollo	Chiwchi
poncho	Punchu
poner	Churay
poner huevo	Runtuy
poner la olla	Churpuy, hast'ay
porra	Maqana
prado, pradera	Purun, muya
precio	Chanin
precioso	Munay
preguntar, interrogar	Tapuy
prendedor	T'ipana, tupu
préstamo	Ayni, mañay
prestar	Mañariy, manuy
primogénito	Phiwi
príncipe	Awki
probar, saborear	Malliy
procrear	Churiyay, miray
producir	Uriy, miray, wachay
profesor(a)	Yachachiq
proteger	Amachay, hark'ay
provincia	Suyucha
pueblo	Llaqta
puente	Chaka
puerta	Punku
pulga	Piki
pulga de aves	Itha
pulir	Lluchk'ayachiy, thupay
pulmones	Surq'an
puma	Puma
puna (región geográfica)	Puna
puñado	Hapt'ay
puñetear	Saqmay
pura	Llumpaq
purificar, solucionar	Ch'uyanchay
púrpura (color)	Kulli
pus	Q'iya
qué	Ima
quebrada	Wayq'u
quebrar (cerámica, vidrio)	Chhalluy
quechua (lengua)	Runa simi, qhichwa
quechua (región)	Qhichwa
quemar	Ruphachiy, Kañay
quena	Qina
querido (el ___ ), querida (la ___ )	Inka, munasqan
queso	Kisu
queuña	Qiwña
quién	Pi
quihuicha	Kiwicha, achita
quijada, mentón	K'aki
quinua	Kinuwa
quinua batida	P'isqi
quishuar (planta)	Kiswar
quispiño (comida)	K'ispiñu
quitasol	Achiwa
quizás	Icha
raíz	Saphi
rama	K'allma
rana	K'ayra
rápido	Utqay
raspar	Thupay, ñañuyachiy, k'isuy
rasgar	Llik'iy
ratón	Huk'ucha
rayo (fenómeno)	Illapa
rebalzar	Phuqchiy
rechazar, rebelarse	Kutipakuy, hatariy
recibir	Chaskiy
reciprocidad	Ayni, kutichinakuy
recitar, declamar	Yarawiy
recoger, cosechar	Pallay
red	Lluku, llika
reflexionar	Hamut'ay
regar, riego	Qarpay
región geográfica	Suyu
regresar	Kutiy
reina	Quya
reir	Asiy
reloj (solar)	Inti watana
remendado	Chhachu, ratapasqa
remendar	Ratapay
remojar	Chulluy, apiyay
remolino de viento	T'uyur wayra, muyu muyu wayra
remover	Qaywiy, harwiy, qachiy; hasp'iy
renacuajo	Huq'ullu
reñir	Anyay
repleto	Hunt'a
reprender	Anyay, k'amiy
resbaloso	Lluchk'a
resfriado	Chirisqa
respirar	Samay
resta o sustracción	Qichuy
resto	Puchu
resucitar	Kawsariy
resultado	Lluqsisqan, tukuchaynin
retirar	Anchuy, ayqiy
retoñar	Kawsariy, ch'ichiy
retornar	Kutiy, kutimuy
reventar	T'uqyay, phatay
reventar con los dedos	P'uqay
reventar el capullo	Phanchiy
rey	Inka
rincón	K'uchu
riñones	Rurun
río	Mayu
robar	Suway, suwakuy
roca	Qaqa
roca monolítica	Wanka rumi
rociar	Ch'allay, t'inkay, ch'aqchuy
rocoto	Ruqutu
rodeante	Khipu
rodilla	Qunqur, muqu
roer	K'utuy
rojo, roja	Puka
romadizo, catarro	Rumarisu, chhulli unquy
rombo	Puytu
romper	Llik'iy, p'akiy, chhalluy
roncar	Qhurquy
ropa	P'acha
rosetas de maíz	Phasanqalla
roturar, barbechar	Chakmay
rubio	P'aqu
rueca, huso	Puchka
ruiseñor	Ch'iqullu
sabio	Yachaq, amawta
sacar	Hurquy
sacar agua	Wisiy
sacudir	Chhapchiy, thalay
sal	Kachi
salir	Lluqsiy
salitre	Qullpa
saliva	Thuqay
saltar	P'itay
saludo, saludar	Napaykuy
salvaje	Sallqa
salvia	Salwiya
sangre	Yawar
sanitario	Hampikuq
sapo	Hamp'atu
sarna	Qaracha
sartén	Thiqtina
sasahui (planta)	Sasawi
saya, túnica	Aqsu
sebo	Wira
sebo del esternón	Untu, llamp'u
seboso, grasoso	Wiswi
sed	Ch'akiy
segadera, hoz	Ichhuna
segar	Rutuy
seis	Suqta
seleccionar	Akllay, pallay
selva	Yunka
sembrar, cultivar	Tarpuy, t'akay, mallkiy
sembrío	Chakra
semen	Yuma, wawsa, muhu
semilla	Muhu
seno, teta	Ñuñu
señor	Tayta, apu
señora, doña	Mama
señorita	Mamacha, sipas
sequía	Chiraw, ch'akiriy pacha, muchuy
ser, estar, haber, poseer, existir	Kay
serpiente	Amaru, miyuyuq mach'aqway
servir comida	Qaray
sesión	Huñunakuy
seso	Ñutqhun
sí	Arí, riki, aw
siembra	Tarpuy, t'akay
siembra primeriza	Maway
siete	Qanchis
sífilis	Wanthi
silbar	Huywiy
silenciar	Ch'inyachiy
silencio	Ch'in
silvestre	Sallqa
símbolo	Unancha
soasar	Harwiy, paruyachiy
sobrecarga	Palta
socio	Masa, masi
sofocarse	Ruphapakuy
soga de lana	Waskha
soga de paja	Q'ichwa, phala
sol	Inti
solitaria, tenia	K'uyka
solo	Ch'ulla, huk
soltar	Kichay, kachariy
solucionar	Ch'uyanchay
sombra	Llanthu
sombrilla	Achiwa
sonaja	Chhillchi
sonido	Kunka, uyarikuq
soplar	Phukuy
soplete, soplador	Phukuna
sordo	Ruqt'u
suave	Llamp'u, ñukñu
subir	Siqay, wichay
suche, bagre	Such'i
suciedad	Khanka, qhilli
sucio	Qhilli
sudor	Hump'i
sueño	Musquy
sufrir	Muchuy, ñak'ariy
suma o adición	Yapay
superar	Atipay
suplicar	Mink'akuy
surco	Wachu unu, pincha
suspirar	Anchiy, llakikuy
sustantivo o nombre	Suti
tabla	K'ullu
tacaño	Mich'a, maqlla
tajar	Khallay
tal vez	Icha
tallo	Tullu, tunu
tamal, humita	Humint'a
tambor	Tinya
tambor grande, bombo	Wank'ar
tapa de olla	Kirpana
tapar	Kirpay
tarántula	Apasanqa, qampu qampu
tarhui, altramuz	Tarwi
tartamudo	Akllu, k'aku
tasajear	Mat'ay
techar	Wasichay, wasi qatay
tejer en palitos	Ruray, wiq'ay
tejer en telar	Away
tejido con figuras	Pallay away
telaraña	Llika
temblar	Khatatatay
temible	Manchakuna
tender	Mast'ay
tendón	Hank'u
tenia, lombriz	K'uyka
teñir	Tullpuy, llimp'iy
terciana	Chukchu
terreno	Allpa
terrón	K'urpa
testículo	Q'uruta
teta	Ñuñu
tiempo, espacio	Pacha
tierno	Llullu
tierra	Allpa
tinieblas	Laqha
tiesto (cerámica rota)	K'arpa
tijeras	Tihira
tirar (arrojar)	Wisch'uy, chamqay, chhuqay
tirar (jalar)	Aysay
tiritar	Khatatatay
tiznado	Qhistichasqa
tizón	T'uqpina
tobillo	Chaki muqu, wich'u
tocar	Llamiy, llamkhay
todo	Llapan
tonto	Upa
torcaz (paloma)	Kukuli
torcer con mano	K'uyuy
torcer en rueca	K'antiy
torcer lana en palito	Mismiy
tordo	Chiwaku
torrar	Hamk'ay, kamchay
torrentera, aluvión	Lluqlla
tórtola	Kullku
tortuga de río	Charapa
tos	Uhu
toser	Uhuy
tostadera	K'allana
tostar	Hamk'ay, kamchay
totora, junco	T'utura, matara
trabajar	Llamk'ay, ruray
trabajo forzado por turnos	Mit'a
tragar	Mikhuy, rakray, millp'uy
trama	Mini
tranquilo	Llamp'u
tráquea	Tunqur
trasladar	Astay
trasvasar	Hillp'uy
trebol silvestre	Layu, chikmu
trenzar	Simp'ay
tres	Kimsa
tributar	Hayway
trillar	Iray
tristeza	Llaki
triunfar	Llalliy
trocar	Chhalay
trompeta	Q'ipa
trompeta de caracol	Pututu
tronco	Kurku, k'ullu
tropezar	Mitk'ay
trucha	Challwa
trueno	Pacha t'uqyay
trueque	Chhala
tuerto	Ch'ulla ñawi, lirq'u
tullido	Such'u
tuétano	Chillina
tumba antigua, chullpa	Chullpa
tumbar	Kumpay, urmachiy
tumbo	Tintin
túnica	Aqsu
tunta, chuño blanco	Tunta
úlcera labial	Lliqti
uñas	Sillu
un, uno, una	Huk, ch'ulla, sapallan
untar	Hawiy, llusiy, qhaquy
urdir para tejer	Allwiy
uretra	Hisp'ana
usado (cosas)	Mawk'a, thanta
vaca	Waka
vaciar	Hich'ay, ch'usaqyachiy, talliy
vacío	Ch'usaq
vagina	Raka
valle interandino	Qhichwa allpa
valor	Chanin
vapor	Wapsi
vaso de madera	Qiru
vedija	Phichu
venado	Taruka
venas	Sirk'a
vencedor	Atipaq
vencer	Llalliy, atipay
venir	Hamuy
ver	Rikuy, qhaway
verdad	Chiqan
verde	Q'umir
vicuña	Wik'uña
vida, vivir	Kawsay
vieja	Paya
viejo	Machu, mawk'a
viga	Kurku, k'ullu
virgen	Llumpaq, mamacha
virgen	María Mamacha Mariya
vírgenes del	Sol Akllakuna
viruela	Muru unquy
vitorear	Haylliy
vivas (gritar ___ )	Haylli
vivaracho, vivo, listo	K'uchi
víveres	Mikhuy, mikhuna
vizcacha	Wisk'acha
volar, correr	Phaway
volear pelota	T'aqllay
volumen	Winara
volver	Kutiy
voz	Kunka
yerno	Qatay
yeso	Pachas
yuca	Rumu, yuka
yunta	Masa
zampoña	Antara, siku
zancudo	Wanwa
zarigüeya	Unkaka
zarzaparrilla	Llaqi llaqi
zorrino	Añas
zorro	Atuq
zurdo	Lluq'i
