a'ạjtaba'	Mata caballo.
aca'	Casa, edificio.
acaij	Hacer casa.
aca'ĉhe'	Encima de la casa.
aca've	De tras de la casa.
aca'veij	Quiere tener casa.
aca'ya'	En la casa.
a'cava'	Macono.
a'chii'	Feo.
a'chiij	Sucio.
a'chity	Feo, que no sirve.
achi'yity-s	Malo, mala.
achic	Sabor feo.
achicdyi'	Gusto, sabor feo.
achijchiij-chii'	Mal olor.
achi'joij	Arruinado, embromado.
a'chi'yetac	Embromar, dejar de funcionar.
achi'tye'	Fregar, arruinar.
achi'taqui	Ensuciando.
achi'ti	Ensuciar.
achuj	Perro.
achuij	Cazar con perro.
adyena	Por lo menos.
adye'bo'oj	Ni a un así.
adye' ĉhịj um	Ya vez ni sabes.
adye'ĉaĉaij ọ	Para que vea.
ạdye'	Brasa.
ạdyei'	Abrasar.
ạdyeij	Quemarse con brasa.
ạfeji'	Gusano negro que nace en la carne seca.
aijyi	Grito de dolor.
aijdyi	Gritando de dolor.
ại'yi	Ladrido de perro.
ại'shaty	Jajudo.
aja'	Gripe, fiebre, resfrío, moco.
ajadyes	Remedio para la gripe o resfrío.
ajaij	Enfermarse de gripe.
ạjcavitu'	Ciempiés venenoso.
ajshacaj	Comadreja.
ajyeban	Salir del lugar.
amere	Pez pequeño sin escama.
ạnavata'	Iguana (lagartija).
ánadye'	Gaviota.
anashyi	Mirar con desprecio.
ạnjer	Ángel divino.
an'dyem' mu'ya'	Mientras está él.
an'dyem' mạij taca'	Mientras esta de día.
ạni'ij-nii'	Deseable.
ạni' chuc	Afortunadamente, por suerte.
anic	Verdad.
anicdye	De verdad.
anicdye me'	Así es.
anicdyena me'	Así fue, así resultó.
anicdye me' jiyi'	Así paso.
anicyi	Creer en algo.
anicyedye'	Creencia.
anicjete	Lo creyó.
anicja'yete	Hacerlo creer.
anictyity- sis	Verdadero.
anictyity muntyi'	Hombre verdadero.
anic där a'ni'ityi'	Cosas de buena apariencia, deseable.
anij	Despacio, con cuidado.
anijje'	Hacerlo con cuidado.
anijyi	Caminar despacio.
anijjeyaqui	Hacer lo con cuidado una cosa de uno mismo.
ạn	Cachete.
ạnve	En el cachete.
anve'jeyaqui	Colocar algo en la boca al lado del cachete.
añej	Lluvia.
añei'	Lloviendo.
añedye'	Tiempo de lluvia.
añeyeva' joi'	Lloviendo.
añetyi, -tyi'	Le cogió la lluvia.
añetyi tsun	Nos cogió la lluvia.
ap	Valusa de color rojo.
ạpej	Peto, avispa negra.
ara'	Muchos, varios.
arara'	Picapica.
araj, arajdye, arajmun	Casi.
arajtye', arajje'	Casi logró realizar una actividad o cosa.
araj ventyeque'	Casi llegó a un lugar.
arajtyecte	Casi alcanzó algún objeto, animal o persona.
ạrajtac	Nueve.
arajyequi	Casi llega a algún lugar.
ạ́raraj	Cuervo.
are'	Lastimado.
are'jiti	Se lastimo.
are'ĉa	Cuidado.
are'ĉa mi	Ten Cuidado.
are'sijti	Se lastimó.
are'sijtiĉa'	Nos lastimamos.
are'redye'	Enfermedad.
are'reij	Estar adolorido, enfermo.
are'reyequi	Sentir el dolor al comienzo de una enfermedad.
a'rerety-res	Inútil, sin valor cosas mal hechas.
arosh	Arroz.
aroshdye'	Tiempo de arroz.
aroshdyes	Chaco para sembrar arroz.
aroshsi' vej	Semilla de arroz.
arosh ĉochactyi'	Arroz pelado.
ạ'ru'	Ave pequeño jabadito.
aseijte	Aceite.
asoca	Azúcar.
ashyedye'	Amabilidad.
ashyity	Amable.
ashnen'yi	Mirar con desprecio.
ashaba'	Árbol, corocho.
áshasha	Limón.
ataj	Relación de tío y sobrino.
atava	Gallina.
a'tum	Que tiene dueño.
a'tum	Que tiene cuerpo.
a'tumsi'	Cosa que tiene dueño o cuerpo.
a'tumtyi'	Propietario.
a'tui'	Hacerse dueño de algo.
átsa	Callapo.
átsaij	Hacer callapo.
atsij	Viene.
atsijban	Volver, regresar, retornar.
atyu'	Ya, listo.
atyu' nash	Ya está.
ạvyi'	Grito de la gallina.
avyi	Grito del gallo.
ạva'	Niño, hijo, cría.
ạva'jeyacsi-tucsi	Entenado.
ạvadyes	Muñeca o juguete para los hijos.
ạva'tucdye'	Ahijado.
ạva'tum	Estar en cinta, embarazada.
ạva'tute -tui'	Adoptar, criar como hijo.
ạva'ye'	Engendrar, embarazar.
ạva'yi'	Embarazarse, tener hijo.
avaro'	Loro.
avujre'	Chuchío grande.
ạyajtrij	Pez bagre.
ạ'yaij	Tener relaciones sexuales.
ạ'yatuqui	Tener relaciones sexuales con su pareja.
ạ'yatui'	Tener relaciones sexuales con otra pareja.
ạ'yaty - yas	Que tiene dueño.
ayidye'	Venida.
ayidye' mu'	Su venida.
ayij	Viene.
ayijban'	Volver, regresar.
ayo'	Jefe, Señor, presidente.
ayo' bu'yi	Gobernar.
ayo' bu'yedye'	Reino, gobierno del pueblo.
ayosha	Buna, tucandera.
ayotuqui	Enseñorean.
ayotute	Valorar como Dios.
bába	Abuelo, el viejo, el respetado, autoridad antigua.
baba	Instrumento utilizado para fabricar marico.
bach	Boyé, boa.
báchona	Ciervo.
bachraty-ras	Pálido anémico.
bachra'jodye'	Anemia.
bachra'joij	Enfermarse de anemia.
bajna'	Algodón.
bajnadye'	Algodonal.
bam'dye'	Matriz, útero.
bam'dye'ĉan	Dentro de matriz o útero.
bạn'ĉhịj	Saber bien hacer algo.
bạn'ĉhịj yita'raqui	Sabe jugar bien fútbol.
banacjeyaqui	Pelarse la piel de uno mismo.
banacjiti	Pelarse.
ba'nai'	Resbaloso.
ba'naty- nas	Ligoso, ligosa.
ban'tyity	Animal maltón (macho).
ban'sis	Animal maltón (hembra).
ban'tyity	Persona joven (varón).
ban'sis	Muchacha.
bañe'	Tacuarilla.
baquits	Colgar algo.
baquitstyeij	Cruzar, pasar por encima de algo.
baquitsjeyaqui	Colgar algo lo que es de uno mismo.
basdyi'	Dar a luz.
basdyidye'	Dar a luz, parir.
basdyidyes	Remedio que se usa cuando se da a luz.
bastaqui	Dar a luz fuera de la casa viaje, hospital, etc.
ba'ŝhuty	Sin fuerza, débil.
bashujshuij	Estar triste, sin fuerza.
bataj	Pálido.
bạtaty-tas	Pálido, enfermo.
bataij	Empalidecerse.
batadye'	Palidez.
bataj	Hongo, oreja de palo.
batajta'	Mariposa.
bạv'joij	Rebalsar, desborde del río.
bayacje'	Sacar un pedazo de carne u otra cosa.
bayacjeyaqui	Sacar un pedazo de carne u otra cosa de si mismo o de su propiedad.
báyera	Canoso, anciano.
bayi'yiij	Tener enfermedad de la piel (lepra).
bayi'yidye'	Enfermedad de la piel.
bejq̂ui'	Paquío árbol.
bejq̂uitujsi	Lugar donde abunda paquío.
bejq̂uituityi'	Hombre que recolecta el fruto de paquió .
bejrai'tyi	Montón Ej: de huesos, chuchío, palo u otra cosa.
beshrety'- res	Sarco.
beshrety vej	Ojo sarco.
bets	Lagaña, materia del ojo.
betsij, betseja'	Tener lagaña, materia en los ojos.
bejve ịvaj	Luna en cuarto menguante.
bej tsun	Por la tarde.
be'be'	Chapapa (trampa para peces).
be'beyaqui	Entablillar (brazo o pierna) fracturado.
be'yi	Balar, mugir, sonido que hace la vaca.
bibaqui'	Quiebran huevos los pollitos para salir.
bibijoij	Avispa cazadora negra.
bicaquis	Agria, ácida.
bícoroi'	Sepes con alas.
bicuc	Amargo, fruta u otra cosa.
biĉun'	Torcer, doblar una cosa.
biĉun'jeyaqui	Torcer algo que le pertenece.
bịcuquity- quis	Agrio ácido.
bij	Hacha de piedra.
bijbi	Hombro.
bíjodye'	Premio o ganancia.
bíjoij	Cazar animal, ganar algo, canear.
bijoij	Carnear algún animal.
bijtacdyes	Pólvora para cargar cartuchos.
bijtaqui	Cargar algún objeto sobre un medio de transporte.
bijti	Subirse, embarcarse en un medio de transporte.
bim'ta'	Bejuco trepador.
binca'	Raíz en forma de tubérculo que es comestible.
bir	Golondrina.
bịbin	Cotorrita.
bị́rish	Loro pequeño, pacúla.
biquij	Asegurar el anzuelo con la liñada de pescar.
biruruc	Paja, pasto.
bisacsi' -tyi'	Cosa esperada.
bisacsi	Persona que espera a otras personas.
bisaqui	Esperar.
bista'	Picaflor pequeño.
bịtatu'	Hongo, oreja de palo.
bitsan'je'	Torcer.
bịv'biv'yi	Canoa sobrecargada.
bịvijviij	Hundir, sumergir canoa.
bo'	Hongo blanco en forma de sombrero.
bọj	Perdiz de serranía.
bọjca'	Barro, lodo.
bojmo'	Pez parecido a sábalo.
bojvaqui	Subir o montar lo que es de uno.
bojvaquis	Escalera.
bojvedye'	Camino que va hacia arriba, subida.
bojvi	Trepar, subir.
bojvity	Trepador.
bonaqui	Tocar flauta propia.
bonoja	Pez como sábalo.
bojno'ta	Fruta silvestre (uvillo).
boñedye'	Flauta.
boñej	Hueso largo de la pierna (fémur).
boñi	Tocar flauta.
boñij	Águila.
bopyi	Tomar agua de algún lugar agachándose.
boptŝoij	Caerse de cara o de nariz.
bọro'fe	Perdiz pequeño del monte.
bọroijje'	Soltar alguna cosa.
botsocje'	Soltar pita, etc.
bubaqui', bubacdye' jac	Terremoto, temblor de la tierra.
buben'je'	Jalar.
bubutajjeyaĉan	Llamar el espíritu de los niños cuando están asustados.
bucan'je'	Mezclar algún líquido.
bucaj	Jahusi.
bu'cje'	Echar tierra.
bucaqui	Echar tierra encima de algo.
bucjeyaqui	Ensuciar con polvo o tierra.
bucjeyacsi	Lanzar polvo o tierra a otra persona.
búquiti	Polvo que entra en los ojos.
bucuj	Bibosi.
bu'chai'	Con barro, fangoso.
bu'chas	Barro, lodo.
buchruty -rus, buchruij	Color ceniza, plomo.
bui'si'	Yuquilla, raíz utilizada para remedio para mujeres que no quieren tener hijos.
bui'tyi'	Palo, balsa blanco.
buj	Sonido de motor.
bujtyeij	Andar rápido.
bujyi	Encender, funcionar (motor).
bujjeyaqui	Hacer funcionar algo propio (motor).
bujjjuityij	Motor funcionando.
bujsaqui	Cubrir con hojas, techar.
bujsuij	Tapado.
bujsuty - sus	Cosa cubierta o tapada.
bujtaqui	Hacer funcionar un motor.
bujtyu'	Loma.
buju'juij	Sonido de máquina funcionando.
búma	Hilo o lana.
bu'maty	Raya pintada.
bụnajje'	Volar, desparramar avispas.
bụna'naij	Volando, bandada de aves.
bunush	Casi ciego.
buñi'	Cosa que esta popís o estar con mohos.
bundye'	Moho, popí.
bur'je'	Rodar tronco u otra cosa.
bureij	Invalidar.
bureijtyi'	Invalido.
bụru'joij	Tener pitaí.
bụrụtụi'	Visitar cada rato, casi todos los días.
busje'	Tapar con algo.
busjeyaqui	Tapar, esconder, con hojas algo propio, etc.
busyedyety	Velo, cortina.
bushnuty	Ciego, Persona Que No Puede Ver.
bu'tacdye'	Mosquitero.
buvacje'	Llenar, rebalsar algún líquido.
bäcäj	Ardilla.
bäĉhäctyi'	Dominado.
bäĉhäi'	Manejar, pilotear, conducir, controlar, dominar.
bäĉhäqui	Manejar algo propio.
bäĉhäityi'	Conductor, piloto, chofer.
bäĉhätety	El que conduce.
bäijnity	Calvo.
bämräij	Desvelado.
bämrä'naqui	Con mucho sueño.
bämräty	Que tiene ojos chinos.
bän'	Lleno.
bän'je'	Llenar.
bän'jeyaqui	Llenar vasija que es propio.
bänäcyi	Ronco.
bänäjnäs	Poso con agua.
bä́nedye'	Llenura, inundación.
bä́ni'	Aumentar el río o llenarse.
bäv	Lleno (estómago).
bävyu'ti	Llenarse mucho.
bävñäij	Calvo.
bä'va'joi'	Mujer sentada.
bä'yaquis	Silla, asiento.
bä'yedye'	Comunidad, pueblo, ciudad.
bä'yis	Pañal para envolver niños.
bä'yi	Sentarse.
bä'ja'	Quedarse a vivir.
ca'baqui	Aplaudir.
cabajte	Llevar alguna cosa u objeto.
caban'	Se la llevó.
cabuti'	Llévame, llévamelo.
cabut	Llévame.
cabu'tyum	Vamonos, caminemos.
cacajmaqui	Polilla, insecto que carcome madera.
cạcdyes	Carga o cosas para llevar.
ca'co'	Muela.
cac̣háqui	Apretar caña con mordaza.
cachaquis	Mordaza.
cachje'	Pisar, apretar.
ca'c̣haij	Apretado, caer debajo de algo.
cac̣ha'naqui	Masticar.
cacha'nacdyety	Para masticar (chicle).
cachtacdye'	Marca.
cachtaquis	Sello.
cachtaqui	Sellar.
cafo'naquis	Batidor.
cafon'je'	Batir.
cafonje'	Mezclar.
cafontye'	Batir hacer mezcla.
cạ'idye'	Riñón.
cạ'ij	Camote.
cạ'ijca'ij	Bejuco, camotillo.
cạji'si'	Planta, raíz usado en remedio para el ojo.
cại'tyi'- si	No que lleva, que guía.
cajcai'	Alzar de paso.
cạjijcai'	Llevar, algo.
cajno	Cuervo.
cajñete	Pasarle en una carrera.
cạjñere'	Balsa (palo, peréa).
cajotyiti	Angustiado, fatigado, preocupado, asustado.
cajsaja'	Víbora (capitán).
cạjsare'	Pez, dorado.
cajtafa'	Jatata.
cajtyityij	Hormiga.
cam'	Callarse, dejar de hablar.
cama'naqui	Revolcarse en el suelo, voltear objeto.
caman'jeyaqui	Darle vuelta.
caman'yi	Darse vuelta.
camaquis	Destruido por polilla.
cạ́mara'	Turiro, nido de tupiros.
cạ́marai'	Comido por tupiros.
cambiyoj	Cambiar, hacer cambio.
camin	Secreto, hacer huir en secreto.
camintui'	Sorprender.
canacdye'	Payuje (plátano sancochado).
canaqui	Hacer payuje, sancochar plátano.
ca'ñiti, ca'ñibun	Volver, regresaren medio camino.
cañon	Cañón de arma.
ca'baqui	Aplaudir.
cại'	Llevar.
carajojnaqui	Gritonear decir palabras ofensivas.
carajpe'	Manguarí (ave).
carau'	Morder.
carav'je'	Morder algo.
cara've'	Mordiéndolo.
carav'tac	Mordido.
carav'yi	Muerde.
carav'yity	Mordedor.
cara'vaqui	Morder, masticar.
careto	Carretón, rueda de movilidad.
carij	Difícil.
carijsis	Problema, cosa difícil.
carijdyei'	Un poco difícil.
carijyi	Dañinear.
carijyity	Dañino, ladrón.
carijtacdye'	Trabajo.
carijtaqui	Trabajar.
carijtyeyete	Trabajar para otra persona, hacer trabajo de otro.
caron	Galón, vasija para líquido.
carsona	Pantalón.
cas	Rodilla.
cash	Quebrar.
cashje'	Machucar o golpear.
cashan'dyij	Sonido de masticar hueso (tigre, perro).
cáshaqui	Machucar, golpear (calucha u otra cosa).
ca'shaqui	Cuando niega la arma no revienta el cartucho.
cashti	Bajar sobre el río, ir río abajo.
cashve	Río abajo.
cashvety	Del río abajo.
cashĉanya'	Más abajo sobre el río.
catiĉa'	Llevar a otro animándolo por una cosa.
cạtsare'	Totaí.
cạvdyis	Dulce.
cavacdyi'	Muy dulce.
cạveja'	Mirar, observar.
cạvedye'	Ventana.
cavi	Mirar.
cavinje'	Hacerlo apurado, ligero o rápido.
cavinyequi	Regresar rápido.
cavintuqui	Utilizar la cosa ante de lo previsto Ej: Comer plátano antes de que esté cocido.
cavintum	Hacer rápidamente.
cavinyeva	Apúrate.
cavinyi	Apurarse.
cayaj	Piedra grande, roca.
caya'dij	Dueño del chancho tropero nombre mitológico.
cayaya'	Bejuco.
cạyete	Llevar algún objeto o cosa a otro.
caye'	Llevar algún objeto o cosa para otra.
cáyei'	Sucha, buitre.
cayi'	Color bien nítido.
co'co'sis	Calzado, zapato.
cọ'co'yi	Silbo o silbido de mono.
cocaj	Coca (planta).
coco'	Garrapata.
co'co'	Aurora cabeza azul.
cọcojsi'	Brujo, sabio.
cọcojsi'naqui	Que hace la brujería.
cocojsi'naquity	Falso brujo.
coco'vanej	Murciélago, vampiro.
cocha'nactyi'	Masa.
cocha'naqui	Amasar, harina, mezcla para hacer pan.
cochan'je'	Amasar.
cochen'	Agarrar todos juntos.
co'chi	Gallinero.
cochij	Chancho, cerdo.
cọc̣hinọ	Cuchillo.
cojchi'ro	Carau.
cọc̣hivi'	Lorito.
cọ́c̣hojc̣ho'	Peto chuturubí.
cochop	En círculo.
coc̣hop yu'tye'	Circundar, rodear.
cọdacdye'	Pedido.
cọdaqui	Pedir, orar.
codaqui jii'dye'	Pedir permiso, pase, salida.
cọ́di	Cola de animal.
cọdaqui	Pedir algo.
cọdyetaqui p̂eyacdye'	Preguntar, hacer preguntas.
cofjiti	Vestirse, ponerse la ropa.
coftyity	Camiseta.
coi'dyii'	Barriendo.
cọi'dye'	Arco (para flechar).
coi'dyij	Barrer el patio.
cọijbun	Dar una jira y llegar al mismo lugar.
cọtoije'	Dar vuelta.
cọijti	Vueltear, girar.
cọijtis	Hélice, cosa que jira.
co'jeyaqui	Ponerse zapato, guante, media.
cojiro	Río.
cojma	Almendrillo.
co'moij	Envuelto en algo.
comomon'je	Envolver cosas.
comon'jeyaqui ava'	Envolver al niño en el pañal.
comora	Flecha con punta de bola (butucúm).
con'	Mario de maíz.
co'naij	Palo seco caído.
cóne'ijtyi'	Víbora cascabel.
cóne'ij	Planta leche, cascabel de víbora.
conojfoto'	Ochoó.
conoya	Pájaro carpintero.
co'ñe	Hojas nuevas de planta, retoño, cogollo.
co'ñeij	Árbol que le sale hojas nuevas (retoñando).
cópinaty	Palometa real.
coracdye'	Remo.
co'raqui'	Hacer chicha de maíz.
co'ractyi'	Chicha de maíz.
cordyij	Remar.
corin'yi'	Ruido de palo seco que se quiebra.
córishij	Fríjol.
co'ro'	Pez, carancho color amarillo.
corocoroj	Ibis cara pelada.
córoi'	Gusano quemaquema.
co'roi'	Algo podrido (yuca).
coroma	Abeja, miel de abeja o de caña.
corpa	Millo, remedio natural para curar enfermedades (hechizos).
cos	Cigarro.
cos	Planta de tabaco.
co'shaij	Quemar.
co'shaqui	Quemar chaco.
cóshaqui	Horadar, perforar.
cóshaquis	Broca, herramienta para horadar.
co'shifore'	Lagarto.
coshi'shii'	Objeto, cosa que se orada de vieja.
coshje'	Quemar.
coshje'	Romper, horadar, pinchar.
cosho'dyij	Hacer bulla (humano o animal).
cosho'dyij in	Reír, hacer ruido cuando están tomando.
cọshor'yi	Hacer ruido con hojas secas.
coshoshoi'tyi in	Murmullo de grupo de personas.
coshtaqui	Prender fuego o quemar chaco.
coshte'	Lograr ensartar con flecha.
co'taqui	Ensartar carnada en el anzuelo.
cotej	Totachi.
cọtoij	Circulo.
cọtoijyequi	Dar vuelta o torcer.
coijti	Girar.
cọtso'je'	Agarrar fuerte (animal o persona).
cọtyij	Pez bagre.
cọtyicotyidyei'si'	Color amarillo.
cọtyícotyi	Bejuco con espinas, usado para teñir hilo (color amarillo).
covamba	Canoa, casco.
coi'dyi	Barrer.
cọyevodye'	Algodón de color moreno (natural).
coyo'daqui	Limpiar chaco después de quemar, basurear.
coyojyo'	Curucusí, luciérnaga.
co'vodye'	Chuchío para hacer flechas.
cubaqui	Exprimir frutas.
cubaquis	Exprimidora de fruta.
cube'	Exprime las frutas.
cu'dye'	Animal, ave doméstico.
cu'dyeij	Criar animales.
cu'dyetui'	Amansar, domesticar animales.
cudyiti	Orar, pedir, adorar.
cui'bujbui'	Remanso chico.
cuj	Carbón.
cujcujje'	Golpear algo que suena, tocar bombo.
cujjajiti	Herir con cuchillo.
cujje'	Golpear, dar sonido a un tambor o bombo.
cujij	Personaje mitológico del pueblo chimane dueño de las aves.
cum	Sardina.
cum	Barbecho, chaco abandonado.
cum'jeyaqui	Echar líquido en una vasija.
cumrety, cumres, cumreij, cumrei'	Cilindrico, esférico.
cu'na'	Pacay.
cudyiti	Pedir, orar.
cupjeyaqui	Exprimir ropa, etc.
curijtu'	Mariposa negra.
curuij- rui'	Carne en descomposición que come el buitre.
curuj	Buitre.
cusha'shaij	Ruido que se escucha en el monte, murmullo de hojas secas (cuando se pisan).
cushin'dyi	Nombre de un río.
cu'shiti, ti'	Enfangarse en el barro.
cushruij -i'	Color del tigre pintado.
cushyi'	Fangoso.
cushushuj bu'yi	Conectado.
cutudye'	Mango, cabo de herramienta.
cuvij, quivij	Otra vez.
cuvijje'	Repetir, hacer de nuevo, repasar.
cäbun	Cambiarse, ponerse ropa.
cächcächsis sánacdye'	Escritura o letra cursiva.
cächje'	Empalmar, añadir.
cächyetŝọij	Acoplar al grupo.
cä'chacdye'	Rompecabezas, cosa añadida.
cä'chaqui	Añadir.
cä'chacsi'	Cosa añadida.
cä'chacdyes	Rompecabezas.
cä'chaqui	Armar añadir cosas.
cäc̣hen'je'	Seguir a otra persona, estar siguiendo.
cächä'	Seguir a una persona.
cäc̣hä'chui'	Seguir a una mujer.
cächä'ĉhute	Seguir a un hombre.
cä'chäij	Seguir los pasos de otra persona.
cächmäty-mäs	Defectuoso.
cächtacdye'	Algo añadido, multipiso.
cächtaqui	Añadirá la largura.
cächti'	Unión, añadidura.
cädäty	Sin pelo.
cädäj	Desnudo.
cädäij	Sin ropa (pobreza).
cäi'säij	Tener dientes completos.
cäi'tsij	Enrollado, curvo.
cäj	Mal puesto, mal hecho, errado.
cäjdäi', cäjdäij	Terreno limpio o persona desnuda.
cäjdäi'ya', cäjdäi've	En el patio.
cäjdäiya'	Patio de la casa.
cäjdäjdäij	Estar sin ropa desnudo.
cäjdä'däi'	Andar sin ropa.
cäjje'	Herrar, fallar.
cäjve	A un lado.
cäjya'	Lejos de casa, en medio monte.
cäjyas aca'	Casa sola medio del monte.
cạ̈n	Agonizar de alguna enfermedad.
cänai'	Al revés, volcado.
cänäij	Tener puchichi (orzuelo) cerca del ojo.
cänäj	Cresta del gallo.
cạ̈nä'naqui, cạ̈nä'ñe'	Cercarse para hacer un compromiso de pareja.
cän'jete	Invitar a tomar agua, chicha, etc.
cän'taqui tŝij	Atizar fuego.
cänjọij	Agonizar, que ya no puede hablar.
cän'taqui	Armar trampa u otra cosa.
cạ̈r'je'	Acercase a una persona u otra cosa.
cäshị́r'je'	Arrugar (dañar) papel.
cätac	Pongan se la ropa.
cätidye'	Plantación.
cäti	Sembrar plantines.
cätin'dye'	Dolor de mordedura de víbora, o picadura de insectos, etc.
cạ̈ts	Igual, exacto, emparejado, perfecto.
cäts	Machetear, cortar.
cäts cati	Desarrollar al mismo nivel que otro.
cätsbäij - bäi'	Delgado, flaco, flaca.
cätsbäty -bäs	Persona delgada, animal flaco.
cätsben'yetac	Enflaquecerse.
cätsben'yetaqui	Enflaquecer.
cätsen'je'	Aplanar piso.
cätsetaqui	Conclusión de un contrato o de un compromiso.
cätsi	Cumplir, concluir.
cätsii'je'	Doblar o torcer alguna cosa.
cätsje'	Machetear, cortar.
cätsyu'taqui	Igualar, comparar.
cäts yụ'taqui	Anivelar.
ĉabaqui	Doblar hojas para el techo de la casa.
ĉabits	Doblada.
ĉabitssis	Que esta doblada.
ĉabitsje'	Doblar.
ĉabi'tsaqui	Doblándolo.
ĉạijya'	Barranco hondo, profundo en la tierra.
ĉajnaij	Cantidades de bichos.
ĉa'joij	Huir o escapar.
ĉa'joye'	Huir o escapar de algo o de alguien.
ĉa'jotaqui	Huir, escapar algo propio.
ĉanam'	Cinco.
ĉanaj	Cantidad o abundancia.
ĉanajje'	Tener mucha deuda.
ĉanajjeyaqui	Tener acumulado mucha cuenta.
ĉaptacdye'	Doblez de ropa.
ĉaptaqui	Poner doblez a la ropa.
ĉatjete, ĉa'tete	Dar puñete o manazo a otra persona.
ĉat yi	Dar puñete.
ĉa'tsaqui	Arrollar, acomodar como cama.
ĉatsdyiĉan	Corva de la pierna, detrás de la rodilla.
ĉatsjeyaqui	Doblar, arrollar en medio.
ĉatsin'jete	Doblar o torcer (clavo).
ĉau'que'	Espantar.
ĉav'caqui	Hacer escapar.
ĉobaqui, ĉobe'	Observar el lugar para realizar alguna actividad.
ĉochactyi'	Arroz pelado.
ĉo'chaqui, ĉochje'	Zunchar algo con palo.
ĉochaqui'	Moler en el tacú.
ĉodichyi	Dar un trampolín.
ĉodichmuñij	Dar vueltas al caer.
ĉodoi'je'	Doblar, hacerlo curvo.
ĉodoi'yi'	Cimbrar.
ĉof	Ponerse la ropa.
ĉoi'jeyaqui	Doblar.
ĉoi'doty - dos	Torcido, curveado.
ĉojcaqui	Cuidar.
ĉojcaquity	Cuidante o casero.
ĉojĉo	Ajipa raíz, raíz tubérculo comestible.
ĉojquiqui	Ir a visitar.
ĉojtyi'	Corazón.
ĉom' sis	Desportillado.
ĉom'jeyaqui	Desportillar.
ĉom'ñi' ve	Esquina, rincón.
ĉo'naqui	Enlazar o enlazando.
ĉo'naquity	Enlazador.
ĉon'je'	Desnucar, quebrar.
ĉoñin'je'	Tragar.
ĉoñi'naqui	Tragar la saliva por desear algo.
ĉoqui	Creer, hacer planes en vano, imputar.
ĉọ́qui	Creer erradamente, tener fe, confianza en, hallar, estar al tanto de, sentir.
ĉọshaquis	Catre.
ĉọshaquity	Estera, ropa para dormir.
ĉọshdye'	Hora de dormir, siesta.
ĉọshdyes	Dormitorio.
ĉọpshequi	Ir a dormir.
ĉoshi	Dormir.
ĉroshtuti	Persignarse, hacer señal de la cruz.
ĉo'taqui	Enlazar.
ĉoti'	Guayaba.
ĉotidyei'	Guayabal.
ĉucdyi'	Visítame.
ĉuchyi, ĉuchjete	Golpear pelota con la cabeza.
ĉuchyi	Toro que golpea con la cabeza.
ĉụi', ĉụi' mọmo'	Cada uno por su propia cuenta.
ĉui'	Uno mismo.
ĉui'	Envano.
ĉụi' me'taqui	Ser orgulloso.
ĉụi'dye	De por si.
ĉụi'dyety tuqui	Hacerse dueño.
ĉụi'dyes tuqui	Adueñar.
ĉụi' dyestui'	Adueñar de lo ajeno.
ĉụi'tui' - tute	Bochinchero, incapaz.
ĉujcan	Alguien que te cuida.
ĉujcati	Cuidarse.
ĉujcatiĉa'	Cuidemos.
ĉuquin	Te visitó.
ĉuñupyi	Volcar canoa.
ĉuri, ĉúreja'	Roncar.
ĉupyi, ĉupĉupyi	Aletear.
ĉurĉurdyi- ĉureva'joij	Roncando.
ĉushaquity	Mosquitero.
ĉush	El sueño.
ĉushdyi'	Visítame.
ĉushi'shij	Con sueño, tener sueño.
ĉushtyiti	Dormirse cuando uno está realizando alguna actividad.
ĉúti	Darse cuenta.
ĉútiĉa'	Darnos cuenta.
ĉútidye'	Creencia, fé.
ĉuv'	Nudo de caña, chuchío, chonta, etc.
ĉär'je'	Encerrar.
ĉä'räij	Cerrado, encarcelado.
ĉär'taqui	Pegar la puerta con candado.
ĉär'taquis	Cárcel, prisión.
ĉärtaquisĉan	Está en la cárcel.
ĉäsjeyaqui	Ponerse gorra, sombrero.
ĉäsyis	Gorra, sombrero.
ĉästaqui	Enlazar.
ĉästacdye'	Corona.
ĉästaqui	Ponerse sombrero (gorra) a la cabeza.
ĉätdye'	Dolor picadura de (víbora, peto, hormiga, raya).
ĉätij	Picar (ají, sentir sol caliente, arder).
ĉävädye'	Pez bagre, toro.
chac	Unidad o suelto.
chac jo'meij	Muy parecido.
chacan'je'	Freír.
chaca'nacdye'	Frito.
chaca'naqui	Fritar.
cha'cacsebity modyin	Dentista.
cha'caqui	Sacar, arrancar, desarmar.
cha'caquis	Destornillador, saca clavos, etc.
cha'caquity	Mecánico.
chacjeyaqui	Sacar, quitar los zapatos.
chacna'naij	Arma (viejo, todo suelto.
cha'e'	Pacú.
chaijcoco	Perdiz pico rojo.
chajaj	Ave, tapacaré.
chajvacdye'	Palizada en río.
cha'vaqui	Tapar hueco con palos.
cha'vetye'	Tapar el hueco con palos cuando el animal se encuentra dentro.
cham'ĉhucdye'	Batidor.
chaman'je'	Apalancar.
chamaqui	Ave que busca alimentos dentro del agua (garza morena).
chamte	Visitar con la intención de unirse a una familia.
cham'je'	Apalancar con remo, batir o mezclar comida.
chaman'je'	Apalancar.
cham'taquis	Palanca.
chanaj	Varias espinas que entran al cuerpo.
chan'je'	Morder alimentos.
cha'ñe'	Animales que toman agua o-comen alimentos rápidamente.
chapa'taqui	Hacer callapo, enyugar bueyes.
chapqui	Nadar.
cha'raty	Animal con cuerno.
chạrara'	Ave, martín pescador.
charqui	Charque.
chav'	Llevar, tener consigo alguna cosa u objeto.
chav'	Tener dinero (lenguaje familiar).
chavapa	Pez, curubina.
chav'jeyaqui	Guardar en el bolsillo.
chẹbebe	Gallareta.
chẹ́caqui	Chocar con el mal viento.
ch'ẹ́cje'	Golpear en el pecho a una mujer.
checreij	Forma de una palca.
chẹi'	Empalcado al medio de dos palos.
chẹi'ya'	Cerca.
chẹi'ya' yi	Acercarse, aproximarse.
chẹi'ya'taqui	Acercar, poner cerca.
chẹi'ya' tuquij	Traer cerca.
chẹi'ya'ya yequi	Ir a acercándose.
chẹi'ya'ya yeti	Venir a acercándose.
chẹi'ya'jete- je'	Acercarse demasiado a una persona.
ĉhe'yaij	Más alto o cantar con voz más fuerte.
chị'	Pando.
chị'ya'	En lo pandito.
chi'baqui	Flechear.
chi'bacva'joij	Flecheando.
ĉhibetstyi'	Lagañoso.
chijcaja'	Cachete de ganado vacuno.
chicje'	Golpear, lastimar herida.
chicnacdye'	Hacer cosquillas.
chicäjräij	Oxidar.
chicnaqui, chicñe'	Hacer cosquillas a una persona.
chicnacvajoij	Haciendo cosquilla.
chicre	Chicle.
chi'ĉan	En lo pando.
chi'ĉhe'	En lo pandito.
chịchu'tyi'	Bocón, chismoso.
chidam' jiti o in	Frase de chistear.
chidacyi	Poner los pies arriba.
chidacyi	Darse la vuelta, retroceder.
chịfrijyi	Estar petacudo (leng. familiar).
chimon'yi	Zambullir o sumergir en el agua.
chimo'naqui	Zambullir varias veces en el agua.
chịn'bis	Lizo, suave.
chinc̣haro	Chicharrón.
chiñicje'	Sacar cáscara o piel de ios animales.
chip	Malva.
chipan'je', c̣hipa'ñe'	Agarrarse del cabello.
chipje'	Flechar.
chipjeban	Flechar de nuevo o desactivar una trampa.
chi'puij	Cabello crespo.
chi'pus, chi'puty	Persona que tiene cabello crespo.
chịquidye'	Aleta del pescado.
chira'je', chira'ñe'	Llenar de flechas.
chinera	Chinelas.
chirijri	Dedo.
chiripo'	Manos, pies (leng. fam.).
chị́rui'	Gusano, vive en palo seco.
chirvajvai'	Montón de algo sin acomodar.
chirvai'tyi	Desparejos, desigual o palizada.
chito'	Planta para envenenar pescado (sacha).
chivän'jete	Hacer dalear la canoa u otra cosa.
chị've	Lo pando del agua.
chị'vejtaqui	Llevar a lo pando.
chiviya	Taracoré (Ave tipo gallina).
chiyajje'	Chisguetear agua.
chị'yedye'	Tiempo seco.
chị'yi'	Agua que baja de nivel (noria).
chobaquis	Niñera.
choben'je'	Abrazar.
choben'jete ava'	Alzar niño.
chobo'naqui	Abrazar, con el pensamiento de tener relaciones sexuales.
chobo'	Niño alzado en los brazos.
chobo'chui'	Tener alzado en los brazo.
choco'	1. Apuntar, culpar, 2. Manojo o nudo.
chọco' c̣họco' p̂eyaqui	Hablar por señas.
chọ'coij	Atado, amarrados.
chọco'te-tye'	1. Amarrar las manos, pies, etc. 2. Culpar a la persona de un delito.
chocojmaqui	Sacar una cosa de una bolsa.
chocomje'	Manosear, hurgar.
chọco'te	Atar en manojo (caña, trigo, chuchío).
choco'ti	Declararse culpable.
chọc̣ho'coco'	Amarrado, prisionero.
chọ'dyij	Sonar el estómago (de hambre, etc.).
choijje'	Arrancar de raíz.
chojc̣hoty	Ave pichón.
chojraqui	Buscar algo en un lugar para robar.
chojre'yi	Robar de una bolsa o de un jasayé.
chojvaqui	Amenazar.
chojyaqui	Arrancar yuca, etc.
chomren' yi	Mirar con desprecio.
chomren'jeyaqui vej	Mirar con disgusto.
chomro'naqui	Mirar con enojo.
chon	Perder, extraviar algún obj.
chon	Desvestirse.
chonĉhui'	Escapar, dejar caer en el suelo.
chonjeyaqui	Perder, dejar, olvidar algo propio.
chonje'	Desnudar.
chojñe'	Desvestir a una mujer.
chon'jeyaqui, c̣ho'ñe'	Mostrar, sacar algo afuera.
chon'je'	Sacar afuera.
chon'yi	Salir de la casa.
chónaqui, c̣hóñeja	Sacar, quitar la ropa.
chon'dye'	Salvación.
chon'dyedyes	Objeto para salvarse.
chonọ'macdyes	Bebida, trago.
chonom'je'	Probar bebida.
chon'ti	Aparecer.
choñij	Escapar, ser salvo.
choco'	Amarrado un jase.
chọquen'	Hacerjase.
choro'naqui	Enfriar líquido caliente.
chọro'roij	Crujido del estómago de hambre.
chọro'roij -roi'	Tener mucha hambre.
chovaj	Sicurí, víbora grande, fiera.
cho'vaqui	Sobar para sacar brujería.
chovo'	Yuca dura aguachenta.
chụ'	Tejón.
chubur'taqui	Volcar (canoa, gaveta, etc.).
chubur'yi	Echarse, acostarse de barriga.
chục	Estar lleno de comida.
chucje'	Teñir, hilo, champar en líquido.
chucujcus ojñi'	Agua estancada, que no corre.
chucu'je'	Remojar, poner al agua para ablandar.
chucu'taqui	Sumergir en líquido, (agua).
chu'c̣hu'	Picaflor.
chu'c̣huij	Callarse, esperar, retener.
chụchujdudu'	Estar echadas varias personas.
chuden'yi	Acostarse.
chuden'je'	Hacer que se acueste.
chude'naqui	Echarse cada rato en la cama.
chuj	¡Cállese!, silencio.
chụjduij	Acostado, echado.
chu'naqui, c̣hu'ñe'	Chupar algo (frutos).
chu'naqui viroj	Chupar caña.
chúna	Quinaquina, árbol.
chunu'	Cotudo.
chunu'joij	Tener bocio (coto).
chuñij	Placenta.
chuñij	Raíz recién brotada de chuchío.
chupen'	Paquete entero.
chupu' tye'	Empaquetar, envolver.
chu'puij	Cosa envuelto en algo.
chụ́qui	Satisfecho, lleno de comida.
chụra'	Mara.
chu'rui', c̣hu'ruij	Desigual (piso, suelo).
churum	Sonido de caer en el agua.
chushtaqui	Tocar hacer el amor la primera vez.
chuctacdye'	Color teñido.
chuctacdyes	Color para teñir hilo.
chäbäj	Grande.
chäc̣häjrärä'	Desparejo, desigual.
c̣häjñi -ñi'	Enfermarse de la boca (utuó).
chäjräij, chäjräi'	Esparcido.
ĉhạbán	Bajar.
ĉhabanya'	En la bajada.
ĉhaba'jeyaqui	Hablar en secreto, mentir de algo.
ĉhaba'naqui	Hablar para otro en secreto.
ĉhabaqui	Sacar la espiga de maíz.
ĉhacbaty	Blanco, de piel blanco.
ĉhạĉhajoi'	Avión que baja del aire.
ĉhaĉhanjoij	Endurar, secar (cemento, etc.).
ĉhạdye'	Bajada o barranco.
ĉhạij	Vomitar.
ĉhạij	Bajar ir abajo o tender ropa.
ĉhạ́ja'	Bajemos o vomitemos.
ĉhaijje'	Abrir, extender.
ĉhaijti	Abrirse (flor, ala, etc.).
ĉhajĉhajyi	Canoa sobrecargada.
ĉhajje'	Hacer rebalsar agua en la canoa.
ĉhajjete	Ladear canoa (hacer entrar agua).
ĉham	Ralo.
ĉhámety -mes	Amarillo.
ĉhami	Arralar.
ĉhanam'si'	Lugar seco.
ĉhañej	Seco.
ĉhantaqui	Pez en un poso secándose.
ĉhañejyejoi'	Secando, seco.
ĉhañety -nes	Seco.
ĉhañij - ñi'	Secarse.
ĉhap chique'	Saber entender bien.
ĉhap p̂eyaqui	Hablar bien un idioma.
ĉhapje'	Abrir.
ĉhapa'jeyaqui	Callapear canoa.
ĉhasa'saij	Navegar en el río.
ĉhastyeij, chasyi	Nadar rápido (casco, cosa sobre agua).
ĉhash	Vómito.
ĉhashdyes	Remedio para vómito.
ĉha'she'	Alcanzar, llegar en el lugar.
ĉháta'	Así es, en verdad, que lastima.
ĉhata'dye me'	De verdad es así.
ĉhayen' tŝọi'	Caída de agua (cascada).
ĉhe' tsun	Sol alto, por la mañana.
ĉhe'ĉhuqui	Sostener, tener alzado.
ĉhe'je'	Suspender, alzar poner arriba.
ĉhe'jetye'	Ayudar a alguien alzarle algo.
ĉhenaqui	Dividir, despengar plátano.
ĉhenje'	Descuartizar a un animal.
ĉhen'	División de carne de animales (pierna) plátano; gajo.
ĉhen'je', ĉhe'ñe'	Despengar plátano.
ĉhet	Mitad, por la mitad.
ĉhetaqui	Partir.
ĉhetacsi'	Partido.
ĉhetaijje'	Deshacer.
ĉhétaqui	Partir, rajar leña.
ĉhete'	Rajar.
ĉheti'tii'	Partirse de por si mismo.
ĉhetjeyete	Dar la mitad de algunas cosas.
ĉhevyi	Abrir las alas para volar.
ĉhe've	Arriba.
ĉhe'vety-ves	Lo de arriba.
ĉhidaquistyi'	Hambriento.
ĉhị́dye'	Sabiduría, conocimiento.
ĉhidyi'ĉanya'	En medio, en la mitad.
ĉhidyi'ĉanyas	Lo del medio.
ĉhifajje'	Rociar, regar.
ĉhifajnaqui	Rociar, regar plantas.
ĉhiba' me'o	Peor así no vas a tener nunca.
ĉhịbi'	Brotar germinar una planta.
ĉhibin	Tres.
ĉhic	Orina.
ĉhicaqui	Entender, obedecer.
ĉhicaqui dáquis	Sentir hambre.
ĉhicvadye'	Enfermedad urinaria.
ĉhicvaqui	Estar enfermo de los órganos sexuales.
ĉhicon'je'	Lavar.
ĉhiĉushtyi' - si'	Dormilón, uno que duerme mucho.
ĉhiĉhi'	Mono chichilo.
ĉhiĉhim'	Pestaña.
ĉhiĉhimec	Parte iguales.
ĉhifrity	Petacudo.
ĉhịj	Saber, conocer.
ĉhijtyi'	Sabio, conocedor, experto.
ĉhij	Palo diablo, árbol.
ĉhị́jam'	Adivinen.
ĉhị́joij	Aprender, llegar a saber.
ĉhijo'metydye	Parecido, igualito, semejante.
ĉhijuchaty	Pecador.
ĉhijäm'	Por fin.
ĉhim	Ceniza.
ĉhimajmaty	Uno que les gusta jugar.
ĉhị́maraty	Dos persona flaca.
ĉhime', chime'dye	También.
ĉhime'jetedye	Vengarse, hacer lo mismo.
ĉhime'jeyacdye	Vengarse, castigar.
ĉhịmo'dye	La misma.
ĉhimu'dye	El mismo.
ĉhin	Clara, ralo.
ĉhintyi' - si'	Agua bien clara.
ĉhịpdye'	Retoño.
ĉhipe're	Plátano bellaco.
ĉhịptaqui	Retoñar, que brota la semilla.
ĉhíqui	Orinar.
ĉhị́qui peyacdye'	Conocer una nueva noticia, enterarse.
ĉhisje'	Sacudir el polvo.
ĉhị́va'joij	Estar atento.
ĉhị́va!	¡Adivine!
ĉhivejyi	Admirar.
ĉhivo'coty	Petacudo, barrigón.
ĉhivo'voty -s	Adúltero (mujeriego).
ĉhị́yactyi'	Bien conocido, amigo.
ĉhị́yaqui	Conocer.
ĉhiyi'dye	Decir lo mismo.
ĉhoc	Mitad, por la mitad.
ĉhocaqui	Cortar en pedazos (plátanos, palos, etc.).
ĉhocje'	Cortar por la mitad.
ĉhof	Reventar.
ĉhofjeyaqui	(leng. familiar) Carnear.
ĉhofjeyaqui	Reventar algo propio (pelota).
ĉhoyei'tyi'	Extender esparcido (no muy junto).
ĉhoji'vaqui	Echar líquido en vasijas, regar.
ĉhojjiti	Echar agua al cuerpo.
ĉhojjeyaqui	Derramar líquido,
ĉhojonaqui	Echar agua en vasija.
ĉhojo'daqui	Regar plantas.
ĉhojo'dye'	Echar agua a las plantas.
ĉhojjotaqui	Derramar líquido.
ĉhojtaqui	Bautizar.
ĉhojtacdye'	Bautizo, echar agua al cuerpo.
ĉhojtyin yụ	Me bautizó.
ĉhomin'dye'	Caracha, roncha.
ĉhojmuñi' añej	Lluvia fuerte por un rato.
ĉhoquin'je'	Ir o pasar por la mitad de un terreno.
ĉhore'naqui - ñe'- je'	Enfriar líquido caliente con dos vasijas.
ĉhoriti	Gotear, fluir, sudar.
ĉhómiñi	Tener carachas.
ĉhoquin' tyei'	Hacer una línea en la mitad de un terreno, cruzar el río.
ĉhoqui'naqui	Cortar por piezas.
choqui'vaqui	Cortar por pedazo.
ĉhosh, ĉhoshje'	Quebrar algo o huesos.
ĉhọsho'	Ratón.
ĉhoshoityi' - si'	1. Tener tumor en la pierna o cuerpo. 2. Comido por ratón.
ĉhọshoij	Comido por el ratón.
ĉhotoc	Soltar un hilo, cuerda.
ĉhoyaqui	Jalar canoa.
ĉhoyen'yi	Saltar.
ĉhoyen'je'	Brincar en algo.
ĉhoyojyoij	Dejar templado el mosquitero.
ĉhúdye'	Comida, algo en contacto con la boca.
ĉhufruty -rus	Petacudo, petacuda, panzón, barrigón.
ĉhụi'	Directo.
ĉhui'buty -bus	Blanco, limpio.
ĉhụi' bu'yi	Ir directamente.
ĉhụi'chuqui	Poner directo en line.
ĉhui'	Pegar a manazos.
ĉhui'	Recibir algo de regalo.
ĉhụ'	Boca.
ĉhucdye'	Ganancia, lo que saca uno por el trabajo.
ĉhuc	Usar una cosa.
ĉhucsi', ĉhuctyi'	Usado, usada.
ĉhujijcai'	Rescatar.
ĉhujbi	Hinchado.
ĉhujbi vejya'	Se hinchó la cara.
ĉhun	Oreja.
ĉhunyi	Alumbra.
ĉhunyis	Linterna.
ĉhuñem	Ver a través de un objeto transparente.
ĉhupyi-yi'	Escupir.
ĉhuquí	Le pegó, lo agarró.
ĉhu'ruruty -rus	Grueso: clavo, chuchío.
ĉhushen'	Animal que corre con la cola levantada (ardilla, zorro, oso bandera).
ĉhu'shus	Animal peluda, oso bandera.
ĉhutye'	Quitar o sacar cosas de alguien.
ĉhutej	Raspadura de olla.
ĉhushu'je'	Dejar palo caído.
ĉhushujshuij	Árbol que queda parado después de un chaqueo.
chuta' - tas	Planta cargada de fruta.
ĉhushu'shuij	Animal que viene con la cola suspendida.
ĉhuju'juij	Cruzar el río a pie.
ĉhutidye'	Pelea, enfrentamiento.
ĉhutidyedyety	Arma para la guerra.
ĉhụ'ya'	Por la boca.
ĉhu'ya' jete	Reprender con la boca.
ĉhụyujyuij	Bejuco que viene de arriba hacia abajo.
ĉhụi'je', ĉhụi'taqui	Enderezar.
ĉhụi' yụ'taqui	Corregir.
ĉhụi'dye'	Puerta.
ĉhujịjcaqui	Agarrar lo escapado, salvar del agua.
ĉhuijrity	Cuello largo.
ĉhụi'tye'	Enderezar.
ĉhäĉän	Sanar, recuperar.
ĉhäcdyi	Vivísimo.
ĉhäcdyiĉa'	Ser vivísimo.
ĉhädye'	Manteca, gordura.
ĉhädyedye'	Tiempo cuando los animales están gordos.
ĉhäij	Gordo.
ĉhäjäm'	Al fin.
ĉhäquiti	Sentir algo de dolor.
ĉhäsh	Sangre, resina de árbol.
ĉhäshi	Sangrar.
ĉhä'täij - teij	Conocido, bien claro; en negativo: oculto.
ĉhäti	Arisco.
ĉhätidye'	Familiar, de la familia, de la misma raza, pariente.
ĉhäyiti	Reconocer su personalidad.
dabaj	Maní.
daca'	Palca.
daque'	Pillar alguna cosa.
dạcaqui	Hallar, encontrar algún objeto.
daquiri	Concha.
dai'	Mucho.
dai'dye'	Caravana, persona blanco.
dai'je'	Multiplica o que tenga varios.
dajje'	Desatar algo.
dajtaqui	Desatar alguna cosa u objeto amarrado.
dam'	Poco.
dam' momo'	Menos, mínimo.
dadam' muju'cha'	Palabra comparativa: más, peor, etc.
damamaj	Poco a poco.
dam'che'	En la punta (del árbol, etc.).
dam'dye	Comparativo, mejor, peor.
dam'dye jäm' me'	Mejor así.
dam'dyety	Casi, falta poco.
da'mi jorojĉan	Escasamente que se puede ver.
damjeyaqui	Cosa que gasta de a poco.
dam'je'	Probar un poco.
damje' va'tacdye'	Ser castigado.
dam'jo'meban	Un poco mejor, recuperar.
damtui'	Traer poco.
damtuqui momo'	Persona que va a un lugar por corto tiempo.
dáqui	Tener hambre.
dáquis	Hambre.
dạquique'	Encontrar a alguien.
dạquishajte	Encuentro de una persona visitante con el dueño de la casa.
dáshu	Cuerno.
dáshuij -shui'	Brotar los cuernos.
dayi'	Aumentar, multiplicarse, reproducirse.
dẹvje'	Tocar campana.
dẹjvaqui	Golpear cosa.
dẹvyis	Toca campana.
déve	Cuenta o deuda.
deveij	Tiene deuda.
dévetute	Le debe.
dijrity	Guatoco y petacudo.
dijris	Guatoca y petacuda.
dochaquity	Singa.
dochco'	Tronco.
dochdyij	Singular.
dochje'	Apuntalar algún objeto con palo.
dochjetaqui	Trancar no dejar pasar persona ajena.
dochtaqui	Apuntalar, sostener.
dochti've	Rincón, esquina, curva del camino.
dochtuqui, dochti	Doblar, ir por curvas (zigzag).
dofocje'	Aflojar.
doijro' bu'va'joij	Cuidar, velar, estar mirando.
doijrodye'ĉan	Hacer señas con los ojos, realizar alguna actividad en pública.
doijroij	Mirando.
doijroja'	Cuidar, velar una cosa.
doijrojtaqui	Fijar algo es de uno.
doijrojtye'	Fijarse en algo.
doijroi'tyi -tyi'	Que esta mirando.
doijrojyi	Abrir los ojos.
doijrojtyejcaqui	Mirar cada rato alguna cosa.
doijrojyetaqui	Fijarse antes de irse.
dọj	Nombre de un sapo.
dojchaqui	Tender el mosquitero.
dojchaquity	Varilla para mosquitero.
dojity	Dios mitológico de los caimanes.
dojity	Nombre de víbora color amarillo azulado.
do'nos	Flema (en heces).
doq̂ui'	Nuez de la garganta o bocio.
dọraj	Hernia.
dọraij	Herniado.
doroi'jeĉunaqui	Discriminar o despreciar.
doroi'	Desprecio.
doroi'yity	Persona que desprecia o discrimina a otros.
dọ́roj	Perrito de Dios.
dosijsiij	Ave, persona parada de piernas largas.
dosi'siij	Estar andando con piernas largas.
dosi' bu'yi	Estar parado con piernas largas (como ave).
dóto	Chumiri (árbol).
dótsaqui	Picotear, pellizcar.
do'tsity -sis	Con piernas largas.
dotsomje'	Picotea.
dui'rij	Amontonado, enroscado (víbora).
dui'ris	Loma, amontonada.
dui'rii'tyi'	Amontonado, montón de cosas.
dujdujyi	Sonido de bombo o de nadar.
dujje'	Dar un golpe en la espalda.
dujren'yi	Flotar, bogar.
dujren'yis	Flotador, bogador.
dujrij	1. Hincharse del estómago. 2. masa para pan.
dujrity	Hinchado, madurado (masa de harina).
dụjru'naqui	Nadar sin champarse la cabeza, estar en el agua sin zambullirse.
dujrujrui'si' -tyi'	Una cosa flotando, bogando sobre el agua.
dujrujrujquemunsi' -tyi'	Muchas cosas flotando en el agua.
dujru'ruij	Que va bogando o flotando.
dujtete, dujte'	Herir con flecha o golpear sin avisar.
dúnanaj	Candirú (pez).
durduryi	Gruñido (puerco).
durdyij	Gruñido de chanchos.
dụri'dụri'	Amontonados.
dụri'je'	Amontonar.
dụrijriij	Muchos animales amontonados en un árbol.
duri'ñiti in	Juntarse en un lugar, reunirse para una reunión.
dụri'naqui	Acumular, tener mucho, recolectar.
dụri'ñejcaqui	Tener mucha carga.
duri'ñe' p̂en	Tener varias mujeres.
dụri' yu'taqui	Amontonar cosas.
dụrijriquen	Tener muchos montones (como plátanos maduros).
durja' durja'dyi	Gruñido, rugido de gato.
dururujyi	Bramado de tigre.
duru'ruij	El sonido del viento fuerte como el sur.
däcrä'joi'	Árbol que se está cayendo las hojas.
däcräjräty- ras	Palo que tiene pocas hojas.
däcren' yetac	Marchitarse de hojas.
där	Grande.
därtyi'- si'	Grande.
därä'	Monte, árbol, vegetación.
dạ̈rä'	Vacío, sin nada, pobre.
därä'che'dyety tsun	Atardecer, cuando el sol se está ocultando.
däräij	Cazar en el monte.
däräijtyi'	Hombre cazador.
därejrei'	Monte alto.
däräjräi'tyi	Conjunto de árboles grandes.
därästyi väsh	Comer fruta del monte.
därjeyaqui	Hacerlo más grande.
därvejyu'taqui	Ampliar la anchura.
därve, därves, därvety	Ancho.
därvedyem'	Anchura.
dyebacdye'	Costura.
dyebaqui	Costurar.
dyebaquis	Máquina de costurar.
dye'chei'- cheij	Arma o trampa preparada.
dyeche'jeyaqui	Preparar arma, trampa.
dyecher'je'	Abrir: tijera, etc.
dyeij	Sujo, clase de paja.
dyetse'	Persona anda con las piernas abiertas.
dye'tsei'tyij -tyi'	Con las piernas abierta.
dye'tsety	Que tiene pierna abierta.
dye'jeyaqui	Separar el fuego para que no siga quemando.
dye'je'	Sacar palo del fuego.
dyen	Abrir paso.
dyen bu'yi	Estar separado, tener espacio.
dyenjeyacsi	Darle paso, abrir paso en la muchedumbre, dar paso a otro.
dyete'ĉan	En medio monte, sin senda.
dyeten'je'	Abrir para dar paso entre medio de otras cosas.
dyets	Dar paso.
dyetsacdye'	Embrujado por el arco iris.
dyetsaĉa'	Flechado o embrujado por el arco iris.
dyetse'	Flechar (animal, ave).
dyi'	Ano.
dyi'ĉanya'	En medio.
dyicba'badye'	Neblina.
dyichchuti	Aguantar, reflexivo.
dyichjetye'	Aguantar o resistir de algo.
dyichmen'yi	Ponerse en cuclillas.
dyidyijyejoij	Captar poco a poco.
dyídyir	Ave pequeño.
dyijbu'yi	Alerta, ser vigilante, estar atento.
dyijjeyaqui	Acordarse de alguien.
dyijyeban	Recordar, pensar de algo pasado.
dyijtucdye'	Recuerdo o pensamiento en alguien.
dyijyi juchajĉhe'	Arrepentirse del pecado.
dyijyedye'	Pensamiento, inteligencia.
dyijyedye'	Idea, conocimiento.
dyijyi jen'che'	Pensar en Dios.
dyijyi	Pensar en algo o extrañar a alguien.
dyidyijjoij	Adquirir conocimientos.
dyijdye' - dyijyedye'	Pensamiento, idea.
dyiji'ji'yequi	Pensar en algo, pensar mal de uno.
dyijtuqui carijtacdye'	Pensar en su trabajo.
dyíjmi'	Murciélago, vampiro pequeño.
dyijtuqui	Pensar continuamente de algo prometido.
dyijtŝọi'	Sentir dolor tremendo en la cabeza.
dyimacdye'ĉan	Tesorería.
dyimaqui, dyimja'	Escoger alguna cosa.
dyimacdye'	Reclutamiento.
dyimruij	Desvelado, borracho.
dyim'tacdye'	Escoger, elección.
dyin'	Cuña da mujer a mujer.
dyíñe'jeyaqui	Poner desnudo, usar ropa muy corta.
dyíñeij	Chiraposo de pobreza.
dyíñe'ñeij -nei'	Chiraposo, usar ropa muy corta (mujer), ave sin pluma (pichón), desnudo.
dyíñety	Ropa indecente (muy corto).
dyiñeya	Guineo.
dyịri'rii'	Lloviznar.
dyiri'ris	Insecto pequeño.
dyiro'	Chancho grande.
dyis	Jipurí de la hoja de motacú flecha pequeña.
dyisa'yity	Chistoso.
dyisa'yi	Que ríe mucho.
dyisa'tye'	Chistear con la mujer.
dyisactacsi	Reírse de otro, burlarse.
dyisa'tacsi	Bromear con otros.
dyisdye'	Risa.
dyisdyen'je'	Sonreír.
dyidyista'	Sonriente, coqueto.
dyisij	Reír (el hombre).
dyisi'	Reír (la mujer).
dyisi'sijtyi'	Uno que para riendo.
dyisharje'	Hacer chispear los brasas.
dyitum	Rocoroco.
dyitsi' dyitsi'yi	Toser.
dyitsi'tsij	Tener escozor, picazón del cuerpo.
dyitsi'tsijtyi' quị'si'	Ropa que pica.
dyi'ves	Trasero, lo de atrás.
dyu'	Pene, miembro varonil.
dyufarje'	Asar algo de carne o plátano entre los brasas y cenizas.
dyufín	Clase de chuchío.
dyudyes	Bañero o ducha.
dyúquij	Se fue ha bañarse.
dyuij	Bañar.
dyụjtsị	Tigrecillo.
dyujtsijtsijyi	Silbido imitando al tigrecillo.
dyụrtyi'	Maíz blando.
dyụru'je'	Tumbarlo al suelo y ensuciar de tierra.
dyụru'naqui	Embarrándose.
dyụ'rurus	Nombre del palo que sirve para hacer casa.
dyuts	Luna llena.
dyutsyi	Arrodillarse.
dyụ'tsaqui	Arrodillar en adoración.
dyu'tse'	Adorar a una cosa (virgen y otros).
dyụ́tsedye'	Donde termina la tierra.
dyutsen' tsedyedye'	Toda la noche.
dyutsen' mayedye'	Todo el día.
dyutsen'je'	Tardar el día y la noche.
dyutsquiti	Arrodillarse para adorar.
dyäcje'	Paralizar, poner alto.
dyäcjeĉuñe'	Pararlo, detenerlo.
dyäcyi	Pararse, detenerse.
dyä'chäij	1. Sentado en un objeto Ej: tronco, canoa, etc. 2. Ave sentada en una rama.
dyä'chaqui	Cocinar en olla común.
dyä'chacdye'	Excursión.
dyächen' tyeij	Ir sentado en algo (canoa, carretón, camión).
dyächä'chäi'	Llevar cosa en la cabeza.
dyächä'chäij	Bajar en callapo.
dyä'chäij	Sentado en un objeto Ej: Estar sentado en (árbol, plataforma).
dyäch bu'yi	Base en lo que apoye algo.
dyächjeyaqui	Poner, asentar olla en el fuego, etc.
dyächtye'	Sancochar yuca, plátanos, etc.
dyäjtsi	Clase de ave.
dyä'tsi'	Camarón.
dyäquedye'	Pascana, campamento, alojamiento.
dyäqui	Alojarse, parar a descansar.
dyäshi'tyeij	Caminar rengo.
dyäshídye'	Rengo, cojo.
e'bina	Hamaca.
e'binai'	Hacer hamaca.
edoj	Hueso de la cara.
edojdyety	Hueso de la cara, significa que es bien flaco.
e'emdyij - dyi'	Llamar desde la puerta, con limpiar la garganta.
e'fe	Pecho.
e'feya'	En el pecho.
eijnaqui	Canto del hechicero.
eje'	Toser.
eje'yi	Tuese.
eje'naqui	Estar tosiendo.
eje'vacdye'	Tos de ahogo o tuberculosis.
eje'vaqui	Enfermarse con tos de ahogo.
éjojyi	Gritar.
éjojquedye'	Grito.
éjojdyi	Gritar varias veces como un borracho.
éjojo	Guajojó.
éjojyejoij	Tormenta, excitación de ánimo.
emej	Pava roncadora.
ẹmẹjrẹque'	Pájaro carpintero vientre rojo.
emoñico	Muñeca, santo o amo de los animales.
ena'yi	Hacer un gesto de desprecio con la lengua.
e'naij	Lengua afuera de cansado.
ena'naij	Venir con la lengua afuera.
ẹ'nas	Machete angosto (viejo).
enam'je'	Lamer.
ena'maqui	Lamber algo dulce.
énojno	Pez como regla.
epan'je'	Montar.
epa'ñe'	Montar continuamente algún animal (caballo, etc.).
epa'paij	Venir montado en la balsa bajando por el río.
epetsje'	Hacer subir; sacar fuera del agua.
epe'tsaqui	Trepar, subir en el árbol.
epoj	Gemelo, tojo, mellizo.
etspei'tyi-tyi'	Varios animales estar trepados.
ẹreij	Parabachi hombro rojo.
erepaj	Tutuma.
ere'	Avisillo.
escuera	Escuela.
escueraij	Asiste en la escuela.
escueraijtyi'	Alumno.
ei'shoty	Jetón.
ẹyeye'	Frio (ave, pequeño de color amarillo).
e'yi	Vomitar, estar con arcadas.
eyo	Lengua de panza.
eyodye'	Clase de ají.
fạ́cacdyety	Enemigo, el aborrecido, despreciado.
fạ́cactyi' - si'	Uno que siempre es odiado, aborrecido o despreciado.
facajje'	Desparramar, regar alguna cosa.
facajnaqui	Sembrar regando la semilla.
fạ́caqui	Enojarse con alguien de la familia.
fạ́ĉoij	Enojarse.
fạ́ĉoijtyeij	Enojarse de inmediato.
facse'	Tragar.
fachtyetye'	Cavar la cueva en busca de algún animal.
fadacdye'	Poso, cavado.
fada'cacdye'	Garfio de flecha.
fadai'jeyaqui	Armar el arco (conectar la pita).
fai'dai'tyi -tyi'	Preparado para disparar flechar.
fadaqui, fadye'	Cavar, escarbar tierra.
faijjan'	Llamar a alguien.
faijte	Llamar a una persona.
faj	Urucú.
fajche'	Estar arriba del urucú.
fạjche'	Encima, arriba, sobre algo.
fạjchety	Lo de encima.
fajraqui	Rozar.
fajve	Al otro lado.
famje'	Mezclar.
famtyity	Mezclado de distintas clases.
fáquitidye'	Enojo, odio.
faraj bä'yity	Persona libre, tranquila.
farajtyity	Persona libre sin control.
farajje'	1. Abandonar, 2. Jonear con algo.
farajjeyaqui	Dejar algo que tenía.
fạra'jeyaqui	Retear alguien de su familia.
fạra'naqui	Retear, gritonear, reprender, hacer escándalo.
faraij	Asar plátanos, yuca, etc.
faraj	Libre.
faraj farajsis sánacdye'	Letra imprenta, tipografía.
faraj vuca' me'	Ojala que se a así.
farajjeyaqui	Botar, poner, dejar, abandonar.
farajnaqui	Jonear, botar algo.
farajjetaque'	Abandonar.
farajnacdyety perota	Básquetbol (pelota).
farajñe'	Joneando, o dejarlo cada rato.
farajnaquity	Persona que pasa algún objeto, cosa a otra persona.
farajtye'	Embrujar.
farajtacsity	Brujo, hechicero.
faratucsi'	Cosido en brasa.
faratucsi' jac	Ladrillo.
fạra'tum	Hablar con fuerza con entusiasmo, en manera ruidosa.
faratuqui	Asarlo algo propio.
fari'joij	Intestino de animal con tumores.
fa'rity	Tener mucha caracha.
fatsujjeyaqui	Regar hacer remojar.
fatsujñe'	Rociar, remojar.
favaqui	Lavarse la mano u otra cosa.
favtij	Lavar, asear.
fave'	Lavar, limpiar objeto o cosa.
favu'vuij	Humedecer constantemente.
fayacĉan	Hacerla llamar.
faye'	Llamar.
fayactyi'	Ser llamado.
fecje'	Poner en fila.
fecjeyaqui	Poner en fila o línea.
fectidye'	Surco, fila.
fecyi	Ponerse en fila o línea.
fec̣haqui	Apretar el hilo cuando se teje.
fec̣haquis	Instrumento artesanal.
féfen	Testículo.
fei'taqui	Rayar o marcar en línea.
fei'tacdyes	Regla.
fejje'	Tocar flauta.
fejjemcai'	Pasar raspando casi por tocar.
feyaquis	Escuadra de carpintero.
fe'yaqui	Rayar, hacer línea.
fejtaqui	Tocar órgano, flauta.
fejquedye'	Sonido del instrumento musical.
fejquedye' p̂an	Plumas de las alas.
fen	Huevo.
fen'dyedye'	Tiempo de huevos que ponen las tortugas o aves.
feñi'	Poner huevos.
fer	Fuerte, con fuerza.
feryi	Hacer fuerza.
fertyi'	Fuerte.
ferdye'	Fuerza, poder.
ferdye' tui'	Persona que trae fuerza o poder.
ferecje'	Rayar con la uña.
fẹre'rei'	Sonido de una flecha volando.
feredye'	Andar rápido.
feroj	Duro.
feroty, fẹros	Objeto o cosa muy duro impenetrable.
fertuqui	Hacerlo con más ganas.
fertui'	Realizar alguna actividad con entusiasmo.
ferva'ti	Haciendo fuerza.
feshta	Fiesta.
feshtaij	Hacer fiesta.
feshtayeja'	Hagamos fiesta.
fetsje'	Cortar con machete.
fe'tsaqui	Rozar hacer chaco.
fetsectyei'	Soltar una soga, pita, etc.
fe'tsij	Senda, picada en monte.
feyi'vacdye'	Rayas o cuadrados (en papel).
fi'	Jugo.
fibity	Panada, inútil.
fibi' jäm' ji'ĉuti	Hipócrita.
fibi'yi	Farsear.
fibi'je'	Farsea, que se adelanta de hacer cosas sin saber.
fibi'yeti	Venir en vano.
fibi'naqui, fibi'ñe'	Jactarse, alabarse uno mismo.
fibi'ya'	Sacar fiado, sin costo, gratis.
fibi'ya' chij	Saber de memoria.
fibi'yequi	Ir en vano.
ficajyi	Extender, huir animales.
fídye'	Cintura, cadera.
fidye'	Sequia de un poso.
fíjfity	Soplador.
fi'i'	Que tiene jugo.
fijnacdye'	Acción de ventear.
fijnaqui	Venteando.
fịjnaqui	Silbando.
fijñe'	Ventear.
fijñitij	Ventearse.
fịjyi	Silbar.
fijyis	Silbaco.
fijyedye'	Silbido.
fịn	Cabello.
fin'je'	Tejer hilo uno por uno.
fíñeij	Bien afilado.
fiñi'	Cuerpo que le nace muchos pelos.
fị́ru	Perdiz pequeño de color oscuro.
fitu'baqui	Botar, echar fuera.
fitupjeyaqui	Botar algo que es de uno.
fi'tyi'	Semen o espermatozoides.
fiyero	Hierro.
fófor	Perdiz del monte.
fojyi	Silbar con las manos.
fo'je'	Vaciar o botar algo.
fopje'	Meter o insertar cosa u objeto.
fop bu'yi	Bien colocado, que no cae ni sale.
fóco	Foco de linterna.
foco'	Podrido.
focoij	Podrirse.
focoty	Podrido.
fochon	Cavar.
fochonje'	Acción de cavar.
fochojñe' jac	Cavar la tierra.
fochojnaqui	Estar cavando.
foi'je'	Raspar madera u otra cosa.
foi'tye'	Raspar la tierra u otra cosa.
foij	Perro del monte.
fojfe	Perdiz del monte.
fom'	Cuñada.
fon'	Descompuesto.
fon'je'	Sacar, descomponer.
fon'jiti	Descomponerse.
fónac	Sacar cosa de adentro y poner afuera.
fónaqui	Sacar cosa de uno hacia fuera.
fop	Poner adentro.
foqui' bu'yi	Montado.
foquin'je'	Montarlo (caballo, etc.).
foqui'tyity	Que está montado.
foyacje'	Operar o destripar.
foyactacdye'	Operación.
foyaqui	Raspar madera u otra cosa.
fucfucyi	Bramar (tigre).
fuchyi	Enojarse de nada.
fuda'cacdye'	Arado.
fudac	Trillar, hacer trillas.
fudye'	Chaisita (ave).
fuda'caqui	Arar, aflojar la tierra.
fudyi'dyij	Estar aburrido.
fujfuj	Mapajo.
fujyi	Ventear.
fujque'	Que está venteando.
fuju'juij	Viento permanente.
fur tyei'	Arder fuego.
furtyei'	Llamear.
furujruij	Estar con luz.
furquij	Con alta temperatura, llameando.
fuvan'yi	Humedece, exudar.
fuyaqui	Arrastrar o llevar jalando alguna cosa.
fuyen'je'	Jalar.
fuye'ñe'	Estar jalando.
fuyu'fuyu' mi'i	Caminar arrastrándose (paralítico).
fäcän'je'	Apalancar (manejar arma).
fäcän'yis	Manivela de arma.
fädye'	Chaisita (ave).
fäi'däij	Curvo, no recto.
fädäi'je'	Hacer curvo, armar arco.
fäi'däi'yai'	Medio curveado.
faijqui	Estar cansado (con lengua afuera).
fäjfäj	Paloma o chaisa.
fän'qui	Con hipo.
fän'quedye'	Hipo.
ịbijq̂ui	Achachairú (fruta silvestre).
i'bubuj	Tutuma, churuno, calabaza.
ichi'mun	Pequeña, mediana.
ichi'muntyi' - si'	Niños, cosas pequeñas, etc.
i'dojore'	Nombre mitológico dueño de los peses.
i'du	Mosca de color verde.
ịj a'	Piscua.
ịjaij	Terminar un trabajo. ỊJAI'. La mató.
iji'naqui	Hablar con ternura.
ijme	Flecha.
ijmeij	Hacer flecha.
ịjsi'taj	Fruta comestible de color rojo (nuí).
ijtapa'shi	Órgano de chancho de monte de olor muy fuerte.
ijtapa'shi	Planta clase de flor.
ijtyiquij	Alacrán, escorpión.
im'	Quijada.
in	Plural (muestra que son varios).
inajshere'	Hormiga pequeña de color negra.
in'ja'yisin'	Nausear.
in'yi - yi'	Causar nausea.
ịnoj	Ají picante.
inọj	Tiempo pasado (mismo día).
inọjĉan	De madrugada.
inọjĉandye	Muy temprano.
inọjdye, inojyai'dye	Hace rato (el mismo día).
intsiij, intsii'	Madurarse.
intsis	Maduro.
iñi'ñij-ñi'	Mal del estómago querer vomitar.
ịpị'	Loro cabeza ploma.
ị'po'	Tutuma pequeña para servir chicha fuerte (copa).
irij!	¡Cuidado!
irijyi	Tener miedo, respetar alguna cosa ajena.
írimo'	Palometa.
iri'taqui	No está de acuerdo.
iri'tye'	¡Cuidado! ¡No haga eso!, tener respeto (puede ser un peligro).
isatrij	Sustancia de cristal, usado como remedio.
isbara'	Mono nocturno, "cuatro ojos".
isinu'	Raya (pez).
ịsitai'	Chulupi pequeño.
isujqui'	Remolino de agua.
ishajje'	Espantar.
ishajvaqui, ishajnaqui	Espantar.
ị'shejshe'	Chuvi.
ịshij	Clase de pez, bagre.
isho'	Viejo, anciano, término de respeto.
ishoij	Envejecerse.
itij	Cogollo de palmera.
ịtsajtsa	Sabañón, enfermedad de la piel.
ítsi	Hoja para teñir hilo (color violeta).
itsidyei'si	Color violeta.
ịtsidye'	Clase de plátano.
itŝij, itŝi'	No hay, no está
itŝij tyeij	Desaparece de inmediato.
itŝijyi	Tener mucho miedo.
ị́tsiquidye'	Surubí.
ị́tsiquij	Tigre.
itŝijtuqui	Ausentarse por un tiempo.
ịtsity	Palanca, tarántula.
itsoj	Anguila.
itsuc	Tamaño pequeño.
itsu'caty	Corto.
ịtsu'qui'	Tamaño mediano.
ịtsu'quity	Pequeño, chico.
ịvaj	Luna.
ịvaj	Mes.
ịvadye'	Luna llena.
ivijnadye'	General, pez.
íya'	Paraba de color amarillo con azul.
iyijq̂ui'	Tarechi.
iyo'yejoij	Morir (leng. Fam).
jábiya'	Luego, más tarde.
jábiya'dye	Enseguida.
jac	Tierra, país, terreno, planeta.
jacĉan	Debajo de la tierra.
jacĉhe'	En la tierra.
jácabun	Venir a llevar una persona (no plural).
jacshajquejoij	Embarrarse, cuando está borracho.
jacsha'naqui	Estar con queresa (huevos de mosca).
jaĉujcatis -tity	Uno que cuida a otra persona, alzadora de niños.
jaĉhajĉhaij- ĉhai'	Estar con la boca abierta.
jaĉhen'yi	Abrir la boca.
jạ'ĉhijyi	Estornudar.
jadacdyi	Pillar o encontrar haciendo algo.
jadaquicdyi	Llegar de sorpresa, entrar, alcanzar (como enfermedad al cuerpo).
jadyic	Terminó, final.
jadyicĉan	Cabeceras de un río.
jadyicche'	En el ultimo, cumbre.
jadyicve	En el último, al final.
jadyiqui, jadyiĉa'	Ir y volver el mismo rato.
jadyiquis	El último, el fin.
jadyiti	Persona que llega y retornar al mismo día.
jafaijdyi	Le han llamado.
jafaquiti	Persona que se enoja constantemente con otra persona.
jáfi	Frente.
jafiche'	En la frente.
jai'bas	Blanco.
jai'baty, jai'bas	Color blanco o blanco.
jai'daqui, jai'dyete	Azuelear.
jai'daquis	Azuela.
jại'dye'	Enfermedad, utuo, afta, (enfermedad de la boca con manchas blanca).
jai'je'	Dividir, partir (carne).
jaijnas	Rojo.
jaijtyi'	Ave, término genérico.
jai'ñi	Hacha.
jai'si'	Flor estéril, no produce fruta.
jaja'yi	Reír.
jajai'jete	Hablar palabras ofensivas.
jajajai'tyi	Estar riendo (solo subjetivo masculino).
ja'jati	Sufrir de dolor (no plural).
jajav	Mosca pequeña.
jaja'ya'	Más tarde.
jajbu'ye'	Vivir con otra persona.
jajbu'yejaty - jas	Con el que vivimos.
jạjĉoshe'	Dormir con una mujer en su casa.
jajicdyi	Avisar, recoger a una persona.
jajicdyi	Mujer que elige al hombre para su marido.
jaji'ĉujtuyiĉun'ti	Mirar alguna persona que viene.
jaji'pendyi	Se lo convenció, lo derrotó.
jajri	Tener sed.
jajris	Sed.
jajqui	Bostezar.
jajru'	Majo (palmera).
jạjtsi'	Encinta, embarazada.
jam	No.
jam jun'	No, no se puede, imposible.
jamjun'tye'	Que no pudo hacer nada.
jam p̂eyaquity	Mudo, que no puede hablar.
jáman	Playa, arena.
jambi'	Todavía.
jambi'dyem' feshta	Antes de la fiesta, víspera.
jáme	Flor.
jame'ĉhuti	Detener una persona a la fuerza.
jame'ti-ti'	Persona que maltrata a otra persona.
jámi	Florecer.
jámosotuti	Esclavizar, hacer mozo a una persona.
jana'	Dónde.
ja'na'	Chapapa, palo para asar carne.
japac	Caliente.
japacsi'	Caliente (café, té, chocolate, etc.).
japacjodye'	Enfermedad.
japaĉoban'	Estar con menstruación (mujer).
japaĉoij	Enfermarse.
japac joi'	Calentarse.
japjoi'	Hacer de mal olor podrirse (carne, arroz mojado).
jạ'puij	Hacer flexible, suave.
jạ'puty, - pus	Flexible, blando.
jarajrai'tyi	Olor algo hediondo.
jarajras - ty	Podrido, hediondo, de olor feo.
jare'a	Jalea.
jaruj	Clase de fruta.
jásäsdyi -i'	Entender, comprender.
jasha'	¡A ver!
ja'sha	Chivé.
jashajshaij	Oler fuerte, feo.
jato'ti	Penetrar, pinchar.
jatupujti	Lo alcanzó o que le haga exacto.
jạtsa'chuti	Persona que sobrevive de otra persona.
jatŝen'je'	Alzar alas o brazos.
játŝuti	Persona que se contagia de enfermedad.
javqui	Pesado.
javquedye'	Peso.
javquije'	Hacerlo más pesado.
javtaqui	Asar o chapapear carne.
javaqui	Quemar chaco.
jávo	Jabón.
javujna'	Planta como patujú.
jayedye'	Espundia.
jayej	Falta.
jayejyi	Faltar.
jayejjotacdye'	Escasez de algo, estar con necesidad.
jayejjotaqui	Le faltó.
jayi (-i')	Gastarse (objeto o cosa).
jayi, jayi'	Tener espundia o enfermedades venenas.
jayu'ti	Colocar o posesionar alguien.
jeba'badye'	Bufeo (pez).
jebacdye'	Animal.
jébadyeyac	Avisaremos.
jebaqui	Comer algo, como ser tapeque, etc.
jebaqui - i'	Cazado por animal (tigre).
jecactyi'	Comprado, sacado, escogido.
jecajcaque'	Hacer huir a animales.
jecavcaqui	Asustarle, dar miedo hacer huir.
jecaqui	Sacar objeto o cosa de uno.
jectaqui	Sacarle algo de su familiar.
jéĉúnte	Reprender, hacerle alto.
jeĉhe'joij	Estar con los labios sueltos (cansado).
je'chejyi	Boca abierta, de cansancio, borracho, susto.
je'chety	Jetón.
jedac me'	Parece que es así.
jedacĉaij me'	Tal vez.
jedacdye'	Pala.
jedye'?	¿Qué?
jedye' in	Varios objetos o cosas.
jedye' a ĉa	Haber que cosa es.
jedye' ca'?	¿Qué cosa es?
jedye' yi?	¿A qué?, ¿Para qué?
jedye'che'	En qué está.
jedye'che'dyem'	No hay en que (cruzar el río, ir al pueblo, etc.).
jedyedyety dyem', jedyedyes dyem'	Para que sirve, inútil.
jedyedyes	Para qué.
jedyeij	Que tiene, que le pasa.
jedyeijca'	Que le pasó.
jedyetuijbuty	A que vino, a que fue.
jedye'tumtyi' - si'	Persona rica.
jedye'veij -vei'	Que quiere.
jẹjé	¡No ve!
jeijyi	Salir del camino, desviarse, apartarse.
jeijjeyaqui	Apartar del camino algún objeto o cosa propia.
jeijoij	Desviarse del camino principal.
jeijmuñi	Pasar por un lado o desviarse.
jẹjcai'	Seguir la acción, trabajando.
jẹjcai' nash añei'	Sigue lloviendo.
jéjech	Clase de bicho (cigarra).
jejmiti	Preparar alimento (cocinar).
jẹjmuqui	Cocinar algo que es de uno mismo.
jẹjmucsi	Que ya está cosida (comida, plátano).
jejmitidye'	Comida.
jemonjoij	Hundir, taparse con agua, desaparecer de la vista.
jemonaqui, jemoñe'	Necesitar, extrañar.
jen'	Padre, Dios.
jenje'	Carpir o cortar con pala.
jen'tui'	Adorar algo como Dios.
jentute	Tratar como su padre.
jen' yetacdye'	Padrastro, esposo de la madre.
je'na'aquí	Hacer nacer algo, como plantas, hijo, etc.
jen'dyes	Cosas para Dios.
jen'dyety	Tío, hermano del padre.
jentaqui	Carpir.
jen'tucdye'	Padrino.
jeñecdye	El mismo tamaño: lugar, laguna, etc.
jeñecve	En el mismo anchura, extensión como pueblo o lugar del mismo tamaño.
je'ñeij -ñei'	Parecido, parece, en apariencia.
jenej	Parece que es así.
jeñej bu'ban	Que reemplaza.
jeñej qui jam vämtyi'ya' mo'	Como sí no fuera su marido.
jeñejdye yéĉan jụijya'	Debiera haber ido a avisarles.
jeñejjeyaqui cui'si'	Tratarlo como si fuera de el.
jeñejyi'	Sonido parecido de algo.
jeñejqui'	Mismo tamaño.
jeñe'qui'vedye'	Misma anchura.
jéñetaqui-i'	Empeora la enfermedad.
jeñi	Parecer del padre (varón).
jéñi'	Parecer del padre (femenina).
jéñi'	Enfermedad avanzada.
jẹp̂anaqui, jẹp̂ane'	Poner las plumas a las flechas.
jep̂anaqui	Criar un niño.
jepepe	Mudo.
jeque'	Sacar.
jẹrdyij	Fragante.
jerdyij	Estar con tos.
jẹrecdyis	Sabrosa.
jẹrejres	Perfume, pomada de buen olor.
jẹ́rojro'	Mosca.
jesaj	Gusano.
jesec	Demasiado salado.
jesequi'	Salado.
jesha'	¡A ver!
jesha'bi	Vamos.
jesha'bi, ĉocja' quịjodye' yu	Vamos a ver mi chaco (terreno).
jeshajmaqui	Sacar punta, hacerlo puntado.
jeshajmaquis	Máquina para sacar punta, tajador de lápiz.
jeshajte, jeshan'	Venir a llevar a alguien.
jéshan'	Venir a avisar.
jeshocbo'	Espuma.
jeve'daqui	Pescar con red.
jev'je'	Sacar suciedad de la superficie de un líquido.
jev'taqui	Sacar muchos pescados de agua con red.
jéyacsi	Avisar a los de más.
jii'	Madurar.
jị'	Enfriar.
ji'a'c̣hitaqui	Ensuciar o hacer lo fregar algún objeto o cosa de uno mismo.
ji'anicja'ye'	Hacerle creer.
ji'anicja'yete	Hacerlo creer.
ji'añeye'	Hacerlo llover.
ji'mabaqui	Hacerlo engordar.
jíban	Enfría, dejar de enojarse, etc.
jíban'	Enfría, dejar de enojarse, etc.
jibaqui	Aplastar, árbol que cae sobre uno.
ji'basacsis	Partera.
ji'basaqui	Ayudar a su mujer dar a luz.
ji'bä'te	Hacerla sentar a una persona en un asiento.
ji'bä'ti	Vivir en un lugar sin que nadie le diga.
jibej	Trampa.
jibi' momo'	En vano.
jibi'	ĈHUM YI. Envano promete en el comienzo.
jibidyes	Que no es usual.
jibij	Cama, catre.
ji'bijtaqui	Hacer cargar, poner carga.
ji'bijtye'	Cargar.
ji'bijti	Embarcar en canoa, camión.
jibi'yity	Farsante.
jibi'naqui	Farsear.
ji'jiban'	Hacer madurar.
jibitis	Víveres.
jibi've	Andar en un lugar donde no hay animales para cazar.
jibi'ya'je'	Saber de memoria.
jibi'yaty -yas	Hijo nacido afuera de matrimonio.
ji'bojvaqui	Subir lo que es de uno mismo.
ji'bojve'	Hacerlo subir.
ji' mube'	Jalar objeto o cosa.
ji'cacati	Hacerse pasar entre medio de los otros sin que nadie sepa.
jị'cacdye'	Encomienda, encargo.
jịcacsequi	Ir a dejar varias personas.
ji'cajnaqui	Pasar en un peligro, problema.
jiĉav'que'	Hacerla huir (animal o persona).
jicajquiqui	Ir a dejar algo de uno.
ji'caman'ti	Dar vuelta.
ji'cam'te	Hacer callar.
ji'cam'ti	Se calla.
ji'ca'ñe'	Devolver alguna cosa prestada.
ji'ca'ñeban	Hacer regresar, devolver.
ji'caĉan	Mandar encomienda con alguien.
ji'ca'ñeyeban'	Devolver algo prestado.
jị'ĉojcaqui	Encargar una cosa para que cuiden.
jị'caquiĉan	Donde se acostumbra mandar encomienda o dinero.
ji'carijtaqui	Hacerlo trabajar (hijo empleado, etc.).
ji'carijti	Molestar.
jiĉavque'	Hacerlo huir.
ji'cav'caqui	Hacer huir lo que es de uno.
jị'cavaqui	Mostrar lo es de uno.
ji'cave'	Mostrar, hacerlo ver.
jị'caveyaqui	Hacerlo ver, mostrarles a los demás lo es de uno.
ji'caveyacsi	Mostrar milagro, mostrar a otros alguna cosa.
ji'cavintye'	Agilizar.
ji'caviti	Hacer demostración, hacerse ver.
jị'cayaqui	Mandar, despachar con otro.
ji'cächtac	Añadir.
ji'cächtaqui	Añadirle, aumentarlo, hacer más grande o largo.
ji'cädäjtaqui	Hacerla desnudar.
ji'cädäjtye'	Hacerlo desnudar con otra persona.
ji'cän'taqui	Hacer juntar el fuego con otra persona.
jị'cätsaqui	Igualar, emparejar.
jicdyi	Superar en el trabajo o estudio tener éxito.
jicdyi jen'dyes	Crecer, llegar a tener fuerza en el Señor.
jị'ĉocdyes	Letrero, parábola, muestra.
jị'codaqui	Hacer orar, rezar.
ji'ĉocdyety - des	Objeto para muestra.
jị'coijtaqui	Hacer girar o dar vueltas algo propio.
ji'coijtye'	Hacer dar vueltas.
jicoj	Sal.
jị'ĉojcaqui	Hacerlo cuidar.
jị'ĉojcaye'	Mirar de paso.
jị'ĉojtaqui	Probar algo, estrenar.
jị'ĉojtacdyes	Examen, prueba.
jị'ĉojtuyaqui	Mirar venir alguien.
jị'ĉoqui, jị'ĉote	Demostrar, hacer ver.
jị'ĉoshaqui	Hacer dormir.
ji'co'shaye' - yete	Quemar, fundir.
jicotuqui	Echar sal a la carne o comida.
jị'ĉoyacdyes, jị'ĉocdyes	Ejemplo, muestra.
jị'ĉoyaqui	Mostrar, presentar.
jị'ĉojtuyete	Mirar venir a una persona.
jicsin'	Nos recogió.
ji'ĉujcayiti	Que se dio cuenta por algo.
ji'ĉujti	Probar, ensayar.
jiĉun	Recuperar las fuerzas.
jiĉun yụ'tac	Animar, alentar, fortalecer.
ji'ĉushíshiye'	Soporoso, hacerle tener sueño.
ji'ĉushishiyete	Soporoso, hacerle tener sueño.
ji'ĉuti	Demostrar, hacer ver.
ji'ĉhaĉan	Bajar algo lo que es de uno.
ji'chaque', ji'c̣hacte	Mandar hacer sacar algo que está clavado.
ji'c̣hácaqui	Hacerse sacar o arrancar.
ji'c̣hacajquiqui	Fue hacerse sacar (diente, etc.).
ji'c̣ham'dyi	Meterse en algo voluntariamente.
ji'c̣ham'tacsity- sis	Persona que convence a otra persona para participar en una actividad.
ji'c̣ham'taqui	Convencer, conquistar, hacer aceptar.
ji'ĉhañe'	Secar.
ji'ĉhante	Hacer secar.
ji'ĉhanaqui	Secar lo que es de uno.
ji'ĉhanaquity	Secador (alambre, soga o cualquier cosa usado para secar ropa).
jiadaqui	Carpir.
jic̣hjan'	Carpir, chaco.
ji'ĉhai'	Bajar.
ji'ĉhaqui	Hacer bajar lo que es de uno.
ji'ĉhäqui	Sacar aceite de motacú.
ji'ĉhäĉajte -ĉan'	Sanar, curar.
ji'ĉhäquiti'	Entendible.
jiĉhäshe'	Hacer sangrar.
ji'ĉhäshaqui	Hacer sangrar lo que es de uno, derramar sangre.
ji'ĉhäyiti	Estudia.
ji'ĉhäyitidye'	Estudio, enseñanza, doctrina, lugar del estudio (escuela, cuartel).
ji'ĉhäyitity, ji'ĉhäyitis	Estudiante.
ji'ĉhe'aqui	Levantar o elevar de precio alguna cosa.
ji'ĉhetacdye'	Al partido, división.
ji'ĉhetaqui	Repartir alguna cosa de uno mismo.
ji'ĉheteyacsi	Repartir algo que uno tiene a otras personas.
jị'ĉhibaqui	Hacer germinar las plantas.
jị'ĉhicacdye'	Testimonio, aviso, noticia.
jiĉhícaqui - qui'	Hacer lo orinar.
jị'ĉhịcaqui	Avisar, hacer saber, conocer.
jị'ĉhicaquis p̂eyacdye'	Título (del libro).
jị'chi'eban ojñi'	Dejar o esperar que baje el agua (antes de viajar).
jị'ĉhiyacdye'	Enseñanza.
jị'ĉhiyacsity - sis	Maestro, profesor.
jị'ĉhiyactyi'	Discípulo, apóstol.
jị'ĉhiyaqui	Hacer estudiar o educar.
ji'ĉhojti	Bautizarse.
ji'c̣honĉhuti	Se hizo escapar de alguna comisión.
ji'c̣honaqui	Hace escapar o salvar.
jị'ĉhu'aqui	Criticar, reprender.
jị'c̣huaqui	Llenarse de mentiras o chismes.
jịchuchu	Martín pescador más pequeño.
ji'c̣hu'c̣huyaqui	Hacer callar, sacar el motivo de las quejas.
ji'c̣hu'c̣huyiti	Estar callado, no hablar.
jị'ĉhui'taqui	Mostrar camino verdadero, decir la verdad de una cosa.
jị'ĉhui'taquis	Brújula.
jị'ĉhui' yụ'taqui	Corregir.
ji'ĉhuqui	Hacerlo agarrar o pelear.
ji'ĉhui'	Hacer lo usar algunas cosas.
jidacaqui	Hacerlo pasar hambre o no dar de comer, hambrear.
ji'dacdyi	Ser hallado.
jịdaqui	Carpir.
ji'daijte	Hacer multiplicar.
ji'dayaqui	Hacer multiplicar, criar animales.
ji'deveyiti	Deber, tener cuenta.
ji'dujraqui	Hacer hinchar la barriga o madurar la masa de harina.
ji'dujraquis	Levadura.
ji'dyäcaqui	Dar alojamiento o hacer parar alguna actividad.
jídyedye'	Tiempo de fruta madura.
ji'dyijviti	Pensar en algo para acordar.
ji'dyijvitidyes	Conmemorativo.
ji'dyijviva'ti	Pensar de algo sucedido.
ji'dyijvacdyes	Celebración, conmemoración.
ji'dyijvaqui	Conmemorar.
ji'dyisaqui	Hacerlo reír a algún familiar o otra persona conocida.
ji'dyiste	Hacer lo reír a alguien.
ji'dyuqui-qui'	Hacerlo bañar (hijo, etc.).
ji'ena'maqui	Hacerlo lamber alguna cosa.
jị'fajcaqui	Enojarse por una cosa.
ji'fajque'	Enojarse de algo.
jị'fajqueyaqui	Enojarse de algo.
ji'fajquiyitiĉa'	Nos hacemos enojar de una cosa.
ji'fayaqui	Hacer llamar a algún familiar o persona conocida.
ji'fercati	Hacer ejercicio, entrenar el cuerpo para deportes.
ji'fercaqui a' mu'in	Ellos entrenen su cuerpo.
jifi	Ventosear.
ji'focoyacsis	Lo que hace podrir.
ji'focoyaqui	Hacer podrir algo.
ji'foquin'taqui	Hacerlo montar animal.
jifrity - ris	Liviano.
jịfrij	Quedó liviano.
jii'dye'	Pase de una tranca.
ji'ujacdyes	Reservado para carnear.
ji'ujacdyi	Hacerse matar (como en guerra).
ji'ujaqui, ji'ujate	Hacerlo matar.
ji'ujati	Hacerse matar.
ji'jiija'	Pasemos.
ji'taqui	Tiempo de maduración de frutas.
jịj	Puga de insectos.
jijan	Pasó en una tranca.
ji'japacti	Calentarse junto al fuego o jugando pelota.
ji'japactaqui	Hacer calentar motor.
ji'jaye'	Gastarlo.
ji'jayaqui	Hacerlo gastar.
ji'jämaqui	Curar o sanar alguna herida.
ji'jämaqui	Obtener buena producción agrícola.
ji'jä'naqui, ji'jä'ñeja	Encender: fuego, lámpara, motor, etc.
ji'jäcaqui	Hacerse sacar alguna cosa o pronunciar palabra.
ji'jäm' yụ'tacdye'	Arreglo, solución de problema.
ji'jäm' yụ'taqui	Hacer arreglar o componer alguna cosa u objeto.
ji'jäsaqui	Hacer, preparar chicha.
jijcai'	Se fue con otra persona.
jịjcaqui	Acompañar algún familiar o persona conocida.
jịjcataqui	Seguir ejemplo lo que hace otras personas.
jijĉhacaqui	Corretear hasta alcanzarlo.
ji'jebeyaqui	Dar comida, hacer comer.
ji'jäcaqui	1. Hacerse sacar algo 2. Pronunciar algunas palabras nuevas.
jịji'	Coquino, árbol o fruta silvestre.
ji'jibaqui (ji'jipte)	Aplastar por un árbol algún objeto o persona.
jị'jiĉan	Hacer enfriar una máquina o cualquier objeto caliente, apaciguar.
ji'jiĉan	Hacer madurar fruta.
ji'jimacaqui	Hacerle cantar, funcionar (radio).
ji'jimacte	Hizo cantar a otra persona.
ji'jimaque' radio	Hacerla tocar la radio.
ji'pa'ca'cayiti	Refrescarse en la sombra.
ji'jiqui	Madurarlo, listo para comer o cosechar.
jị'jiqui	Ir a enfriar comida o algún objeto caliente.
ji'jiyaqui	Dejar de pasar, paso libre.
ji'jiijja	Hacemos pasar.
ji'jiye'	Lo hizo pasar alguna cosa.
ji'jiijte	Lo hizo pasar.
ji'jiijme	Déjelo que pase.
jijmo'moj	Manantial de agua.
jijmu'se'	Esconder.
jijmu'saqui	Esconder, tapar cosa para que nadie lo vea.
ji'jónaqui	Hacer le hueco alguna cosa que es de uno.
ji' joban' - te	Despachar persona.
jị'jobaĉan	Despachar algún familiar de uno mismo.
jị'jo'chaqui	Hacer caer algo propio.
ji'juban'	Total lo que producía en el año.
ji'juchayiti	Hacerse pecar, tentar.
ji'juntaqui	Calentar al fuego algún objeto de uno mismo.
ji'juntye'	Poner cerca del fuego.
ji'jun'taqui	Dar un oficio a una persona.
ji'jun'taqui	Hacer lo plantar un poste.
ji'juntaquis	Objeto que sirve para calentar algo.
ji'junti	Calentarse en el fuego.
jị'jutaqui, jị'jutyete	Hacer descansar un rato.
jị'jutyiti	Descansar.
jị'jutyitidye' mạyedye'	Día de descanso.
jị'ma'aqui, jị'ma'e, jị'ma'ete	Hacer sonar, tocar instrumento, dar más volumen al radio.
jimacdye'	Canto, himno, culto.
jimacdye'ĉan	En el culto, en la iglesia.
jimacdye'ĉan tsun	Vamos al culto, en la iglesia.
ji'majmayaqui	Hacerlo jugar a algún familiar.
ji'ma'jotaqui	Hacerlo alegrar a alguien.
ji'ma'jotyiti	Alabarse uno mismo.
jimaqui	Canta.
jimaĉa'	Cantemos.
jimacva'joi	Cantando.
jimja'	Cantemos una canción.
jị'marayaqui	Hacerla enflaquecer (persona, animal).
ji'ma'yaqui	Animar, hacer feliz.
ji'maaqui	Hacer sonar, tocar instrumento.
ji'menaqui	Hacerlo tardar, atrasar, ir más despacio.
ji'me'siyaqui	Terminar, concluir.
ji'me'tacdye'	Denuncia.
jime'taqui -tyeja	Denunciar, demandar, condenar a alguien.
ji'meti	Entregarse, rendirse (a la autoridad).
ji'me'tyeyaqui	Discutir con alguien por algo.
jime'ye'	Suicidar voluntaria por algo.
ji'me'yiti	Suicidarse, persona que voluntariamente quita la vida.
ji'mi'aqui	Hacerlo andar, ayudara un chiquito dar pasos.
ji'miyaqui	Hacer senda, camino.
ji'micdaqui	Hacer santificar, comportarse.
jimij	Caballete de casa, edificio.
ji'mincaqui	Vender algo que produce.
ji'me'te	Traicionar, denunciar.
ji'moc̣hayaqui	Hacerlo crecer largo.
ji'monaqui, ji'moñe', ji'monte	Lo extravió, perdió.
ji'monsin'	Nos perdió, nos hace equivocar.
ji'muñe', ji'munte, ji'munsin'	(Palabra usada para referir al cocojsi' hechicero) transformar, hacer milagro.
ji'munuyaqui	Amutar algo filo.
jị'muqui	Cocer algo como: comida y otros.
jị'muquis	Cocina.
jin	Hueso.
ji'na'aquí	Vivir o estar con una persona melancólica o un chico exigente.
ji'na'aquí	Hacer nacer una cosa nueva.
ji'nabaqui	Echar gallina a empollar, encubar.
jinac	Arroyo.
jị'naijcaqui	Esperar hasta que amanece.
jị'naijtaqui	Hacerlo ver algo, mostrar.
ji'naijbun	Aparecer después de mucho tiempo.
ji'naijti	Serviste.
ji'na'iti	Persona exigente.
jijchacaqui	Corretear, perseguir alguien de la familia.
jíno	Ano.
jị'nobaqui	Hacerlo cruzar rio.
ji'nopjudyiĉam'	Hagan nos el favor de cruzarnos.
ji'no'baqui - beja	Hacerlo cansar.
ji'noi'quete	Asustar, dar miedo.
ji'ñäbaqui'	Animal que está dispuesta a tener relaciones sexuales.
ji'ñäbe', ji'ñäpte	Hacerlo hinchar.
ji'ñäpsin'	Hacernos hinchar lo que nos pica (peto).
jị'ñäbeyacsi	Contagiar enfermedad a otros.
ji'ñe'te	Convulsionar, dar ataque (epilepsia);
sọyo' ji'ñe'ete	Lo convulsionó el demonio.
jị'ñäbaqui'	Animal que está en sélo.
jị'ñibe'caqui	Hacerlo sufrir, castigar demasiado.
jị'oque'	Que ensucia.
jị'ocja'	Ensuciamos.
ji'paca'cayibun	Persona que se refresca en la sombra.
ji'paca'cayibujsha'	Refrescarnos en la sombra.
ji'paca'cayiti	Refrescar, aliviar (del calor).
ji'pacajtaqui	Aliviar, consolar.
ji'pai'que' - queja'	Desparramar.
ji'p̂ai'caqui	Hacerlo subir o bajar de un vehículo, canoa, etc.
ji'p̂anacdye'	Criado.
ji'p̂añe', ji'p̂ante	Hacer criar como hijo.
ji'p̂ashe'	Fermentar.
ji'pechte - che'	Hacer hundir cosa u objeto.
ji'penacdye'	Derrota, prueba.
ji'penja- ja'	Lo derrotamos o ganamos una justicia.
ji'pente-ñe'	Lo venció, lo derrotó.
ji'penac	Derrotar, ganarle algo.
ji'pen'ti	Defender.
ji'pen'ti p̂eyacdye'ya'	Defender con palabras.
ji'pen'tidyes	Arma o otra cosa para defenderse.
ji'p̂eyaque'	Hacerlo hablar.
ji'piñituti	Hacerse curar.
jị'pi'tsuyaqui	Ablandar, poner blando o flexible alguna cosa.
ji'p̂o'chiti - ti'	Tener tratamiento inyectable.
ji'p̂o'chti	Hacerse inyectar.
ji'poijque'	Disolver, derretir.
ji'puijdayaqui	Dejar polvo.
ji'p̂uijdaye' jac	Hacer polvo la tierra.
ji'p̂uti	Ahogarse en el agua.
jip̂ujtye'	Hacer inflar.
jiputaqui	Masturbar (varón).
jịquei'	Se enfría.
jị'jịqui	Hacer enfriar.
jíquei'	Desmayado, listo a morir.
jiquej	Muestra el pasado, "había sido".
jíquej jadyiqui- qui'	Estuvo desmayado.
jiquej yi	Desmayar.
ji'quepti-ti'	Hacerse sacar foto.
ji'quepte	Hacerle tomar foto a alguien.
ji'queptaqui	Hacer sacar foto Ej: Hijo, nietos, etc.
ji'querechayaqui	Hacer ganar plata.
ji'queveye'	Hacerla buscar algo.
jíquin	Ir a avisar.
jiquique'	Fue a dejarla.
jiquicte	Ir a dejar una persona.
jicajquiqui	Ir a dejar algo de carga.
jị'quiqui, jị'quite	Hacerla vestir.
jị'qui'i', jị'quija'	Vestirla.
jiquiyecte	Dejárselo algo a alguien.
jiquiyeĉajte, jiquiyeĉan', jiquiyacsequi, jiquiyacseĉa'	Ir a dejárselo algo a una persona o a varias personas.
jiquiyeĉajte pe're	Ir a dejárselo plátano.
ji'rä'aquí	Terminar todo.
ji'räsh yụ'taqui	Ponerlo erecto.
ji'rébaqui, ji'rebeja	Ir a encontrar a alguien que viene.
jirijriij	Oler feo, olor de puerco de tropa.
jị'ruijtaqui	Hacerle decir la verdad.
jị'sa'	Humo.
jị'saij - sai'	Que humea.
jị'sajsai'	Neblina.
jị'sájsaij -sai'	Oler a humo.
ji'sáñeyaqui	Hacerle escribir.
ji'sáñiti	Inscribirse, presentarse al cuartel.
ji'sei'taqui	Safar, circuncidar.
ji'se'jeyaqui	Hacer, convencer o animarlo.
ji'se'vaqui	Escucha.
ji'site'	Lo hace entrar.
ji'sisja	Lo hacemos entrar.
ji'site', ji'siste	Lo hace entrar.
ji'sisye	Te aré entrar.
ji'säsunac	Los hizo entrar.
ji'sässin'	Nos hizo entrar.
ji'säsdyiĉa'	Nos hacemos entrar en una actividad.
ji'säsdyi -dyi'	Que entra en una actividad.
ji'säcsac, ji'säcse', ji'säcsete	Alimentarlo, darle de comer.
ji'säñéja	Anestesiar.
ji'sästi	Integrarse al grupo.
ji'sitaqui	Dar permiso para entrada o introducir una cosa.
ji'shapuye'	Hacerla enloquecer.
jishdyiti-ti'	Peinarse.
jishdaqui'	Peinar a alguien de la familia.
jishdyisin'	Peinado por otra persona.
jịshin'je'	Quemar cabello.
jishi'shiij- shii'	Estar medio borracho.
ji'shuc	Sobra.
ji'shuque'	Que sobra.
ji'shucdyi'	Lo que sobrar.
ji'shucdyidye'	Sobra.
ji'shucaqui	Hacer aserrar con otra persona (madera).
ji'shu'caqui	Hacerlo emborrachar.
ji'shu'queja-a'	Nosotros lo hacemos emborrachar.
jishujsin'	Viene a llevarnos.
jishun'	Vuelva a llevarme.
ji'shupque'	Saca r afuera alguna cosa.
ji'shupte	Sacar afuera a una persona.
ji'shuptiñe'	Ustedes lo están haciendo salir.
jítacdyi'	Avísame cuando salgas.
jitajquiti	Venir a dejar alguna cosa.
jítaqui, jítaĉa'	Tener muchas plantaciones para cosechar.
ji'taraqui	Entristecer.
ji'tashdyi	Guiar, adelantar.
ji'tashiti	Ir adelante.
ji'tashja-ja'	Mandar adelante.
ji'tätsaqui	Acortar un compromiso o contrato.
ji'tä'tsiti	Hacer recortar cabello.
ji'ti aquí	Nombrar, poner nombre.
jítidyeij- dyei'	Avisar uno al otro.
jitishajte	Vino a dejarlo.
jitishan'	Vino a dejarla.
ji'toco'taqui	Que se deja tocar.
ji'toco'taqui'	Que se deja tocar, o manosear, (sentido sexual).
ji'tofeye'	Hacerlo encegar.
ji'tomaqui	Hacerlo tumbar en el agua algo propio.
ji'tome'- tomte	Hacerla ahogar, o caer al agua.
ji'tom'taqui	Poner o echar remedios por gota en el ojo o en una herida.
ji'to'ojcạti	Llegar a ser tonto flojo.
ji'to'ti	Se logra avanzar.
jitu'baqui	Estar botando algo.
jitupje'	Botar algo.
ji'tuqui	Mandar algo con alguien.
ji'tututi'	Traer consigo.
ji'tui'	Mandar con alguien.
ji'tuyaqui	Mandar con otra una encomienda para alguien de su familia.
jijtsaebajte	Resucitarlo.
jị'tsa'aquí	Despertarlo.
jitsaqui	Animal que busca alimento para su subsistir en el frio.
jitsaqui	Morder algo propio.
ji'tse'aquí	Reproducir, crecer, extender.
jị'tsicaye'	Hacer avergonzar.
ji'tsicayin	Te hizo dar vergüenza.
ji'tsi'yaqui'	Mamar, dar de chupar.
ji'tsivujtye'	Enfriar.
jị'tsivujtaqui	Enfriar algo propio.
jị'tsivujtaquis	Heladera.
jị'tŝoqui, ji'tŝun	Lograr, acertar, hacer caer.
ji'tŝuyinac	Contagiar.
ji'tyäpe'	Callar.
ji'tye', ji'tyequi	Hacerlo tomar.
ji'tyeja	Hacerlo beber.
ji'tyete	Hacer tomar, convidar a tomar.
ji'tyuqui	Hacer tener relaciones sexuales.
ji'tyuyete	La mujer entrega al hombre hacer relaciones.
ji'tyuti', ji'tyuyisin'	Hacer tener relaciones sexuales, tener relaciones sexuales.
ji'ujaqui	Hacerlo matar.
ji'unaqui -ñeja	Hacer trabajar.
jịva'chai'	Tumbar (palo, animal, etc.).
ji'vai'ñe'	Hervir.
ji'vanchui'	Hacerlo abrir: cartón, maleta.
ji'vämacsity	Oficial registro civil.
ji'vämaqui -meja	Casarse, hacer casar.
ji'venaqui, ji'veñe', ji'venjan	Acarrear.
ji'ventucsity	Brujo, hechicero que llama a los difuntos.
ji'ventuqui	Hacer llamar (especialmente se refiere a los difuntos).
ji'vei'	Ponerle carga (persona, animal).
jivin	Pasto cortador.
ji'vorvete -ve'	Llamar, mandar a llamar.
ji'yacĉhuyaqui	Hacer dejar, hacer salir.
jiya'dyeye'	Pagar.
jiya'dyeyaqui	Pagar (persona, deuda).
ji'yajcati	Dejarse quedar en el medio camino.
ji'yajtuti	Quedar (cuando está de venida).
ji'ye', ji'yeja	Imitar, remedar.
ji'yaquintuqui	Hacer olvidar.
ji'yäjcaqui	Haber endurar algo propio.
yäjqueja'	La enduramos.
jiyi	Pasó.
jiyi'	Ocurrió, sucedió.
jiijja'	Pasamos.
jii'dye'	El pase (puente, tranca).
jiyicdyij -dyi'	Fragante, de buen olor.
jiyi'dye	Se pasó (del tiempo).
jiyis yómodye'	Año pasado.
jiyi'si', viyadye'	Apellido.
ji'yocaqui, ji'yoquete	Extrañar, entristecer.
ji'yomoyaqui -ye'	Esperar: la noche, oscuridad.
jịyu'taqui	Encargar algo.
jịyu'tyeyete	Se lo encargó.
jịyu'tac	Encargar.
jiyutyiti	Hacerse pisar por un vehículo, carretón, etc.
ji'äjdyiyaqui	Hacer lo gritar.
jo'	Águila.
jọban' ịvaj	Luna nueva.
jọban	Se fue.
jọbajsha'	Vamonos.
joboboj	Cargado de algo como: ser en canoa, camión, carretón, etc.
jopje'	Poner en algo (bolsa, etc.).
joc	Carnada.
joco'co'	Planta de vainilla.
jọcoyoj	Garza blanca.
jọ'chaij	Se cayó.
jọ'chaja'	Nos caímos.
jochboij -boi'	Tener espundia en la nariz, estar con la nariz pontuda.
joi'je'	Servir algo líquido.
joi'taqui, joyaqui	Servir comida, bebida.
joi'dyi, cordyi	Remar.
joijno'	Bebe, hasta 4 o 5 meses.
jojdoij	Estar hueco.
jojdojdoij -doi'	Con huecos.
jojdojdos	Hueco, agujero.
jojoi'	Verde, no maduro.
jojoi' na'ij- nai'	Aborto.
jo'meij, jo'mei'	Parecido, de color, apariencia.
jo'meijdye	Parecido.
jo'mei'tyi	Varios objetos parecidos.
jo'me'quequeij	Alistarse, ponerse en actividad, actuar cuando uno está preocupado o en pánico.
jo'mety -mes	Así como esto.
jo'na	Comida (sopa de plátano).
jo'naij	Hacer locro.
jonajnaij	Tener olor a comida.
jonayeja'	Cocinaremos.
jónaqui	Desvío del curso del río.
jónaqui	Violar.
jo'no'	Cabeza.
jonocjeyaqui	Horadar, agujerear algo propio.
jonodye'	Pus, materia.
jo'nodyes	Remedio para dolor de cabeza.
jopje'	Embolsar, embarcar.
jopo'naqui	Pez que boquea.
joquin'je', joquin'yi	Montara caballo.
jọrọ	Lira.
joro'ĉo	Clase de fruta como pachió.
jorojĉan	Visible, entendible, conocido.
jorojĉanje'	Mostrar, hacer visible, hacer conocer.
jorojya'	Estar afuera de la casa.
josir	Fusil.
joshojje'	Golpear, aplastar a golpe.
joyaqui	Sacar en un vaso algún líquido.
joyo'daqui	Desaguar canoa.
joyo'daquis	Vasija para desaguar (una canoa, etc.).
juban', ji'juban, ja'yeban'	Bastante cantidad de algo.
jubij	Cama, trastes.
jucñuij	Velloso, cabelludo.
jucshuij	Barbudo, bigotudo, con muchos pelos.
jucshui'tyi'	Barbudo, peludo.
juchaij	Pecar.
juchayeja'	Pecamos o cometemos un gran error.
juchaj	Pecado.
juchajtumtyi' -si'	Pecador.
juchatute	Pecar contra otro.
juchujmaqui	Zunchar, punzar.
juchujme'	Punzar a un hueco.
jụdyej	Si, bien, está bien.
judyeya'	Y, después.
jufiti	Calentarse en el sol o al fuego.
jui'buty, jai'baty	Blanco.
jụij	Nariz, hocico.
jụijche'	En la nariz.
jụijya'	Con la nariz.
jụjje', jụjyi	Lo recibe o acepta.
jụj ja'yete	Ganar, convencer de algo.
jụjjeĉúnaqui	Recibir o aceptarla.
jujmuij	Esconder.
jujnaqui	Calentarse.
jụjtaqui	Lo acepta.
jụjtyeja	Aceptamos.
jumĉan, jumve	Escondido.
jumejjeyaqui	Encerrar, cerrar, tapar.
jumij	Caballete.
jumje'	Esconder.
jumyi	Esconderse.
jijmu'se'	La escondió, lo ocultó.
jun'	¿Qué?
jun' a ĉa	¿Como será? (dudando).
jun' a caty me'	Frase que expresa desaprobación.
jun' buca'	¿Como será?
jun' buty	¿Como es?
jun' bu'yi'	¿Como fue?
jun' ca'	¿Qué pasó?
jun'ca'mi	¿Qué te pasa?
junĉhui'	Calentando.
jun' da' bo o	¿Como será?, significa que no acepta.
jun' dash	¿Porque?
jun' qui	y ¿Cómo?
jun' qui', jun' quity	¿Que tamaño es?
jun' ra'	¿Como será?
jun' to' ca'	¿Que le pasó? (Femenina).
jun' tyu' ca'	¿Que le pasó? (Masculino).
juna'	Donde, donde está.
juna'dyem'	¡De donde!
junaqui	Plantar horcones.
junatyi', junasi', junaty, junas	De dónde es.
jun'dyeya'	¿Cuando?
jun'dye ba'	Como es siempre, como era su costumbre.
jun'dyem'	No, ni un poco.
jun'dyeya'dye	Desde cuando.
jun'dyij-dyi'	Cómo está el sabor.
jun'je'	Hacerle, dañarle.
jun'jeja'dyem'	Imposible, una situación que no podemos cambiar o realizar alguna actividad.
junjoij	Sudar, transpirar.
junjos	Sudor.
jun'si'	Cuando.
jun'si' ra' ĉụi'	En cualquier momento.
jun'tacdye'	Cualquier oficio o trabajo.
jun'taqui	Hacer algo.
jun'taquidyem'	Que no hace nada.
juntacsidyem'	Dejémoslo, que no sirven para nada.
jun'tityu ụ in	Que hacen entre ellos.
jun'tum	¿Cuántos?
jun'tum qui'	Cuantas veces hiciste.
jun'yi	Como hizo.
jụ'ñiij, jụ'ñii'	¿Cómo es?, ¿como está?
jụ'ñis	¿Cuál es?
jụ'ñis (-ty) ĉụi'	Cualquier.
jụ'ñisĉan	En cual o en donde se encuentra un objeto o cosa.
jụ'ñity -ñis	¿Cual?
jun'je'	Plantar (palo, planta, etc.).
jun'taqui	Plantar poste, horcón, etc.
juñucsi'	¿Cuántos?
juñujñuij	Tener calor.
juñujñus	Calor.
juñum	Cubierta, tapada.
juñum bu'yi	Estar cubierto.
juñumchuquis	Impedimento, límite.
juñumchuquity	Cortina.
júparej	Avestruz, piyo.
ju'saqui	Olfatear, oler.
jushu'je'	Que calienta algo.
júshu'taqui	Calentar algo propio.
jushu'shuij	Caliente, ropa caliente, etc.
jushu'shui'	Agua que está tibia.
jutac bu'yi	Acecha, hacer emboscada.
jutacdye'	Mandato, carta mandada.
jutacdyety	Persona que es utilizada para realizar lo mandado.
jutactyi'	Comisionado, mandado.
jutaqui	Mandar.
jutiru	Pez, bagre.
jutsjeyaqui	Asar, poner al fuego.
ju'tsuij	Que se está asando.
jụ́tyes	Respiración.
jụ́tyi	Respirar, descansar.
jụ́tyiĉan	Nariz, ventana de la nariz.
jutyu'ĉa	Vamonos.
jutyu'ĉa!	¡Vamos!
juyaqui	Defectuoso de nacimiento, mudo, con deformidad.
juyu'tyeñej	Oso de los cerros.
jäbäj	Pulgar, dedo mayor del pie y de la mano.
jäbän	Seis.
jäĉan'si'	Restar (usada en matemática).
jäcaqui	Sacar, restar.
jäcaquis	Instrumento para sacar algo.
jäctaqui	Sacar, comprar algo de un familiar.
jäcmäty	Persona sin diente o algún objeto que le falta un pedazo.
jäĉhä'je'	Dejar destapado.
jä'ĉhäij -i'	Recipiente vacío.
jä'ĉhäs	Vasija, bañador.
jä'dyäijdyety tsun	Tarde, por ponerse el sol.
jä'dyäij-dyäi'	Alumbrado.
jädyen'yi	Brillar, reflejar.
jäi'	Yerno, nuera, la relación de suegra a la nuera o al yerno.
jäijnäjyi	Enojarse y ponerse la cara roja.
jäijnäs -näty	Rojo, colorado.
jäijnäty	Billete de 100.
jäijni	Colorearse.
jäijve, jäijvetaque	Al lado de algo.
jájä	Animal pequeño parecido al melero.
jän'jän'yity	Tartamudo.
jän'jän'yi p̂eyaqui	Tartamudear.
jäjäbä	Dueño mitológico de animales silvestres.
jäjäjäi''tyi'	Riendo mujer.
jäjäm'tum	Despacio, lento, con cuidado.
jäjämun	Cosas buenas, lindas.
jäjyij-yi'	Gritar.
jäm'	Bueno, bonito, lindo, sirve, útil.
jäm' bä'yi	Vivir bien de salud o moralmente.
jäm' bu'yi'dyes aca'	El base de la casa.
jäm' jishdac	Bien peinado.
jäm' yụ'tacdyedyes	Repuestos.
jäm' yụ'taqui	Componer o guardar.
jä́me'	Persistir, hacer continuamente.
jäm'ĉan	Estar en el lugar bueno.
jäm'ĉhubun	Alistarse para el viaje.
jäm'ĉhuqui	Tomar control de uno, retener.
jäm'ĉhuti	Acomodarse.
jäm'dye mi	¿Cómo está?
jäm'dyeya'	De vez en cuando.
jäm'dyij- dyi'	Rica, sabrosa.
jämejje'	Cerrar, tapar.
jämij	Hacer, formar, crear.
jämi	Hacer varias veces.
jämi"taqui	Arreglar, alistarlo, acomodar bien.
jä'mii'tyi -tyi'	Estar listo, preparado.
jä'mij	Adelantar, ir primero.
jä'mijdye	Antes de que algo pasa.
jämi'miij -mii'	Recuperar, recobrar ánimo, fuerza.
jämijmij'	Huele lindo, de buen olor.
jämi'taqui	Alistar algo, acomodar.
jämi'ti	Alistarse, acomodarse.
jäm'ja'yaqui	Hacer bonito, bueno.
jämjan, jämjajsha'	Sanar herida.
jäm'jeĉúne'	Recibir, encontrar con respeto, con cariño.
jäm'jeyaĉan	Reconciliar.
jäm'jeyaqui	1. Guardar 2. Tratar con respeto 3. Satisfacer.
jäm'jiti	Ser reconciliado.
jäm'tac	Elaborar algún trabajo u otra cosa.
jäm'tacdye'	Monumento.
jäm'taqui	Hacer, fabricar, construir.
jäm"tui'	Lograr satisfactoriamente.
jäm'yedye'	Bondad, benevolencia, rectitud, virtud.
jäm'yedyes	Adorno.
jäm'yi	Bueno, ser bueno, ser arreglado.
jä'naqui	Barrera, obstáculo que impide pasar.
jän'jän'yi	Tartamudear.
jänjänyi	Con fiebre.
jänjoij	Escaldar.
jäñä'	Llama, brasa de fuego; maquina que está encendida.
jäñäc	Pierna, muslo.
jä'ñi (-i')	Encenderse, arderse.
jä'ñi ĉojtyi'	Turbado, enojado, pensar hacer mal.
jäp	Sobrina, nuera (relación con su suegro).
jäqui', jäqui've	Después, atrás.
jäquity -quis	Último, el menor.
jäqui'ves	La de atrás.
jäsdye'	Helape (fabricación de chicha).
jäsi'	Hacer chicha.
jäshajte, jäshan'	Venir a llevar a alguien.
jätäjyi	¿Que dice?
jätäjjete	Que es lo que le dice.
jätäjyidyem'	Que no dice nada, imposible, sin solución.
jätaĉan	Venir a llevar algo cosa personal.
jäti	Tener frío.
jätis	Frente frío, sur.
jätisve	Dirección del sur.
jätsä'ñe'	Rascarse algo.
jätsän'je'	Rascar.
jätsin	Te mordió.
jätstiĉa'	Nos mordimos.
jäye'	Abuela, nieto, nieta: la relación entre ellos.
jäyem'	Palabra vulgar: teste.
mabej	Gordo.
mabety -bes	Gordo.
mabij	Engordar.
máchichi'	Garrapatilla.
machitu	Machete.
mạ'edye'	Sonido, eco.
mạ'edyes	Música, instrumento de música.
mạij	De día.
maijyi	Alumbrar.
mạ'ij	Que suena.
mạijchuqui	Estar alumbrando algo de uno.
mạijchuja	Alumbrándolo.
mạijquedye'	Luz.
mạijdyem'	Temprano, casi de noche.
mạijjeyaqui	Alumbrar algo de uno.
mạijyi	Alumbrar.
mạijyis	Linterna, luz.
mạijyity	Luz, lamparita.
maj	Hondo, mucho líquido.
maj añei'	Llovió mucho.
majdye'	Remanso, lugar hondo en el río, etc.
ma'je'	Quiere.
mạ'jejcacaqui, mạ'jejcacai'	Seguir queriendo más.
mạ'je' muju'cha'	Que la quiere mucho.
mạ'jeyacdyes	Querida, amada.
mạ'jeyacdyety	Querido, amado.
mạ'jeyaqui	Querer, desear, amar.
mạ'jitidye'	Amor.
majmadye'	Juguete, juego, apodo.
majmaij -ayeja'	Jugar, chistear.
majmatuqui	Hacer la jugar, chistear, burlar o vender barato alguna cosa.
majmayaquity	Uniforme, ropa deportiva.
majmi	Camino, senda.
majmiij, majmii', majmiyeja'	Hacer camino.
ma'joij	Contento, gozoso, alegre.
ma'jotye'	Alegrarse, estar contento de algo, estar complacido de algo.
majya'taqui	Llevar, poner en lo hondo del rio alguna cosa o canoa.
majyedye'	Tiempo de agua, llenura.
majyi	Subir el agua, llenarse.
mana'i	Motacú.
mạnaqui, mạnja', mạn'dyi	Encender fuego.
mạ́ra'	Costilla.
mạra'se	Varacachi.
mạra'	Flaco, persona o animal sin gordura.
mạraĉa	Naranja.
mạradye'	Palabra de cariño para hablar al hijo (sobrino).
mạraij	Enflaquecerse.
mạraty-ras	Flaco.
mạ́rata	Perdiz de la pampa.
marípi	Mate.
mạrei'	Gusano.
ma'se'	Clase de árbol.
mashadye'	Brujería.
mashaij	Hacer brujería.
mạyedye'	Día, cielo.
mạyedye'che'	En el cielo.
mạyeij, mạyei'	Claro, de día.
mạyes	Luz.
me'	Así, de esta manera.
me' bu'yeti	Vino por un rato.
meme' qui	De esa manera.
me'qui'	Ese tanto, tiempo largo.
me'ra'	Será así.
me'vu'ca'	Ojalá.
me'ca'	Así.
mécacaj	Por pedazo.
me'ĉandye	De esa forma.
me'chuqui	Que detiene.
me'dye	Así, seguir así.
me'dyes qui	Por eso, desde entonces.
me'dyety	El ultimo.
medyety	Para eso.
meij	Apartarse.
meij jịjcaij	Que esta de ida.
meij qui	De esta manera.
meijjetyete- tye'	Quitar.
meijje'	Apartar, anular.
meijyi	Apartarse, separarse de algo.
meijtaqui	Apartar alguna cosa que es de uno mismo.
meijtuqui	Dar una vuelta.
meijya' yi	Hacer lance, ir de un lado a otro.
mej	Tábano.
me'je'	Que realiza algo.
me'yi	Que hace así.
meme'	Tortuga, peta de agua.
me' qui	Por eso.
me'meyejoij	Seguir andando, seguir haciendo cosas.
men	Tarda, mucho tiempo.
mendye	Más tarde.
mensi'	Un tiempo, rato largo.
menya'	Media noche.
meñi -ñi'	Tardarse.
meñi'ñiyeti	No tarda mucho.
méqui'	Así de esta manera, ni un poco.
me'qui'dye, me'qui'	Final, terminado.
me'qui'muntyi'	Contemporáneo, de la misma edad.
méqui'mun	De ese tamaño.
méquity -quis	Mediano, de este tamaño  (señala con la mano).
mequi've quịjodye'	Chaco pequeño, media hectárea.
mereshje'	Rayarse la piel con algo.
meriq̂ue	Piña.
me'si'	Esa cantidad, en número.
mesh ĉaij	Así es.
me'taqui	Que siempre hace así.
me'taqui	Que hace relaciones sexuales.
me'taquis p̂en, me'taquity son'	Adultera(o), prostituta.
me'tiĉa'	Hagamos relaciones sexuales.
métudye'	Tábano negro.
me'yi	Que hace así.
mi	Tú, vos.
miba'	Tu era.
mibaqui'	Empollar.
mic	Vituperación, regaño, (lo trató).
micdaqui	Evitar (algo, tabú o prohibido), privarse de algo.
micdyi, micdyiĉa'	Hacer en moderación, prohibirse de contacto sexual, ciertos alimentos, etc., cumplir los tabúes.
micdyidye'	Tiempo de prohibición.
mi'edye'	Cañada, arroyo.
mi'edye'	Caminata.
mi'ij-i'	Caminar, andar, (agua que corre).
mi'in	Ustedes.
mịj	Camino, senda.
mij	Piedra, roca.
mijam	No, ni.
mijmama	Caimán.
mimitjoij	Endurar, espesar rápidamente.
minacdye'	Soga.
minaqui	Hacer cuerda para arco.
miqui'	Poco, poquito.
miquity	Pequeño, chiquito.
miquis	Pequeña, chiquitita.
miqui'ya'	Corto.
miqui'yai'	Más corto, o bajando.
misij	Calumniar.
míshi	Gato.
mitactyi'	Gusano pequeño.
míte	Quemadura.
míti	Quemarse el cuerpo.
miti'	Encuajar.
míto	Tarumá.
mitsej	Pedernal, piedra.
mitsej	Marico pequeño.
mitsi'naqui	Perforar.
miyaĉa	¡Va por ahí!
mọ'	Ella, esa.
moch	Lejos, alto.
mocha', mochaty-chas	Largo, alto.
mochadyem'	Largura.
mocha'je'	Alargar, poner mas largo.
mochane'	Mosetén.
mochaty un	Manga larga (camisa).
mochĉan	Hondo, bien adentro.
moĉhĉhe'	Alto.
moĉhedyem'	Altura.
mochety-ches	Alto, alta.
mocho'naqui, mocho'ne'	Cavar en la tierra con el hocico (chancho, etc.).
mochti	Alejarse.
mọ'dye	Misma.
modyin	Diente, muela.
mo'fe	Yema del huevo.
mo'ijva	Clase de pez (bagre).
mọj	Allá.
mojij	Lugar bajo llanura.
mọjo'cha', muju'cha'	Mejor, superior, mas allá.
mọjo'cha'je', muju'chajete	Recorrer, poner más allá.
mọjo'va', muju'va'	Más allá.
mọjo'veya'	Mas allá (como más abajo por el río).
mon	Perderse, escaparse.
mon'dye've, mon'dye'ĉan	Perdición.
mono'	Renacuajo.
montaqui	Dejó perder.
moñi	Perderse.
mor'mor'tyity	Color rayado.
mor'mor'sis	Color rayada.
moractyi' -si'	Rayado de distintos colores.
mórety -res	Rayado de diferentes colores.
mor'tacdye'	Rayado de color.
mor'je'	Masticar chicha.
morifi	Planta venenosa.
morocje'	Golpear en la costilla.
morocje'	Golpear, destrozar casa, cerco, etc.
moro'joij	Tener diarrea.
moro'jos	Diarrea.
mosh ọij	Aquí está (mostrando en la mano).
mosh tyu'	Ahí está, señalando con dedo.
motaqui	Afilar pala, hacha, machete, etc.
motoc	Víbora de la tierra.
mótoi'	Boro.
mótoi'yeja'	Tener boro.
mọtsi', mọtsi	Terminarse, desaparecerse, acabarse.
mo'tyi'	Gusano grande.
mọvety-ves	Los de allá.
mọ'ya', mu'ya'	Hay, ahí está.
mọ'ya'	En ese lugar.
mọ'ya'dye, mu'ya'dye	En el mismo lugar.
moyo'fi	Gato gris.
moyojco'	Conejo.
mụ'	Algodoncillo.
mu'	Él.
mu'ĉan	Está adentro.
mu'che'	Él está arriba, encima.
mu've	Está allá.
mu'ya'	Ahí está él.
mubaqui	Jalar.
muben'je'	Jalar alguna cosa.
mube'ñe'	Estar jalando.
mubiri	Raíz.
mucu'	Tener en la boca.
mụcu'	Cerro.
mucu'chuqui, mucu'naqui - ñe'	Tener en la boca, masticar.
mucta	Plato (Mosetén).
muchety	El es de allá.
mụi'	Que esta cociendo, asando.
mụi', mụi'dye	Hace rato.
mụi'dye	Hace ratito, hace pocos minutos.
mụij-i'	Cocer.
mụijya'	Abajo, al suelo.
mu'in	Ellos.
munaqui, muñe'	Chamuscar pelo de animal en el fuego.
mụi'tyity -sis	Nuevo.
mụi'ya'	Anteriormente.
muj	Mariguí.
mujrui'tyi'	Muchas frutas en el suelo.
muju'cha', mojo'cha'	Más superior.
mujve	Al otro lado.
mumu'	Cura.
mumujñi	Chancho del monte tropero.
mun	Entero.
munuj	Muto, sin filo.
munujje'	Hacerlo muto.
munja'	Ayer.
munja'	Fecundar.
munja'veya', munja'veyas	Hacen unos días.
munjaya'ĉan	Antes de ayer.
munsi	Persona de sexo femenino.
muntyi'	Hombre, persona, humano de sexo masculino.
muntyim' bä'yi	Ateo.
munujje'	En mutar algo filo.
múñeji'	Tángara de paraíso.
muñety	Viudo.
muñes	Viuda, divorciada, soltera.
muñemunsi' in	Solteras.
muñety	Viudo, divorciado, soltero.
muñemuntyi' in	Solteros.
muñesdyem'	Que no tiene marido todavía (soltera).
muñetydyem'	Que no tiene mujer todavía (soltero).
muñi, munja', mun'dye'	Convertirse en otra cosa, tigre, etc.
muñiti'	Fecunda, frutea.
muquedye'	Yuca sancochada.
muquejje'	Quemarlo.
muquety -ques	Cocido, quemado.
muruc	Frutas que caen en cantidad.
murje'	Hacer caer de arriba.
murucjeyaqui	Cosechar toda la fruta de la planta.
muru'que', muru'queja'	Cosechar mucha fruta.
murujru	Espinazo, columna vertebral, espalda.
murujrutaqui	Dar la espalda.
musacdye'	Molido.
musaqui	Moler (con piedra).
mu'suru	Árbol chicle de monte.
mush tyu'	Ahí está (apuntando).
mush uts	Aquí está (en mano).
mu'tyeva'joi'	Comer una sola clase de comida (por un tiempo).
mutyudye'	Bastón.
mutyudyeijtyi'	Autoridad, jefe, corregidor.
muvety in	Los de allá.
mu'ya', mọ'ya'	Hay, ahí está.
mu'ya'dye, mọ'ya'dye	En ese lugar, sitio.
muya'dyety tsun	La tardecita, al anochecer.
muya'yejoij	Tardecita.
muyetye'	Aplazó.
muyetyeja'	Aplazamos.
muyetyejcai'	Fracasó.
muyejjoij	Fracasó por entendimiento.
mätseij-tsei'	Que tiene varios colores bonitos.
mä́tsetsety	De colores muy brillantes.
mätyäj	Conejo de pampa y del monte.
nabac	Poner otra ropa encima de otro.
nabactyity	Abrigo, manto.
nabacyity	Saco, chompa, etc.
nabai'je'-te	Bajar el hinchazón, desinflar algo.
nabaj	Víbora pucarara.
nabaqui	Empollar.
naca'	Jóchi pintado.
nácaty	Hígado.
nacje'	Recibir algo tirado, etc.
nacven'je'	Sacar entero, completo.
nạ́dye'	Vuelo (de avión, ave).
nadyedyes	Documento de identidad para vía aérea o boleto.
na'eban' ịvaj	Luna nueva.
na'edye'	Cumpleaños.
na'edyedyes	Primogenitura.
na'fa'	Clase de árbol.
na'ij	Nacer.
na'eja'	Nacemos.
nạij	Volar.
nạ́ja'	Volamos o enterramos alguien.
nạ́dye'	Vuelo.
nạij bu'yi	Visible, transparente.
naijje'	Asesina, mata.
nạijjodye' tui'tyi'	Lucero del alba, Venus.
nạijjoi'	Buenos días.
nạijjoij, nạijjoi'	Amanece.
nạijjoi'si'	Pasado mañana.
nạijjoqui've	Madrugada.
nạijtye'	Ver, algo.
naijti	Ver, mirar.
naijtiĉa'	Poder ver.
naijtis	Pupila del ojo.
nai'qui	Nadar en el río, laguna.
naj	Peto de color amarillo (campana).
najna	Inflar alguna cosa.
najñeja'	Trabajar con barro.
najyajyaij, najyaijtyi'	Abierto, mal tejido.
na'maqui	Cercar el agua para barbasquear.
nam'je'	Cercar, encerrar.
na'maty	Camiseta.
namchaij, namchai'	Aplastado en el suelo.
namchaty, namchas	Aplastado, no redondo plano.
nam'joij	Atorase, trancarse.
nana'	Tiza para hilar.
nánac	Peto (vive en la tierra).
nanasti'	Desarrollarse llegar hacer joven femenina.
nanaty -nas	Joven.
nanatyti	Desarrollarse llegar a ser joven masculino.
nana'vava'	Mucho: grano, huevos, etc.
nạnayi'	Aves grandes como: mutún, pato, etc.
napats	Planta del pie.
napo'	Caravana, de habla española.
napu'	Compañero.
nạ́qui, nạ́que', nạcte	Ir a enterrar a un muerto.
na'ru	Cerco, pared.
na'ruij	Hacer pared de chuchio.
na'rutuqui	Hacer pared.
nas	Víbora.
náseij, násei'	Plano, nivelado.
nasen'je'	Nivelar.
na'sis	Satisfecho de comer.
nashaj	Tijera.
nashatuqui	Poner tijeras de la casa.
nashja'	Andar, pasear, cazar.
nájshushu	Lancero (insecto grande que vuela).
nataquis -quity	Vehículo, canoa para pasear.
nạ́te	Enterrarlo.
nati, nashja'	Andar, pasear, viajar, cazar.
natsacje'	Tumbar, cortar todo, dejar limpio.
na'tsaij -tsai'	Tendido en el suelo (tela, cuero).
natsyedyety - taquityi	Sábana.
natsje', natstaqui	Tender en el suelo, cama.
nav'je'	Desparramar.
na'vaij -vai'	Tener en cantidad.
nạyenje'	Nivelar, acomodar.
nạyejya'	En el espacio.
nayi'vaqui	Matar varios animales que es propio de uno.
nejneyi'	Llanto de animal.
nem	Lengua.
ne'maqui	Tener contacto sexual.
ni'bacdyes	Bola.
ni'baquity	Blando (arco resorte).
ni'yi'	Ablandar.
ni'joij	Ablandar, debilitar.
nipjeyaqui, ni'baqui	Tirar con honda.
niptaqui	Marcar línea.
nọ'aijtyi'	Gato gris.
no'bedye'	Cansancio.
nọbi	Cruzar.
nọpja'	Crucemos en el rio.
no'bi	Cansarse.
no'bis	Cansancio.
nocje'	Que mata de un golpear, o con bala, etc.
nóco	Vía láctea (constelación).
noĉo'ĉoij	Alguien que viene abrazado con su pareja.
noĉo'ĉoyeja'	Abrazado con la pareja.
nochnochyij-yi"	Que camina rengo.
nochje'	Alargar.
noc̣ho'c̣hoi', noc̣ho'c̣hoij	Temblando de miedo o de enfermedad.
noc̣ho'c̣hoyequi	Temblar por miedo.
noc̣hodye'	Vuelta del río.
noc̣hojc̣hos	Bahía.
nofje'	Golpea, el sonido de golpear.
noijririj	Gallina coto pelado.
noi'yi	Asustado, con miedo.
noi'yedye'	Miedo.
nojno	Mañana, al día siguiente.
nojnoĉanya'	Pasado mañana.
nojnodyety	Hasta mañana.
no'nirij	Vagabundo.
nono'	Mamá, madre.
nopdyety, nopdyes	Canoa, puente para cruzar.
nopej	En la banda.
noq̂uen'je'	Abraza.
noq̂uen'yi	Abrazar.
nọ́te	Atajar, detener.
noriaj	Noria.
notacdye'	Ayuda, apoyo.
nọ́taqui	Que ayuda.
nótaquity	Ayudante.
nọ́tyetaqui	Ayudar (por una dificultad), defender de dificultad.
nuca'je'	Mojar.
nuca'joij	Mojarse.
nu'caij	Mojado.
nụi'je'	Moler por máquina, pulverizar, hacer jachi de algo.
núnum'	Luciérnaga.
nụyaqui	Pulverizar.
nä'nä'je'	Chicotear, guasquear (leng. fam.).
näräc tyeij	Correr, ir a carrera.
närä'yi	Zapatear.
närä'naqui, närä'ñe'	Zapatear, en espiritismo, etc.
närä' närä'	Correr.
ñecjeyaqui	Amarrar, colgar con un cordón (cuerda) (como una cruz o algo sobre el cuello).
ñe'ij	Convulsión, tener ataque.
ñeijje'	Romper.
ñej	Huasu, venado.
ñejñe	Palo, puñera.
ñe're	Sapo que canta en el tiempo de llenura del rio.
ñéta'	León, puma.
ñịbe', ñịbety, ñịbes	Pobre, sufrido.
ñịbe' bä'yi	Vivir sufriendo, pobre.
ñịbe' cạve'	Sufrir de algo.
ñịbe' ĉọ́qui	Tener lástima de, paciencia de algo.
ñịbe' jị'cavaqui	Hacer sufrir algún familiar.
ñịbe'beij, ñịbe'beyeja'	Sufrir persona que de alguna enfermedad.
ñịbe'betacdye'	Regalo.
ñịbe'betaqui	Tener suerte.
ñịbedye'	Sufrimiento, pobreza.
ñịbedyes	Sufrimiento.
ñị'beij jäm'	Persona flaca, débil.
ñịbe'jeyaqui	Regalar, salvar, tener lástima, favorecer.
ñịbe'jeyacsity	Salvador.
ñịbe'jisin'tyi'	Nuestro salvador.
ñịbe'jitidye'	Favor.
ñịbe'jitidyes	Perdón, favor.
ñịbe'yedye'	Regalo, premio.
ñibe'yedyes	Para regalar.
ñịbe'yi	Regala.
ñịbe'tacdye'	Sufrimiento por castigo.
ñịbe'taqui	Maltratar, molestar, sufrir persecución.
ñịbe'tum	Con sufrimiento, con dificultad.
ñictiij, ñictii'	Flaco, delgado o delgada.
ñinaqui, ñiñe'	Criticar, hablar en contra.
ñitsche'	Arriba en el río.
ñitsedye'	Arribada.
ñịtsi, ñịtseja'	Arribar.
ñitsi'	Filtrar, gotear, entrarle agua.
ñi'tsi	Cazar por un día.
ñịtsje'	Ganarle la delantera a un animal.
ñucchuqui	No dejar salir, proteger, impedir.
ñucchuquis	Tapa, división, impedimento.
ñucjeĉúnaqui	Defenderse, desviar un golpe, proteger de.
ñucac	División (cuarto o patio de casa), entre dos lugares.
ñucjeyaqui	Prohibir, parar, cerrar.
ñucñiti	Moverse, brincar el feto.
ñuctacdye'	Cuarto, cerco, división.
ñuctaqui	Impedir, trancar.
ñuctyi'	Vena, tendón.
ñucyetŝọij	Bloquear, tapar, algo cae que tapa.
ñucyi, ñucje'	Apoyar, recostarse.
ñụi'je'	Errar, no lograr.
ñujcuij, ñujcui'	Encerrar (patio).
ñujcus, ñujcuty	Lugar encerrado.
ñujdye'	Sobrina.
ñụjtsujtsus, ñụjtsujtsuty	Impedimento, barrera.
ñun	Atajar, detener.
ñuru'nacdye'	Marcha.
ñuren', ñuru'	Grupo, reunidos, grupo en la tribu.
ñuren'je'	Ir en el grupo.
ñuryi	Juntarse para reunir.
ñuru' tyeij	Reunirse, juntar, venir a reunirse.
ñuru'je'	Tener, obtener muchos.
ñurujrui' - rus	Árbol enredado de bejucos.
ñuru'ruij	ir o venir en grupo.
ñurva'ti'	Lluvia fuerte.
ñusdyety	Sobrino.
ñúteij	Rayada, con franja.
ñútetety, ñútetes	Rayada, con rayas verticales.
ñúti'	Detenme.
ñutin'ñutin'sis	Rayada.
ñutu'je'	Amarrar por la cintura, en medio.
ñutu'tacdye'	Cinturón.
ñutu'ti	Ponerse cinturón.
ñutschuqui	Que defiende, protege.
ñutsjeĉúñe'	Acosar.
ñutsje'	Defender, respetar.
ñutsjetacsity	Protector, defensor.
ñutsjeyaqui	Atajar, defender, proteger.
ñutsen'je'	Cruzar una línea recta.
ñutstaqui	Envenenar (pescado, gente).
ñutstyi	Barbasquear, envenenar pescado.
ñútyin	Ayudar en algo.
ñuv'	Traspasar, pinchar.
ñäbdye'	Hinchazón, puchichi.
ñäbdyi'	Infectar, llega enfermedad contagiosa.
ñäbi, ñäpja'	Hinchar, tener puchichi.
ñäcrä'je'	Desnudarse, estar desnudo.
ñäcräjräi'tyij- tyi'	1. Casa sin techo 2. Sin ropa.
ñäcräjräs	Armazón de casa, con todos los palos menos las hojas (del techo).
ñam'dyi	Cruzar, de un árbol a otro.
ñäñisin'	Nos critica.
ñäñitidye'	Crítica, odio, desprecio.
ñäpje'	Termina, que usa todo.
ñävä'	Camijeta.
ñä'väij	Puesto con la camijeta.
ñäväjväij	Cabelludo, puesto con la camijeta.
ọ́ĉan	Aquí adentro.
ọ́che'	Aquí encima.
ọ́ve	Aquí al otro lado.
ọ́ya'	Aquí está.
oba'	Árbol, toborochi.
obadye'	Mes de mayo.
obota	Bolsa.
o'boyo'	Lechuza, búho.
ọc	Suciedad, olor del cuerpo, ropa.
ọcamyi	Perder la vista.
ọ́ĉan	Aquí adentro.
ọĉan	Debajo.
ọĉanya'	Por de bajo.
ococo	Rana, sapo.
oconạ	Clase de piedra, lugar del río Maniquí arriba.
ọctuij	Olfatear, seguir senda de algo por el olor.
ọ́che'	Arriba, encima de.
ọ́cheya'	Más arriba.
oc̣ho'	Mucho.
oc̣hodye'	Enojo violento.
odo'	Marimono.
ofjeyaqui	Golpear, patear.
oi'	Tojo (ave).
ọij, ọ́yi	Esta, esa.
ojdo	Tujuju.
oji'na	Galápago, peta del agua.
ojñi'	Agua.
ojtere'	Gallo.
ọjtocoj	Araña, sama.
ojtyi'sha	Véase.
vajac	Burro (gusano).
o'me	Cogollo, retoño.
onọjnodye'	Sombra, alma, espíritu.
onomsi'	Sombra.
onom'ĉan	Debajo de la sombra.
ọñej ọñej	Pájaro de mal ohuero.
ọ'ojpona	Hombre mitológico, marido de úju.
ọ'oyo	Oso hormiguero.
ọpaj	Mutún.
o'pito'	Arco iris.
o'pitoij	Embrujado por el arco iris.
opoj	Personaje mitológico.
opopoty	Molleja.
opos pe're	Planta parecido a plátano.
ọqui'	Se ensucia.
ọquity, ọquis	Oxidado, manchado, sucio.
óra	Hora, tiempo de día.
óricoj	Calambre.
óricoij	Tener calambre.
ọ́ris	Maúri.
ororona'	Árbol blanda (papayo).
ọ́rota'	Estrella, luz eléctrica (foco).
ọ́rotaty	Planta eléctrica.
oshno'joij	En cegar algo de la vista (no de todo), perder la visión (con edad).
o'sho'	Ropa (mosetén).
otej, otejyi	Lástima, sentir lástima de, pesarle.
otejjiti', otejjitiĉa'	Apreciarse, valerse, quererse.
óto'	Capiguara.
ọto'	Mosquito.
ọ'to'	Paloma.
ọtodye'	Tiempo de mosquitos.
ótodye'	Pintonea una fruta.
ótoi', ótoyeban'	Pintonea la fruta de plátano.
ọtoij, ọtoyeja'	Picado por los mosquitos.
ọtyire	Primo hermano, socio.
óva	Uva.
ọ́vemun	Ambos lados.
oveca	Oveja.
ọ́ya'	Aquí está.
óya	Lombriz (de estómago, tierra).
ọ́ya' qui'	Mucho, grande en ciertos contextos.
ọ́yas	La que estaba aquí.
ọya'ya'je', uya'ya'je'	Rebajar precio.
ọya'yai', uya'ya'ij	Disminución de capacidad o fuerza.
o'yi	Yuca.
oyo'	Ombligo.
ọyoj	Mono silbador.
ọyosiij, ọyosii', ọyosiyeja'	Dañinear.
paca'caij- cai'	Fresquito.
paca'caijtyi'	Ventilador (eléctrica).
pacajje'	Aliviar.
pacajyis	Refrescante.
pacajyejoi'	Refrescar.
pacajyi	Refrescarse, sentir mejor, aliviar.
pacaqui	Clavar.
pa'caqui	Golpear con palo, etc.
pacjeyaqui	Plantar horcón, palo o golpear.
pactacdye'	Herido o hueco hecho por clavo.
pactaqui	Clavar, plantar poste.
pac̣hir'	Arrugar.
parchii', parchis, parchity	Arrugado.
pachjajiti, pachyi	Picar (insecto).
pachje'	Encender, prender fuego o motor.
pachtaqui	Encender (fuego).
pá'e	Cura, párroco.
pafa'faij	Dolerse de los huesos.
pafera	Fósforo.
pai', pai'pai'	Desparramado, separados, en distintas partes.
pai'je', pai'yi, pai'joij, pai'joi'	Desparramar, tender para que seque, ir a todas partes.
paijra	Paila.
pai'tye'	Desparrama.
pai'tyeja'	Desparramamos cosas, ir a todas partes.
pai'yij - yi'	Desparrama.
paj mọ'ya', paj mu'ya'	Que se quede, déjelo.
pajajje'	Sonido de disparo de un arma.
paja'jaij	Dolor del cuerpo, arder de fiebre.
pajjete	Pegar, golpear con las nos.
pajnaqui, pajñe'	Golpear (algodón, caña).
pajñe'	Envolver, arrollar.
pajquity	Mosquito, puguilla.
pajraij, pajraja', pajrejoij	Tener enfermedad de piel, piel áspera o escabrosa.
pajraty -ras	Áspero, áspera.
pam'	Temprano.
pam'mundye	Toda la mañana.
pam'dye	Bien temprano (en la mañana).
pam'je'	Comer, tragar rápido.
pam've	Por la mañana, este (dirección).
panaqui	Envolver, liar.
panjeyaqui	Envolver, enroscar, estrangular.
pantaqui	Envolver, vendar.
panyi	Envolver, liar.
pa'ñe	Bi, árbol.
pañeij	Vendado, liado.
pañejñeij	Estar vendado, enroscado, liado.
pañero	Pañuelo.
paper	Papel, cuaderno, libro.
parajnaqui, parajñe'	Hacer una cosa de madera no bien terminado, como canoa mal labrado.
parasje'	Errar, escapar.
para'saqui	Que no acierta.
parchir'je'	Arrugar algo.
parchijyi	Arrugarse la cara.
pạrej	Separado.
pạrej bu'yi	Apartado, en secreto, privadamente.
pạrejdye	Separado.
pạrejje'	Separarlo, apartar.
pạrejtaqui	Separar.
pạrejti	Separarse, separado.
pạrejve	En otro lugar.
pạrejveya'dye	A un lado, no directo.
parta	Palta.
pasmun	Pasarse pero casi chocando.
pa'sa'	Retoño de plátano.
pási	Cedazo, umpé.
pasje'	Encender fósforo.
pastaqui	Encender fósforo.
pasha'ra	Caracha.
pasha'raij	Tener carachas.
páshejshei'	Barranco alto.
páshesheij	Precipicio, brillante.
páshety, páshes	Brillante, blanco.
pashyi	Reflejar, brillar.
patstaqui, patstye'	Servir comida.
pato	Pato.
pats	Servido.
patssis, patstyity	Con manchas.
patsa'cac	Desecho.
patsa'caqui	Quebragear, machucar.
patsacdye'	Basura.
patsacje'	Machucar, destrozar.
pa'tsaqui	Hacer pared de barro o servir comida.
pạ́tsi're	Pegapega.
patsjeyaqui	Enlodar, regar con barro.
patstaqui	Servir comida.
pa'tyi'	Uña, garra.
pavaj	Ala.
pavajĉhes pan	Plumas de las alas.
páya	Patujú, bajura.
payaso	Payaso, mágico.
payi	Comentarios que llegan a todas partes.
pecajracdye'	Idioma castellano.
pecajraqui	Hablar en castellano.
pecaryi	Saber hablar castellano.
pecseij, pecsei'	Estar de color negro o moreno, quemado del sol.
pecsety, pecses	Persona de color negro, moreno.
pech	Tronco de árbol, cola de canoa.
pechĉan	Estar por debajo.
pechĉantyi'	Justán, ropa interior.
pechi	Hundir.
pechtaqui	Le hundió alguna cosa en el agua.
pe'ii -i'	Turbio, espeso, espesa.
pei'je'	Colar, prender.
pe'is, pe'ity	Nombre de un arroyo.
pei'taqui	Parchear, prender, colar.
pei'taquis	Parche (para cámara o blader de pelota), pegante.
peje'jeij	Sonido del motor de la moto cuando viene.
peje'jei'tyi	Trabajando con la motosierra.
pejje'	Acelerar algún motor.
pe'maqui	Apedazar.
pem'je'	Sacar un pedazo.
pem'tye'	Partir (leña, madera, etc.).
pen'	Un solo lado.
pen' tyeij	Costear, ir por el barranco del río.
pen'dye'	Compañero, amigo.
pen'dyeij	Ser acompañado.
pen'dyetuqui	Acompañar.
penej	Balsa, callapo.
peneij	Conducir canoa, callapo.
peneij	Hacer canoa.
pen'je'	Poner a un lado.
pentaqui	Que va disminuyendo de fuerza de algún familiar cuando esta enfermo o morir de enfermedad.
penva'joij	Agonizando.
peñeti	Vino a perder el juego o perder una apuesta.
penja'	Perdimos.
pen'dye'	Derrota, amigo.
pépen'	Tigre, nombre mitológico.
pe're	Plátano.
perota	Pelota.
perotaij	Jugar fútbol.
pétsi	Peine.
pe'yaqui	Remendar, parchear.
pichyi	Arder.
pichon'	Hacer pico.
piji'	Plato, vasija.
pijjeyaqui	Huasquear.
pịjpitsa'	Clase de pájaro de color negro.
pijrity- ris	Bien flaco o flaca.
pijririty, pijriris	Delgado.
pịñẹj	Tucancillo de tira roja.
pịñidye'	Remedio, medicina.
pịñiij	Curar, dar remedio.
pịñitui'	Curar con remedio.
pị'pidye'	Raya grande, redondo sin puga.
píqui	Nigua.
píra	Pila.
pirij	Greda, tierra para hacer cántaro.
pirim' pirim'	(idiomático) Saber, aprender un poco a hablar algún idioma.
pirisyi	Tronar fuerte.
pisimi	Urina.
pisje'	Pasar casi topándolo.
pishta	Pista.
pish	Peto.
pịsheij, pịshei'	Claro, con brillo, reflejante.
pishva	Surubí.
pise're	Fruta silvestre.
píti	Ceniza que utilizan para mascar coca, la tapa de la fruta de motacú.
pịtsi'caqui	Destrozar, hacer pedazos.
pitsicje'	Quebrar, destrozar.
pitsuij, pitsui'	Disolver, deshacerse.
pị'tsuij, pị'tsui'	Blando.
piyiyirej	Bato.
piyuyu'	Garza.
poco'	Penga.
po'coi'ya'	Bifurcación de río o camino.
poc̣haqui	Sacar un poco (lo que entra en la mano).
poc̣hen'je'	Sacar, separar poco alguna cosa u objeto.
poc̣hen'yi	Unirse, congregarse.
poc̣hoc	Puñado de arroz, etc.
poc̣hocje'	Arañar, escarbar, agarrar un puñado de algo.
poc̣hoctuqui	Arañar, intentar subir.
poc̣ho'ya'	Puchuya (lugar sobre el río Maniquí) al lado de una isla.
pofpofje'	Golpearla, sonido de golpear.
pófi	Papaya.
poijjoij	Disolver, derretirse.
pojqui	Hormiga negra.
pojroi'tyi	Con muchas piedras.
pom'je'	Quebrar, desportillar.
pom'jeyaqui	Desportillar una cosa que es de uno.
po'nacdye'	Chicha de plátanos, yuca.
po'naqui, po'ñe'	Hacer chicha o refresco.
ponoj	Bombo de barro especial de brujo.
po'po	Clase de guineo.
pọpoj	Tobillo del pie.
po'rij	Trillas del tigre, gato, perro.
porisisi	Seboí, ave de color negro que come arroz, maíz.
porisiyaj	Guardia, policía.
porojma	Antiguo, pasado de hace mucho tiempo.
potsadye'	Viruela.
potsadyeij	Tener viruela o lepra.
potsin'je', potsi'ñe'	Agarrar, pellizcar.
potsin'tacdye'	Punilla de casa.
potsin'taqui	Poner punilla a la casa.
po'tso'	Greda especial para cántaros.
prestaij	Prestar, dar prestado.
prestajjetaqui	Prestar algún objeto o cosa.
prestajjeyacsi	Prestar, dar en prestado.
prestajjeyaqui	Dar en prestado.
pucmun	Seguido, cada rato.
pufeij, pufei'	Olear, tener olas.
pufej	Ola.
pufu'fuij	Andar agachado, vagar.
pufu'naqui	Andar agachado.
pufu'nacva'joij	Tener relaciones sexuales con una mujer.
pụi'jeyaqui	Pulverizar, moler (café, chocolate).
puijnui'	Muy maduro.
pụ'je'	Besar.
pum'jeyaqui	Masticar fruta del monte.
pumsui', pumsuij	Con punto redondo.
pum'taqui	Morder, matar piojo con dientes.
pumu'yi	No saludar, no contestar (cuando uno le habla).
pụna	Ayllu, nombre de pez.
punchu	Colcha, frazada, manta.
punichyi	Paralizar, inmovilizar brazo, mano.
puñipu'	Cera para colar columna de la flecha.
pụñuj	Cántaro.
pupujri'	León.
puptaqui, pupte, pupti	Lavar ropa.
pur'chiij	Arrugado.
pururu	Escopeta, trueno.
pururu	Tucura palo (insecto de color café obscuro).
pụ'sacva'joij	Besando.
púshin'	Gusano de tabaco.
putu'tuij	Llevar en la mano algún objeto.
pútyi, pútyi'	Sanarse, alivia del dolor.
putyuij-i'	Adormecido, con anestesia.
pä'	Sonido de golpe.
pä'cäij	Puesto, echado de espalda.
päcä'	Volcado.
päcä' bu'yi	Echado de espalda.
päcä'je'	Volcar, poner de espalda.
päfräij	Tener ronchas en el cuerpo.
pä'je'	Pegar, golpear, topar.
pä'jisity	Nos golpeó.
päjsäi'	Bien tejido, apretado.
päm'yi	Mudo, no poder hablar.
päpäj	Tío, marido de hermana de la madre.
päquen'je'	Volcar, poner de espalda.
päquetyyi'	Mujer que se echa de espalda.
pärä'	Dos.
pä'räij	Estar juntos.
päräjräij	Estar solos dos personas.
päräjräij	Dos personas que andan juntos.
pären'	Ambos, par.
pä'sijque'	Tumbar, echar abajo.
pä'shä	Japutamo.
pävnäij	Calvo, sin cabello.
pä'yetŝọij	Sonido de caer.
p̂ạĉan	Tumbar monte después de rozar para chaco.
p̂ạcdye'	El lugar donde se tumba el monte.
p̂acraij	Con canas.
p̂acren'yi	Envejecer, tener canas.
p̂acsi'	Tumbado (palo).
p̂ại'	Tumbar árbol.
p̂ai'joij	Entrar o salir de un vehículo.
p̂ai'tye' -te	Brincarle, subir en vehículo, canoa, etc.
p̂an	Pluma, ala de insecto.
p̂anacdye'	Tejido.
p̂anaqui	Tejer, techar.
p̂an'dye'	Crecimiento.
p̂antaqui	Estar ausente mientras el hijo crece.
p̂añeyaqui	Tejer, techar casa para alguien.
p̂añi	Crecer.
p̂áp̂an'	Escama de pez.
p̂ạqui, p̂ạjquiqui	Ir a tumbar árbol, mont.
p̂aquidye'	Hacha.
p̂ash, p̂ashsi'	Fermentado, fuerte.
p̂ashi'	Fermentarse.
p̂ashi'shiij	Dolor del estomago, acidez.
p̂irishyi	Tener diarrea.
p̂eijte	Hablar de (bueno o mal), criticar, oponer.
p̂ej	Patio, canchón.
p̂e'je'	Abrir, extender.
p̂en	Mujer, esposa, hembra.
p̂endyes	Prometida, novia.
p̂entudye'	Adulterio.
p̂entui'	Casarse con una mujer.
p̂etaijje', p̂etaij tŝọij	Destruir, quebrar, volverse polvo.
p̂etajyaqui, p̂etajyeja'	Quebrar, destrozar.
p̂eyacdye'	Palabra, conversación.
p̂eyacdye'ĉan	Ser pedido en matrimonio, comprometido.
p̂eyacdyes	Radio de comunicación.
p̂eyacdye'tumtyi', -si'	Él que habla su idioma, él que lleva la palabra.
p̂eyaqui	Hablar, decir, confesar.
p̂eyeja	Le hablamos.
p̂eyaquity jen'tyi'	Profeta de Dios.
p̂eye' juchaj, p̂eyeja' juchaj	Confesar pecado.
p̂eye' paper, p̂eyeja' paper	Leer libros.
p̂ịj	Cola de pescado, ave, avión.
p̂ịjcu'shi	Pez, blanquillo.
p̂iqui	Correr.
p̂isijsis	Choza.
p̂isijsiquen	Varias chozas.
p̂isi'naqui	Refugio, hacer choza.
p̂isnacdye'	Cigarrillo.
p̂isnaqui	Fumar cigarrillo.
p̂isñe'	Que fuma cigarro.
p̂o'c̣haqui	Inyectar, zunchar con jeringa.
p̂oc̣hp̂oc̣hyi	Espinoso (ropa que molesta uno).
p̂oc̣hi'chiijtyi'	Cilicio, ropa áspera.
p̂ochjeyaqui, p̂o'c̣haqui	Inyectar, dar puñaladas.
p̂oc̣ho'	Amarre de la bolsa.
p̂oc̣htaqui	Inyectar, plantar poste, pinchar, punzar.
p̂oc̣htacdye'	Herido puñalada, inyección.
p̂oc̣htaquis	Jeringa.
p̂odo'doij	Salir, aparecer muchos (personas e hormigas).
p̂ọi'shoty-shos	Con boca pequeña (ratones, jochi).
p̂ojqui'	Hervir, burbujear.
p̂on'dye'	Llamada, canto, sonido.
p̂on'dyedye'	Tiempo que brama el tigre o canto de los animales.
p̂oñi	Cantar (ave), gruñir, bramar, cacarear.
p̂oquedye'	Olor.
p̂oqui	Huele (bueno o mal), huele feo.
p̂ọ'qui'	Burbujear, hervir a un punto muy alto.
p̂otso'vi	Horcón, poste.
p̂oyajje'	Agua lleva con fuerza.
p̂oyajnaqui'	Remolino de agua (río).
p̂ucruij	Con canas, pelo blanco.
p̂ucu'shaqui	Retorcerse, mover.
p̂ucushjeyaqui	Mover arbusto, gajo, viento, etc.
p̂ucushyi	Ramas del árbol que se mueven por el viento.
p̂uc̣hi'	Racimo, tripa entera con estómago.
p̂uc̣hic̣hiyeban	Venir o ir con cama.
p̂uc̣hi'je'	Poner un lugar el racimo de plátano.
p̂uc̣hin'jeyaqui	Cargar cama para viajar.
p̂uc̣hin'joij, p̂uc̣hi'joij	Enredado, estómago con calambre.
p̂uc̣hi'riti	Enredado.
p̂uc̣hir'je'	Arrugar.
p̂uc̣hir'joij	Arrugarse.
p̂udaijje'	Quemar algo.
p̂udaij jii'taqui	Quemar de todo lo que tenía.
p̂udi'	Agachado.
p̂udu'dus	Neblina, llovizna.
p̂udu'dui'	Con neblina, llovizna, anublado, en el aire con humo.
p̂uduj	Rápido, levantar polvo o humo.
p̂udujquedye'	Polvo.
p̂udujqui	Hacer polvo, humo.
p̂udujqui'	Ventear del sur.
p̂údyei'tyi, p̂údyei'tyi'	Caliente, muy caliente.
p̂údyei'tyi' yụ'tye'	Lo hizo bien caliente (el horno, fierro, etc.).
p̂údyes	Rojo, color del fuego.
p̂ụ'dyuij	Tarde, cuando se entra el sol.
p̂ui'dity-dis	Torcido, doblado (persona u otra cosa).
p̂uijdai'	Polvoriento, playa, seca, etc.
p̂uijdastyi, p̂uijdastyi'	Comer polvo (tierra, cosas polvorientas, chivé).
p̂ujje'	Soplar.
p̂ujp̂ujyi	Palpitar mucho, con lengua afuera de cansancio.
p̂ujnaqui, p̂ujñe'	Soplar el fuego.
p̂uj	Soplar.
p̂ujnaqui	Soplando.
p̂ujñe'	Soplar algo.
p̂ujsi'	Verde (solo plátanos).
p̂ujtaqui	Inflar, soplar algún instrumento musical.
p̂ujtaquis	Bomba de inflar, inflador.
p̂um'	Metido en algo.
p̂u'maij	Debajo, metido en la basura, paja, monte tupido.
p̂uman'je'	Meter algún objeto por debajo de la arena o cualquier otra cosa.
p̂umucje'	Poner debajo de algo.
p̂un'chii'	Equipaje acomodada listo para el viaje.
p̂un'joij	Caerse de raíz, desarraigar.
p̂ur'	Tapado, cubierto con colcha.
p̂ur'ĉhuqui	Taparlo (con manta).
p̂ụra'	Caballo.
p̂urdye'	Maduración.
p̂ụr'dye'	Pelo blanco, cana.
p̂ure'daraj	Término de decir a la mujer/esposa (en chiste).
p̂urej	Viejo. Maduro.
p̂urety -res	Viejo, adulto, planta madura, querida, "vieja" (palabra de cariño a la esposa).
p̂uri	Envejecer, madurar.
p̂ur'jiti	Taparse con manta (colcha).
p̂ur'tyity	Sábana, colcha, manta.
p̂uru'naqui	Trabajar de brujería, tapándose con algo.
p̂usaijje'	Champarla en el agua alguna cosa, meter en líquido.
p̂uru'naquity	Brujo.
p̂u'suij	Estar con cabello largo, sin cortar.
p̂u'suty	Persona con cabello largo.
p̂usujsus	Choza, casa pequeña.
p̂u'shaqui	Soplar (de brujería).
p̂ushjeyaqui	Soplarle, forzar, apretar, maldecir (con soplar).
p̂uti, p̂uteja', p̂utja'	Ahogarse.
p̂utscu' bu'yi	Asentado.
p̂utscuij	Estar sentado.
p̂utsquen'je'	Que lo hace sentarse.
p̂utsquen'ti	Sentarse, sentarse con cuidado cuando se está enfermo.
p̂uyaj	Embriagado.
p̂uya'yaij, p̂uya'yai'	Dolor del estómago, agrio, fermentado.
quebaqui	Cortar uñas, cabello.
que'baqui	Sacar fotografías.
quebosje'	Doblar algún objeto como ser olla, lata, etc.
quebostaqui	Perona que dobla algún objeto suyo.
queburje	Amellar filo del cuchillo, machete, pala, etc.
quec̣haqui	Apretar alguna cosa u objeto de uno mismo.
quec̣he'je'	Apretar con fuerza.
quec̣he'naqui	Amasar.
quec̣he'taqui	Apretar.
quejtyefe	Pierna junto a la cadera.
quenej	Cadera.
quepje'	Apretar algún objeto o cosa.
quepsis	Jatata con dos varillas.
queptacdye'	Fotografía.
queptaqui	Sacar fotografía, poner mango a cuchillo.
queptaquis	Máquina fotográfica.
quéquev'	Clase de ave, cacaré.
quepyis	Trampa.
quejraqui	Afeitar, raspar, limpiar.
queraquis	Afeitadora, raspadora, limpiadora.
querec̣ha	Dinero, plata.
querec̣ha cam' mạ'jete	Codicia, avidez.
querec̣haij, querec̣hayeja'	Ganar dinero.
querechyi	Morder, rechinar (dientes).
querechyejoi'	Ataque de mal viento.
quererejjeyaqui	Raspar.
queshyi	Gritar, chillar: jochi colorado.
quete'	Flor: de caña, arroz.
quetsaqui	Moler caña.
quev'je'	Acomodar el feto en la matriz.
quevjan'	Buscar.
quevaqui	Buscar.
quevja	Busquemos.
que'vaqui	Acomodar feto en la matriz para facilitar el parto.
quiban'yi	Cerrar los ojos.
quiba'saqui	Enojado, aburrido, vivir enojado.
quị́bi	Verruga o quirichí.
quic	Sembrar.
quicsi'	Sembrado.
quictyi'	Ropa usada.
quịch	Directo.
quichĉan	Directamente arriba, abajo.
quịchĉan tsun	Mediodía.
quịchĉanjoi'	Saludo al medio día.
quịchen'je'	Poner en dirección.
quịchij	Seguir, continuar.
quichje'	Arrectar, endereza.
quịchi'vaqui	Cazar al acecho, esp.
quị'	Sembrar.
quijadye'	Mezquindad, tacañería.
quijaij	Mezquinar, negar.
quijatuqui	Mezquinar algo.
quijbo	Peta del monte de color amarillo.
quijnacdye'	Miedo.
quijnaqui, quijñe'	Temer, tener miedo.
quịjodye'	Chaco.
quịjoij, quịjoja'	Chaquear.
qui'joij	Apagarse.
quimiri	Tigre pequeño.
quin'jeyaqui, quin'jete	Gatillear.
quị́qui, quị́ja', cäti	Sembrar.
quị́qui', cäti	Vestirse.
cätiĉa'	Vestirnos.
quiquijnaquity	Cobarde, miedoso.
quiquijnatu'	Avispa (peto) amarilla y negra, vive debajo de la tierra.
quirca	Papel, libro.
quíro	Kilo.
quiruru'	Ambaibo, corteza usada para hacer soga.
quis	Suegra.
quisbánaqui	Infeliz, aburrido, triste.
quisbuij, quisbuty, quisbujyi	Cara fruncida, arrugada, fruncir de enojo.
quị'si'	Ropa, tela, trapo.
quishje'	Quebrar, romper cosas dura.
qui'shaqui	Quebrar huevo (sale el hijo), quebrar cosa vidriosa.
quishac tŝọij	Quebrar a pedazos.
quitivarej, quiti'	Taitetú.
quítsa'	Peni.
quiv'je'	Persona que apaga fuego, lámpara, maquina.
quiv'joi' qui'joi'	Apagar de por si misma.
quiyo'yi', quiyo' quiyo'yi	Llanto de anta.
quiyu'yi	Silbado a la anta.
q̂ue'beij, q̂ue'bei'	Barranco o zanja.
q̂ueben'jeyaqui, q̂uebe'ñe'	Trenzar.
q̂ue'bes, q̂ue'bety	Bajura, un lugar más bajo que el otro.
q̂uefje'	Colocar debajo o entre medio de otras cosas.
q̂uei'je'	Raspar.
q̂uei'taquis	Cuchilla de tractor, o sepillo para madera.
q̂uem'je'	Desportillar, sacar un pedazo.
q̂uememejje'	Partir algún objeto por varias partes.
q̂uemi'miij	Cacharro, gastado.
q̂uemi'mi'si'	Migas, migajas, sobras.
q̂uemi'vaqui	Quebrar en pedazos.
q̂uen'je'	Sacar, cortarle la pierna de animal, quebrar pierna.
q̂uen'ĉan	Ocho.
q̂ueñi'ñiij, -ñii'	Quebrar, desgajar.
q̂uepje'	Colgar marico cruzado sobre hombro.
q̂uesh	Descompuesto.
q̂ueshyi	Caer de arriba.
q̂uev'joij	Desviarse, ir por otro camino.
q̂uev'yi	Desviarse.
q̂uev' cại'	Ir por otro camino o desviarse con alguien.
q̂ueyaqui	Raspar.
q̂ueye'daqui, q̂ueye'dyete	Raspar flecha u otra cosa, desgranar choclo.
q̂uishin'	Hinchazón, seca.
q̂uishin'yi	Tener seca hinchazón.
q̂uibaqui	Tejer jatata.
q̂uichjeyaqui	Llenar, completar de carga.
q̂ui'chij, q̂ui'chii'	Muchos, en cantidad.
q̂uim	Izquierda.
q̂uimon'yi	Cuando vuelca la canoa de por si.
q̂uin'	Hoy día, ahora.
q̂uin' ĉhat	Ahora si, está bien.
q̂uin'dye	En este momento, ahora.
q̂uin'dyem'	Recién, por fin.
q̂uinve	Izquierda.
q̂uinves un	Mano izquierda.
q̂uinvejtaqui	Zurdo, con la mano izquierda.
q̂uin'veya'	Más tarde.
q̂uin'veya'dye	Más tardecita.
q̂uiñu'	Una papa silvestre, comestible.
q̂uipdyi	Rincón.
q̂uipsis	Jatata con una varilla.
ra'baqui	Remendar ropa, canoa.
racam'	Pegar.
racam'je'	Pegar algo.
rajyi, rajyi'	Sonido de andar en el monte (animal o persona).
rajsijcaqui, rajsijban', rajsijque'	Sonido de hacer caer árboles.
rajsijque' son	Tumbar árbol.
rámi	Hambre, con mucha hambre, con fuerte deseo sexual.
raptaqui	Remendar alguna cosa.
raptacdye'	Remiendo.
rata'tayequi	Temblar de miedo o de frio.
ratatajyi	Saltar (pescado o animal).
ratben'sis	Hongo de la piel, sarampión.
rebacsi	Encontrarse, ir a encontrar a alguien en el camino.
re'baqui	Componer, arreglar, ensanchar.
rébete	Encontrarse en el camino.
refjeyaqui	Colgar tela, cortina, extender ropa.
repjeyaqui	Pegar algún cuadro en la pared.
reptaqui	Remendar, añadir, ensanchar.
repteja, reptete	Encontrarse por el camino.
ribin	Raíz.
ribro	Libro.
ricaricaij	Tocar caja o tambor, hacer caja o tambor.
ricaricaj	Caja o tambor.
rijmadye'	Eco de un sonido.
rijtety, rijtes	Adulto, mayor de edad.
rijti, rijti', rijtiĉa'	Ser adulto.
rimonaraj	Lima (fruta).
ríshaij, ríshayeja'	Rezar.
ríshayaqui	Rezar a un santo, ídolo.
robocje'	Doblar alguna cosa.
ro'bodye'	Poción de brujo (hecho de fruta del monte, que puede matar, veneno).
roc bu'yis	Atravesaño, palo del techo de la casa.
rocjeyaqui	Atravesar, poner atravesado.
roctaqui	Armar el esqueleto de una casa.
roctacva'joij	Armando el esqueleto de la casa.
rocve	Viento del norte, sol pasado las doce.
rodo'	Ruido de animal.
rodo'doij, rodo'yi	Ruido de animal.
roi'muñi	Saltar algo, pasar por alto.
roi'je'	Saltar para subir en algo.
roi'qui	Latir, palpitar.
roijya'	Canilla.
roi'yi	Saltar, brincar, bajarse, largarse.
roj	Caracha.
rojcaqui	Atravesar, poner palos para puente, construir esqueleto de la casa.
rojcoij, rojcojcoi'	Atravesad.
rojcos	Palo atravesado por el camino.
rọjo'	Insecto llamado chicharra.
roquen' tsun	Después de las doce del medio día.
roquen'je'	Llevar en brazo.
roroij	Picado de una abeja llamada roro'.
roro'	Abeja negra.
ro'yacdye'	Baile.
ro'yaqui	Bailar.
rucrucyi ĉojtyi', ruc rucdyij	Palpita fuerte el corazón, asustado, etc.
ru'dyei'ya'	Sepultura, cementerio.
ru'dyety	Persona enterrada.
ru'dyuij	Estar enterrado.
rudyu'je'	Enterrar, llenar, terraplenar.
rudyu'naqui	Terraplenar.
rudyu'taqui	Enterrar.
rụi'cu'	Estar parado (persona).
rụi'cu'ĉan	Visible, en cuerpo.
rụi'cuijcuij, rụi'cujcui'	Estar parado.
rụi'cujcuty, rụi'cujcus	El que está parado(a) (persona).
rụi'cu'tyity	(Hombre) Mortal, ser humano.
rụij	Correcto, justo, verdadero.
rụij cạqui, rụij cại'	Hacer algo correctamente, justo, directo.
rụijje'	Corregir, poner recto, decir la verdad.
rụijjoij	Acontecer.
rụijtye'	Hacer correctamente.
rụijtaquis	Corrección, reforma.
rujyetŝọij	Caer con explosión de arriba, del cielo.
rujyi, rujjajiti	Salir, atacar entre mucho (avispa).
rum tŝọij	Caer al agua.
rumu'	Llevar algo en la ropa.
run'quen'	Estar parado.
run'quen'yi	Pararse.
rupejchui'	Cerrar, encerrar, tapar.
rupejjeyaqui	Tapar, cerrar hueco, encerrar con cerco.
rä'eban' ịvaj	Disminución de la luna.
rä'i, rä'eja	Terminar, terminarse, acabar, gastarse.
räi'säjyi, räi'säjyi	Con la frente inchado, furioso, enojado.
räj	Todos, ambos.
räjjeyaqui	Terminar, terminarse, acabar.
räj qui', räj qui've	De buen tamaño.
räjĉan	Siempre.
räjen'	Casi todos, la mayor parte.
räjjotaqui	Terminarse, acabar.
räjqui', räjquity	Chuchío que esta en su medida.
räjyaty tạ́ra'	Choclo (maíz).
räm'yi	Tener calambres.
räñäjñäij, räñäjñäi'	Tronco seco, persona parada (que no trabaja).
rärä'ejoij, rärä'ejoi'	Contagio, extender a todos.
räsä'säyeva'joij	Paseando, mirando (leng. fam.).
räsh	Sano (no borracho), sano (no enfermo).
rätsä'je', rätsä'naqui	Embarrar algún objeto, embarrarse, volcarse en el barro.
rä'tsäij	Grueso, espeso, espesar.
rävä'väij, rävä'vädye'	Temblar de frio.
sa'baqui, sapjeyaqui	Amarrar.
sac tyeij	Levantarse, pararse rápido.
sac ja'yacsi	Hacer parar, levantar, enojar, alborotar.
sacjeyaqui, sacyi, sactaqui	Levantarse, salir.
sacacaj	Levantarse e irse (entre varios).
sacacdye'	Fruta.
sacan'je', saca'ñe'	Ajustar, endurar (la tuerca se tomó), dar volumen a la radio.
sacaqui	Chupar fruta.
sacavadye'	Clase de pescado (boca ancha).
sacñi	Marchitarse.
sacti	Salir, irse, empezar el viaje.
sacvaty	Clase de tela (con tejido abierto).
sadam	Captar, escuchar bien a una emisora, idioma.
sajaja	Mosquitero.
sạji'	Red para pescar.
sajquen'jeyaqui	Escurrirse, filtrarse.
sajrai'	Lugar bajo, abierto en el monte.
sajsajyi	Sisear.
sajvaij, sajvai'	Con aberturas, tejido abierto.
sama'	Mantener mojado.
sama'chui'	Mantener mojado.
sama'je'	Mojar.
samaij, samayeja'	Mojarse.
san'quejĉoij	Escribir en un libro, en una lista.
sana', sa'naij	Arrastrarse con la barriga.
sánacdye'	Escritura, mensaje escrito.
sana'je'	Derribar, hacer caer, enfermar, debilitar.
sánaqui, sáñe', sánete	Escribir.
sánaquis	Máquina de escribir, instrumento de escribir.
sancochaj	Sancochada.
sancochajje'	Sancochar.
sanje', sanyequi	Sacar uno, una flecha, un lápiz, etc.
san'jeyaqui	Escribir, anotarlo en la cuenta.
sapa'je'	Atravesar, cruzar, traspasar, llegar (honda de radio).
sapajpaquen, sapajpaquemun	Muy alto (serranía).
sapato	Zapato.
sapen'yi	Doler.
sapje'	Amarrar.
saptacdye'	Cosa amarrada.
sára'iij, sára'ii'	Hacer marico (bolsón que tejen los Tsimane').
sára'ij	Marco.
sa'sa'	Cerebro.
sasa'baba'	Están atados.
sasavintyi'	Clase de peta muy grande.
sa'si	Coca.
savte	Una planta usada a curar (injibre).
seijbo'je', seijbo'joij	Chirapudo, vestido de ropa vieja.
sei'je'	Cortar (carne, cuero).
seijva'joij	Chirapudo, andrajoso, volverse chirapudo.
seijvaty, seijvas, seijvaij	Ropa chirapuda.
sei'tacdye	Operación (no del vientre), circuncisión.
sei'taqui	Operar (no del vientre), circuncidar.
se'je', se'yi	Ponerse de acuerdo, admirar, estar contento de, querer.
sejnaqui	Cansado, con calor (animal), con palpitación.
sejsejyi	Cansado, con lengua afuera (como perro con calor y con sed).
sen'yi, sen'sen'yi	Respiración ruidosa, estertorosa.
sequej	Sangre de toro, árbol.
seque'nacdye'	Violín.
seque'naqui	Tocar violín.
sevaij	Ropa usada, vieja.
se'vaqui, se'viti	Escuchar, entender, obedecer.
sévayaj	Ciempiés, grande.
se'vetaqui	Escuchar, oír de.
seyaqui	Cortar.
se'yity, se'yis	Valiente, buen cazador, buen trabajador.
si'	Chala de arroz.
si'bacdye'	Chicote, guasca.
si'baqui	Azotar, guasquear.
sibuijje' - te	Lucha entre dos personas, esforzarse.
sicdye'	Plantación, producto.
sicojyiti, sicojyitiĉa'	Luchar a brazo.
sich	Salitre.
si'chaqui	Picar.
sichjajiti	Picar: mosquito, marihuí.
sidyi'dyiij	Picar: pulga, escocer.
sijje'	Sacudir árbol para sacar fruta.
sijnaqui, sijñe'	Sacudir planta sacar fruta.
sịjta'	Joporobobo (planta).
sijsa	Cerere de rio.
sijsijyequi	Temblar, sacudir.
síma'	Bibosi.
simi'	Chicha, bebida.
sinaqui, siñe', sinte	Barrer.
sinaquity	Escoba.
sinve	Orilla de río, laguna.
sinyi	Filo.
síñi, síñeban	Bajarse (hinchazón), marchitar.
siñiti	Andar por la orilla del (río, laguna).
sipjeyaqui	Azotar, dar un chicotazo.
sipi'je', sipi'dye	Herir (no matar).
siquijje'	Sacudir árbol, planta.
siren'yi	Gotear.
sírite	Cabeza seca, ave.
sirijje'	Dormir de borracho.
sirijnaqui	Tener relaciones sexuales ilícitas.
sirim'je'	Tomar, probar un poco.
siri'maqui	Tomar bebida poco a poco.
siriti	Salir poco, gotear (aceite).
sisja'	Entramos.
sisvaj	Entre.
sisdye'	Entrada.
siscajcaqui	Ir a ver de inmediato, ir de golpe, ir todos juntos.
sisij	Pez, simbau, buchere.
sistujtuqui	Venir de inmediato, ir de golpe.
sita'	Chala de maíz.
siti, siti', sisja'	Entrar.
siti, sitaqui	Entrarlo, encerrar.
sitiche' tsun	Oeste (literalmente: donde entra el sol).
sivijvi	Aleta de pez, ala pequeña.
siyamo	Cedro (árbol, madera).
siyajsiyaj	Sardina.
so'je'	Ensartar (pescado en liñada), figurativo: entrar, traspasar.
sóbacdye'	Paseo, visita.
sóbaqui	Pasear, visitar, viajar.
socyi	Afloja.
socsocyi'	Tener dolor de cabeza.
socjeyaqui	Bajar la carga de la espalda.
soco'raqui	Ensartar.
socor'je', socor'yi	Ensartar, pasear portadas las calles.
soijje'	Jalar, sacar.
sojoij	Llegar a ser dulce (como joco o camotes dejados en el sol).
sojquiti	Encostar, estacionar, llegar a su destino.
somaqui	Liar, hacer masa.
so'maqui	Dar a algún familiar.
so'me'-te	Da.
son	Palo, árbol.
son'	Varón, macho.
son' bu'yi	Potente, arrogante.
son' yu'ti	Dominante, potente, actitud de macho.
sona'are'	Pez, surubí.
sondaroij, sondaroyeja'	Ser herido, matado por soldados.
sóno'	Saliva.
sonojno'	Rocío.
sontica	Anillo.
sóñi', son'	Varón.
sóñi'yi, sóñi'yi'	Corajudo, portarse como macho con coraje.
sóñi'je'	Tenerle coraje.
sóñi'yedyes	Paz, fuerza (lit. para coraje).
sópe	Pared, muralla, corral.
sópeij	Cercar.
sópetuqui	Hacer cerco, corral.
soquemje'	Traspasar, bandear, penetrar (como frío en una heladera).
soro'ta	Huso.
so'taqui	Coser, ensartar.
sóto'	Pozo, cueva de animales.
so'vo'	Carne humana, cadáver.
sovocje'	Aflojar.
sọyo'	Demonio, Satanás.
sọyo'naqui	Criticar fuertemente, blasfemar, meterse en la brujería.
súbun, súbun'	Tapar (como hierba tapando la senda), llenar pozos.
sucyi	Sisear (gato, tigre).
suịjje'	Atolondrar, aturdir.
suịjjoij	Enloquecer, tontear.
sum'	Firme, duro, apretado.
sụmyui'tyi	Hacer entre muchos un trabajo.
surum'je'	Sorber, tomar un poco (despacito).
suyu'	Cabeza de grano (trigo, arroz).
sä'yi	Gruñir (humano, de hacer fuerza).
säsäcsa'	Uno que come frecuentemente.
säcsaquis	Cuchara, instrumento para comer.
säcsedye'	Alimento, comida.
säcsedyeij	Preparar comida.
säcsequi	Ir a comer, comer en pensión.
säcsi	Comer.
sän'	Sábalo (pez) en el idioma mosetén.
sänaquety, sänaques	Cadáver, muerto.
sän'dye'	Muerte.
sändyes	Destinado a muerte, para muerte, terminar en muerte.
säñej	En extremo, dormir muy pesado.
säñej tŝọij	Desmayar, caerse muerto.
säñequi	Ir a morir.
säñeti	Venir a morir.
säñi	Morir, eclipse de (luna, sol).
säntaqui	Perder a un pariente en muerte.
säntaquity, säntaquis	Huérfano.
särä'	Unidad, pieza de algo largo (palo, yuca, pala, arma, etc.).
särä' bu'yis	Mujer estéril, sin hijos.
sä'räban	Dejado en la playa o en el seco (canoa dejado cuando baja el agua).
sä'räij	Pieza, porción cilindrico.
särä'räij, särä'räyeja'	Andar con cosa larga en la mano (pala, arma).
sären'jeyaqui, sären'yi	Brincar de asustado.
säsäcsa'	Glotón, persona que come demasiado.
säsän'	Golondrina.
säsä'räräty	Piezas de palo, chuchío, etc.
sä'ti, sä'teja'	Encallado, atascar.
sätjeyaqui, sä'te', sä'tete, sä'taqui	Tapar botella, cerrar (puerta), llenar (de gente, mosquitos, humo).
sätje'	Cerrar, poner candado.
sättacdye'	Tapa (botella).
sättaqui	Tapar, cerrar.
sätsis, sättyity	Apretado, completamente lleno.
shababaty	Pulmón.
shạ́ban'	Borrar, limpiar.
shạ́biban'	Borrar algo de otra persona.
sha'bo'	Chulupi grande.
shacan'je'	Hacer girar perno, tuerca, encender radio, darle volumen, amasar en mano (bollo de barro), desgranar grano en la mano.
shacjeyaqui	Raspar, cortar.
shạcri' jeyaqui, shạcrijriij	Ebrio, un poco borracho.
shacrin'yi	Sucio de tanto caer.
shactaty, shactas	Áspero, cortante.
shachjeyaqui	Vaciar, botar, derramar en cantidad.
sháfai'	Cera del oído.
shại'je'	Pelar, separar, romper con la mano.
shaja'jaij	Sonar sonido débil: de lámpara, lluvia, motor.
shạjbe	Pejichi, tatú grande.
shạjbo'boij	Viejo con cabello blanco.
shạjbo'boyeban	Anciano viniendo con cabello blanco.
shajje'	Cernir.
shajmaqui	Hacer división con hojas.
shamtaqui	Tapar (como ropa en un cartón con papel).
shajraqui	Cernir.
shajraquity	Cernidor, urupé.
shajshadye've	En la gotera del agua.
shajshadye'	Gotera, canal del techo.
shajvas	Esponja.
shajyi	Sonido de pez nadando.
shamacdye'	Palo de balsa para hila algodón.
shamaqui	Hilar, poner doblar.
shamij	Hoja de motacú.
shamita'	Hoja caída y seca.
sham'je'	Blanquear, limpiar, borrar.
shamrui'ban, shamrui'ban'	Dormir sucio (idiomático).
shamruij	Dormir abajo en el suelo por estar borracho.
sham'taqui	Pintar su casa.
shan	Hoja.
shánajnai'	Concha.
shanajoij	Deslizamiento, desprender tierra, piedra de la serranía.
shandyes, shandyety	Color verde.
shaparyi	Sonido de hoja seca.
shaporo	Arete, aro.
shapuij	Enloquecer.
shapuijtyi', shapui'si'	Persona loca, tonta.
shaputui'	Persona que quiere tener relaciones sexuales (mayormente ilícito).
shạ́qui	Borrar, untar, pulir, limpiar.
shạ́quity	Borrador, toalla.
shara'	Árbol (cari cari),
sharaj	Churuno largo, calabaza monte.
sharje'	Hacer ruido en el monte.
shásha	Flor, adorno.
sháshadyes	Florero.
shasha'tata'	Atado, mazo de flechas, etc.
sháshatuqui	Adornar, poner adorno.
shashdyi, shashdyi'	Pasar varias veces, reproducir muchos, multiplicarse.
shatactyity	Múltiple, cable, hilos, etc.
shata'taij	Llevar flechas en la mano.
sha'vaqui	Apedazar, picar yuca para hacer chicha.
shavyi	Llorar, chillar, gritar, gemir.
shavdyij	Llorando.
shavnaqui, shavñe'	Llorar seguido, ser llorona.
shayaqui	Sacar la fibra de un árbol.
shẹi'je'	Romper alguna cosa.
sheijqueij, sheijqueja'	Chirapudo, andrajoso.
sheijquety	Persona con ropa vieja.
sheje'sheje'yi	Resuello ruidoso, estertoroso.
shejvin'dye'	Chiste, calumnia.
shejvintuqui	Chistear con algún familiar.
shejviñi	Chistear.
shepres, sheprety	Inútil que no trabaja.
sheresherej	Ventón, pez.
sheshejvintyi'	Uno que es chistoso.
sheshejvinsi'	Mujer chistosa.
shevajjeyaqui	Amontonar, juntar muchos.
shevan'je', sheva'naqui	Tostar (café, maíz, chivé).
shevaqui, shevva'te, shevte	Cortar con tijera, abrir lata.
shevaquis	Instrumento para abrir, cortar.
shevecjeyaqui	Cortar con cuchillo, tijera.
shevevejjeyaqui, shevevejjete	Cortar tela con tijeras.
shevi'vaqui	Cortar cuero.
shev'jeyaqui	Cortar, sacarle algo.
shevujriqui'	Clase de árbol (fruta como jabón).
shị'	Anta.
shi'are'	Clase de pez (cachorro).
shíbo'	Chonta.
shicanje'	Desmayar, aturdir, confundir, herir.
shicurity	Clase de pez (bagre pintado).
shichjeyaqui	Limpiar la nariz.
shidyen'yi	Mocoso, le sale moco por las narices.
shịdyi'dyiij, -i'	Estar con secreción mucosa.
shi'e'	Sucha.
shijmii'	Puntuda.
shijraqui	Sobar, friccionar, untar el cuerpo.
shim, shimtyi'	Delgado (tela, papel, cerco, persona).
shimaij	Tener manchas blancas en la piel o empeine.
shimaj	Enfermedad de la piel manchas blancas o empeine.
shim'shim'yity	Persona chismosa.
shímimij	Zapato pez.
shim'shim'yi	Ser malo, vivir mal, con enojo.
shínaij-i'	Pelo rubio.
shinaty-s	Persona que tiene pelo rubio.
shína'joi'	Árbol que se está secando las hojas.
shicavava'	Clase de rana.
shíñu	Langosta.
slip	Clase de insecto (petilla).
shípa	Casa de los brujos.
shipijraqui	Limpiar el oído.
shipna	Estera de hojas de chuchío.
shipnaij, shipnayeja'	Hacer esteras.
shị́ri	véase ÓYA. Lombriz.
shiricje'	Pelar, sacar pelo del cuero, tener las mangas de camisa enrolladas.
shiri'caqui	Arremangar: camisa, pantalón.
shị́shi	Ají pequeño (aribibi).
shitan'yi	Resbalar.
shitijje'	Botar, tirar por abajo.
shiva'	Parabachi.
shijvaca'cai', shijva'ca'caij	Enturbiar.
shivajnarety	Pez parecido al bagre o toro (tujuno).
shịva'vaij	Burbujear el agua (de un animal dentro el agua, de un neumático pinchado dentro el agua), enturbiar.
shivira	Sarna.
shiviraij	Tener sarna.
shóbo	Zapallo.
shocam	Atardecer, cuando entra el sol.
shocbedye'	Espuma, enfermedad de la boca.
shocdye'	Chicha.
shocdyeij	Hacer chicha.
shocjeyaqui	Lavar ropa.
shọ́co'	Tocura, langosta, salta monte.
shochyi	Resoplar, gruñir (animal).
shọi'dye'	Flojera.
shọijjoij	Estar con flojera, rendido, acobardarse.
shọijtaqui	Hacer bulla, acobardarse de.
shojbi'	Hinchar.
shojoij	Subir, aumentar (río, laguna).
shọjsho	Secreción mucosa seca.
shomeroroj	Sombrero, gorra.
shomon'je'	Envolver, cubrir, proteger, guardar limpia.
sho'pa'	Cuero, piel, cascara.
shopjeyaqui	Mostrar alguna cosa de una bolsa.
shoyi'yiij-i'	Flojo, tonto.
sho'que'	Tojo.
shoyi, shoijja'	Tener flojera, acobardado.
shu'	Palabra de auxilio.
shu'adye'	Robo.
shu'aij	Robar.
shu'atuqui	Robar algo de algún pariente.
shucaqui, shuque', shucte	Acerrar madera.
shu'caqui	Aserrar, cortar con serrucho.
shu'caquis	Serrucho, sierra.
shucben'yi	Echar espuma de la boca.
shu'ij	Ave, yacamí.
shuj	Correr, andar rápido, ¡Shuj! ¡Corra!.
shujshujyequi	Sonido de ave grande volando.
shujyi	Arder, reventar en llamas.
shujqui	Fiebre, con fiebre alta.
shuju'jui'	Sonido de fuego, de llamear.
shuju'jui'tyi'	Estar ardiendo.
shum	Estera, palabra genérica.
shum'	Jejene.
shumi, shumeja'	Hacer, fabricar estera.
shumur'	Lastimar músculo o piel.
shunje'	Bajar de arriba (de un árbol).
shupqueti	Llegar, salir a la casa de visita.
shupqui	Salir lo de adentro hacia fuera.
shupqui fi'tyi'	Orgasmo, tener orgasmo (hombre solo).
shupquiya'	Boca de río.
shụquen'sis	Enfermedad sarampión, viruela loca, granitos salen en el cuerpo.
shu'qui	Está borracho.
shu'queja'	Emborracharse entre varios.
shurcu' shurcu'	Andar, ir, salir, sonido de andar.
shurje'	Desatar.
shuru'	Chuchió.
shush	Carne, jane de fruta.
shúshi, shúshi'	Que tiene carne.
shushi, shushi'	Planta que dan papas dentro de la tierra.
shushu'aty	Hombre ladrón.
shushu'as	Mujer ladrona.
shäctäty, shäctäs, shäctäij	Áspero.
shäjä' shäjä'yi'	Tronar levemente, retumbar.
shäjä'jäi'	Sonido de lluvia en el monte.
shätejyi	Sufrir un golpe en el cuerpo, estar cansado.
shäti	Ropa que se achica.
shätiij-tii'	Comido por jochi colorado.
shätij	Jochi colorado.
ta'	Misa, para atar.
tạ'	Ají.
tababajjeyacsi	Agarrar, ir agarrando.
tạbaij, tạbayeban	Podrirse, madera, papel, etc.
tạbaty-s	Algo que esta podrido, papel, etc.
tạbedye'	Pescado.
tạbi, tạbeja'	Pescar.
tac	Diez.
tac tyeij	Que se emborracha y se enferma lapido.
tạcac bu'yi	No crecer, no desarrolla, sigue el mismo tamaño.
tạ'caij, tạ'cai'	Sobrar.
tacacajyi	Empujar, persona que empuja a otros.
tạca'cayequi (de ida), taca'cayeti (de venida)	Encostar callapo, aterrizar (avión), evitar peligro.
tạĉan	Quedarse, quedar todavía.
tạcaty	1. Persona que desde principio no cambia su carácter (buena, malo) 2. Que no tiene principio.
tạcche'	Quedarse.
tạco'	Hamaca de niño.
tacjete	Empujar, pasar (pelota).
tacjeyaqui	Volcar la ropa.
tacve	Quedarse allí.
tacve	Lado derecho.
tacvejtaqui	Pasar algún objeto del lado izquierdo a la derecha.
tacya'	Quedarse allí.
tacya'dye	Ahí mismo.
tachjete	Golpear, dar puñete.
ta'dyety	Que sirve para amarrar.
tạ'dyity	Olla.
tạij	¡Váyase! ¡Ándate!
tai'je'	Untar, pintar casa.
tai'jete, ta'yiti	Mecer hamaca.
tạijje'	Decir: ¡cuje! al perro.
tai'taqui	Pintar, dibujar.
tai'taquis	Pintura.
tại'ya'	En medio camino, medio del cuerpo.
taja've	En la orilla.
tajñi'	Pampa, paja.
tami	Dormir pesado.
tamiñi	Soñar.
tamin'dye'	Sueño.
tamin'dye'ĉan	El sentido del sueño.
tamintuqui	Soñarse con alguien.
tam'yi	Dormir un poco.
tana'caqui	Sacar cuero de animal.
tanacje'	Pelar, sacar piel.
tạn'joij	Cansarse, agotado.
tapĉhuc	Detenido, atrasado.
tapchute-i'	Tener agarrado.
tapĉhuja'	Tenemos agarrado, detenido.
tápi	Bejuco que se utiliza para amarrar.
tapje'	Agarrar, tomar, recibir.
taquem	Poder ver larga distancia.
taquen'	Entero, un paquete, unidad.
táqui o'yi	Sacar yuca, etc.
tạr	Pierna trasera de animal en división de carne.
tạ́ra'	Maíz.
táraqui	Lamentar, llorar por alguien.
tare'a	Tarea.
táredye'	Tristeza.
tári	Llorar, estar triste.
táris	Lágrimas.
tas	1. Todo. 2. Fin.
tasje'	Terminar, acabarlos, destruir todos.
tash	Adelante.
tashmuñi	Adelantar.
tashche'	Adelante, primero, antes.
tashche' tashche'yi	Sin vergüenza, agresivo rimero, el mas viejo, gran (hombre, libro).
tásheshei'	Claro, sin nubes, sin lluvia.
tashi	Adelantar, ir adelante, primero.
tashin	Pecho, seno.
táta	Papá, padre.
ta'ta'	Batán, para moler.
tátacdye'	Juguete.
tạtạjqui	Diente canino, colmillo.
tạ'taqui, tạ'tyeban	(leng. fam.) Comer.
tạ'tuqui	Ungir con ají el cadáver para castigar a que le hechizó.
távara	Clase de pez.
ta'yacdyes	Color.
táyen'	Clase de hormiga.
te'caqui	Tesar, templar.
tẹcjẹyaqui	Templar, tesar.
tecon'je', teco'naqui	Volcar la cabeza a mirar.
te'coty, te'cos	Torcido, inclinado.
tef	Satisfecho, lleno de comer.
tejcaqui	Templar cuero.
temtemje'	Tocar guitarra, harpa.
teracajca'	Carcana, ave.
tétev'	Ave de la pampa.
tibä'yaqui	Estar con, vivir con (en la misma casa).
tibu'	Cosa redonda, esférica.
ti'buij	Tener forma redonda.
tibu'jodye'	Tumor.
tibu'joij	Tener tumor.
tibun'	Globo.
tibun'jeyaqui	Comprar por pieza, lata (cosa entera).
ti'buty-bus	Redondo, esférico.
ticame'	Negar, no declarar.
tica'ñeban	Hacer regresar, devolver.
tiĉav'que'	Huir con, para proteger.
tịĉoshaqui	Dormir con (con sentido sexual).
tiĉoshte- she'	Dormir con.
ticrity vej	Tuerto.
ticun' bu'yi	Torcido, no recto.
tiĉunacdye'	Bienvenida.
tiĉuñe'	Recibir, saludar con gozo.
tiĉun'taqui	Recibir con gozo, dar la bienvenida.
tịchaqui	Obedecer, hacer caso.
tị́dye'	Cuerda, soga.
tịfajque'	Enojarse de algo.
tị'ij	Hacer nido.
tii'ti	Crecer bien (planta).
tịj	1. Nombre. 2. Nido.
ti'je'	Estirar.
tima'que'	Alabar, querer, apreciar.
tinataqui	Ir con, hacer pasear algún familiar.
tiranti	Palo, palo de casa, atravesaño.
tiri'rij, tiri'riyeva'joi'	Volar dando vuelta.
tiririjyi	Sonido de tener diarrea, ventosear.
tisira	Tijera.
titashe'	Anticipar.
titic	Grillo.
titij	Tipo de árbol, bibosi.
titso'chui'	Tener colgando en la mano.
titso'je'	Colgar.
titsojtsoij	Colgado.
titso'naqui	Basurear.
titson'jeyaqui	Llevar colgado.
tivencaqui	Llegar con (de ida).
tiventuqui	Llegar con (de vuelta).
tiventui'	Hacer llegar algún objeto o persona.
tiyacchui'	Comenzar, iniciar, empezar.
tiyacĉhutidye'	Principio.
tiyacchutis	Comienzo.
to'	Pozo, cueva, hueco.
tobiri	Clase de pez (boga).
to'biti	Brotar, salir espiga, flor.
tobono'	Tigre con cola corta.
tocac tŝọij	Quebrar, aplastar.
to'cacsi'	Filo.
tocaqui	Cosechar maíz.
to'caqui	Cortar, penetrar, gastar.
tocje'	Quebrar.
tocnis	Chuto, sin mano, etc.
tocnity	Revólver.
toco'je'	Tocar.
toco'ñe'	Tocar, tentar, hurgar.
tocyetac	Se quebró.
tọchje'	Cortar gajo, desgajar.
tọ'che'	Podar.
todocje'	Meter algo en la casa.
todocyi	Entrar en la casa, hueco, etc.
tofeij	Perder la vista.
tọfej, tọfety	Ciego.
tofero	Ciego.
tọfi'	Matico.
to'ij	Hacer pozo.
toj	Sonido de un disparo de arma.
tojje'	Disparar con arma de fuego a un animal o una cosa.
tojyi	Disparo de una arma.
tojti, tojjiti	Dispararse uno mismo con un arma.
tojnaqui	Aprender a disparar con arma.
tojboty	Barrigón, petacudo.
tojjete-je'	Golpear con puñete o dar cocacho a una persona.
tojñe'	Golear, apalear.
tojmai'	Obscuro, de noche.
tojmas, tojmadye'	Obscuridad.
tojqui've	Rincón entre dos paredes de una casa.
tom'	Punto.
tomajmai'	Algo negro, nublado.
tomaque	Se ahogó sin que nadie vea.
tọmaqui	Poner puntos en escritura.
tọm'dye'	Inundación.
tom'dyei'	Peligro de ahogarse.
tomen'	Difícil de distinguir, parcialmente invisible.
tomo'naqui	Espiar de noche a una persona.
tọmi	Ahogarse, hundirse, taparse con agua.
tom'tacdyes	Remedio para mal de ojo, gotas para los ojos.
tom'taqui	Ungir, poner gotas al ojo u otra herida.
tọn'	Tacuara para flechas, flecha con punto de tacuara.
tonoj	Cangrejo.
to'oij	Ponerse flojo.
to'oty	Flojo, sonso, tonto.
to'os	Floja, sonsa, tonta.
top	Sonido de explosión.
topsis	Pinchado.
topje'	Pinchar.
topyi	Explosionar, reventar.
toproty -ros	Petacudo (animal).
topti	Brotar.
toquin'je', toqui'ñe'	Quebrar: palitos, hojas secas, etc.
toqui'quiij, toqui'quii'	Quebrarse: gajos.
tore'saqui	Cacarear (gallo).
torin	Turril.
tóro	Bebida: chicha hecho de plátanos.
toro'je'	Pisar alguna cosa pequeña.
tor'quen'yi	Hacer redondo la boca al pronunciar la vocal o.
toshjete	Sunchar (con palo, hoja, dedo), distraer, llamar la atención.
tótop	Pachio de la pampa.
tovij	Pava campanilla.
tovoj	Estera cuadrada.
toyei'	Nombre de un tigre mitológico.
toyocje'	Arrancar fruta madura de plátano, guineo, etc.
trajtor	Tractor.
tịribity	Talón, tendón del talón.
tirivo	Trigo.
trubuty	Estómago.
turujruij	Estar en hamaca.
tuc	Traer.
tui'tyi'	Él que trae.
tuj	Pescuezo, garganta.
tujijtui'	Traer, hacer venir.
tujje'	Soplar corneta.
tujtaquis	Corneta.
tujtui'	Alzar, traer de paso.
tunaqui, tunja	Pulir, cepillar.
túneij	Aceitoso, resbaloso, lubricado.
tuntaquis	Lija, lima.
tụntụn tyei'	Lubricado, resbaloso, funciona bien.
tuptupyi-yi'	Hablar disparates, farsear.
tupudye'	Tiempo fijado, sazón.
tupuj	Alcanza, suficiente, posible.
tupujĉan	Por tarea, medida.
tupujjeyaqui	Calcular, tantear.
tupujtye'	Le hace (camisa, zapato).
tuputuqui	Medir, pesar.
tupuyaquis	Medidor, romana, instrumento para medir.
tuqui	Traer.
turaqui	Llevar colgado, estar en hamaca.
turen'je'	Mecerse: en hamaca, algo colgado.
turen'joij	Coto, tener coto.
turiti	Mecerse.
turu'	Colgado.
turubuty	Estómago.
turu'je'	Colgar.
turu'ruij, turujruij	Colgado, estar en hamaca.
tutuqui	Traer algo propio.
tútyi'	Piraquina, nombre de arbola.
täcnity	Corto, chuto.
täcnity un	Con manga corta (camisa).
täcräty, täcräij	Ciego, con mucho sueño.
täcren'yi	Con sueño.
täj täjjeyaqui täjtäjyi	Golpear seguido, machetear.
täj tŝọij	Tropezar, chocar.
täjete	Encontrar se el camino con otra persona.
täjje'	Hachear, tumbar.
täjnaqui	Hachear, cortar con machete, golpear, tocar (puerta).
täjaqui	Encontrar en camino algún familiar.
tä'maqui-i'	Picar (anzuelo), morder, masticar.
täm'je'	Morder.
täm'jeyaqui chu'	Estar callado, no contestar.
täm'jodye'	Ataque.
täm'joij	Tener ataque, boca cerrada no abre.
tänä'vaqui	Ira ver sin hablara la persona.
tänäcje'	Suspender la ropa.
tänäcjiti'	Pelar, sacar ropa.
tänäctum tyeij	Correr rápido, suspendiendo la ropa.
tänäjyi	Colgar ropa.
tänäjnäij	Estar flotando en el agua en la canoa.
tänä'joij, tänä'joja'	Letárgico, quiere dormir.
tänänäij	Andar en el agua en canoa.
tänen'jeyaqui, tänen'ti	Salir de viaje en canoa.
tän'je'	Visitar, aparecer de repente.
tän'vaqui	Espiar, mirar de escondida.
täräjnaqui, täräjyi	Tronar.
tärä'räij	Camión andando.
täräräty	Nuez de la garganta.
tärba'joij	Llegar a ser viejo, pescuezo arrugado, de viejo.
täryi	Bramar (tigre).
tätäcninis, tätäcninity	Troncos, pedazos de palo.
tä'tsitidye'	Cortadura, herido.
tätsaqui	Cortar: caña, cortarse.
tä'tsacsity	Peluquero.
tä'tsete	Peluquean.
tätscäi'	Final.
tätsi	Estar cortado, trancado, parado.
tätsitidye'	Herida con machete o hacha.
tätsiti	Cortarse.
tätsi'vaqui	Cortar tronco, plátano.
tätsje'	Cortar.
tätscäi'	Final, al final de (ubicación).
täyä'chui'	Someter, no separarse, estar fiel.
tä'yäij	Morder sin aflojar.
tä'yäj	Atorar.
täyä'jetaque'	Dejar enchufado alguna cosa.
täyem'chuqui	Estar fiel, someter.
täyem'yi	Morder, picar.
tsạ'	Vivo.
tsạbac	Sin dulce.
tsạbaqui	Desabrida, sin sal, sin azúcar.
tsạ́bu	Carachupa cuatro ojos, comadreja.
tsaca'	Sobaco.
tsacar'	Langosta, salta monte grande.
tsạ'chuqui	Hacer vivir, dar vida a, cuidar.
tsạ'edye'	Despertamiento, al otro día.
tsafa'	Hielo, granizo, helados.
tsafujje'	Regar con brocha.
tsam	Cuajo.
tsạ'si'	Ser vivo, vida.
tsa'ij	Despertar.
tsanaj	Ambaibo.
tsara'faqui	Capullo (grande y blanco en árbol, mágicamente enseña a las chicas a tejer).
tsạ'si'	Vida, alma.
tsạ'si' shush	Carne fresca.
tsạ́tsa	Concha del lago.
tse'	Madre.
tse' yụ'tacdye'	Madrastra.
tsédye'	Tía.
tsedyedye'	Noche, de noche.
tse'etaqui'	Enfermedad avanzada (género femenino).
tse'i'	Reproducir, multiplicar, infectar a todos.
tsejve'	Tocar campana o metal.
tse'tucdye'	Madrina.
tsevj'	Sonido de golpear (cabeza).
tsii'	véase TSÍQUI. Contar los números.
tsi'yi	Mamar.
tsi'ye'	Chupar.
tsịbi'	Microbios, moho.
tsịca'	Avergonzar.
tsị́cadye'	Vergüenza.
tsị́caij	Tener vergüenza.
tsị́cayeja'	Nos avergonzamos.
tsịca'jete-je'	Ofender con palabras vergonzosas.
tsịca'taqui	Avergonzar, tratar.
tsị́cataqui	Tener vergüenza de algún familiar o de algún objeto.
tsicdye'	Número.
tsịjtyi'	Hiel, vesícula.
tsim	Veneno de víbora.
tsimacdye'ĉan querec̣ha	Casa de recaudación de impuestos.
tsimane'	Chimane.
tsim'jete-je'	Escoger.
tsimaqui	Elegir, recoger (algo derramada).
tsim'dye'	Pedazos rotos de cántaro.
tsim'tye'	Escoger, recoger.
tsimtety querec̣ha ayo'dyety	Cobrador de impuestos.
tsin'caty, tsin'cuty -cas, cus	De color negro.
tsin'cuij	De color negro.
tsiñi'	Murciélago.
tsiñi	Hormiga.
tsiñi'tsiñi'	Clase de bejuco.
tsique'	Laguna.
tsíqui, tsi', tsíte, tsísin'	Contar, escoger, hacer lista, nombrar.
tsiquim've, tsiquim'ya'	Por la costa, por la orilla (río).
tsiquim'quedye've	Costa, donde el agua encuentra con la playa (no el barranco).
tsị'tsi'yi	Sonido, chillido de ratón.
tsịtsicaty	Vergonzoso.
tsịtsicas	Vergonzosa.
tsivjos	Frío.
tsivjoquety	Estar con frío (listo a morir).
tsịvujyi, tsịvjoij	Frío, estar frío, no caliente.
tsịvu'vudye'	Frío.
tsịvu'vuij	Tener frío.
tsomejmeij	Aún visible, visible todavía (no bien borrado), presente (después de procurar quitar).
tsom'je'	Poner gota.
tsontos, tsonto', tsonto'joi'	Gastada, punta redonda, que está muta.
tsorejre'	Tela de araña.
tsotsoj	Puerco espín.
tso'tyi'	Codo.
tso'vety	Jipijapa (para hacer sombreros).
tsudyujyi	Juntar, amontonar, reunir.
tsudyujnacdye', tsudyujñitidye'	Reunión.
tsudyujñitidye'	Reunión, congreso, ampliado.
tsujdyuij	Reunidos.
tsujdyujdyuty, tsujdyujdyus	Los que están reunidos.
tsufjete-je	Golpear con el puño.
tsufje'	Herir con flecha a un ave o animal en el pecho.
tsụn	Nosotros.
tsun	Sol.
tsúñedye'	Tiempo seco.
tsu'be'	Rellenar partidura.
tsuqui'	Panacú, cesta de hojas.
tsäfje'	Sonido de flecha lanzada.
tsä'qui, tsä'qui'	Taparse (la vegetación crece), crecer, el monte lo tapa.
tsäqui'	Peligro.
tsäqui'yity-yis	1. Peligroso, peligrosa. 2. malo, mala.
tsäqui' tsäqui' tamiñi	Pesadilla, soñar mal.
tsäquijquiij	Peligroso, pavoroso.
tsäqui'sis	Peligro, juicio (de Dios).
tsäqui'taqui	Sufrir: castigo, juicio, desastre.
tsäqui'taqui	Peligroso, trae susto.
tsätsä'quin	Maravilla, majestoso.
tŝaca'naqui	Pelar: yuca, palo.
tŝacan'je'	Pelar: yuca, animal.
tŝacje'	Arrancar, derribar, tumbar, sacar.
tŝẹ'jojyi	Toser profundamente.
tŝerac	Chonta para arco.
tŝic	Vagina de mujer.
tŝejtŝejyi	Cansado con la lengua afuera (perro) de enfermedad, resuello ruidoso (con asma) persona.
tŝi'ij	Hacer fuego.
tŝij	Fuego, leña, infierno.
tŝịj	Piojo.
tŝijĉan	En el fuego, infierno.
tŝítuij	Traer leña.
tŝin'	Cáscara: yuca, plátano, etc.
tŝin'dye'	Cáscara (plátano, etc.).
tŝiñen'yi	Dalearse, ladearse.
tŝiñenje'	Inclinar, puesto de un lado.
tŝi'ñiij- nii'	Inclinado.
tŝiv'	Peto, avispa.
tŝocon'	Ocoró fruta silvestre.
tŝọ́dye'	Aterrizaje, caída.
tŝọ́dye'ĉan	Pista, la parte donde el avión puede asentarse.
tŝọij, tŝọi'	Aterrizar.
tŝọ́ja'	Aterrizamos.
tŝọmchui'	Aterrizar, pasar de paso de retorno.
tŝọ́qui, tŝọij	Topar, llegar a, alcanzar fondo del río, etc.
tŝọ́taqui p̂eyacdye'	Oír de, escuchar de, le llega la noticia.
tŝọtŝoj	Puerco espín.
tŝúbaqui	Partiendo alguna cosa de uno mismo.
tŝu'baqui	Partir, romper lo que es de uno.
tŝubi'bii'	Partir de por sí mismo (pared).
tŝup	Partida, abertura.
tŝupje'	Partir.
tŝäpin'yi	Hinchar (pez, animal hincha cuando está con miedo o enojo), con pelo parado.
tŝäv	Barranco.
tyédye'	Bebida.
tyejá'	Ir por un camino, en cierta dirección, andar.
tyeij, tyéja'	Tomar, beber.
tyéqui	Ir a tomar.
tyéquis	Vaso, taza.
tyes, tyestyi'	Grueso, espeso (nube, etc.).
tyétacsi	Ir a beber con otro.
tyetyejcaqui	Nombre vulgar para chancho del monte el más grande.
tyi	Quién.
tyị'	Bi (árbol).
tyíbun	De venida, de ida.
tyicacdye'	Collar.
tyifcaqui	Ventear grano.
tyifje'	Sacudir.
tyịji'jiij, tyịji'jii', tyịji'jiyeja'	Tener dolor de oídos o de una herida.
tyijtyi	Quienes.
tyịjtyijyi-yi'	Doler, punzar.
tyimyi	Pesado.
tyimje'	Afirmar, asentar (tierra, una pista).
tyi'mu	Viento.
tyi'mutumsi'	Consonante con aspiración, lluvia con viento.
tyi'mutyi, tyi'mutyi'	Andar, viajar en el viento.
tyiquiqui'	Hormiga cazadora.
tyiraqui	Ablandar, hacer flexible.
tyị́reij	Color café, obscuro, morado.
tyis, tyísi', tyity, tyítyi'	Cuyo, de quién.
tyiti', tyitiĉa'	1. Llegar a cierta edad. 2. Llegar a cierta parte.
tyị'tuc	Pintar con bi.
tyuc	Sordo.
tyujcuty	Persona sorda.
tyucjoij, tyujcujcuij	Estar sordo.
tyucjeyaqui	Cerrar (los oídos), estar duro.
tyucu'maqui, tyucu'me'	Absorber, secar limpiar líquido con trapo.
tyuijmui'	Muslo.
tyuijñus, tyuijñuty	Colorado (color de animales).
tyuj tyuj tyuj	Sonido de caminar.
tyuja'	Palabra exclamatoria, usado en chistes, que menciona a la sexualidad.
tyujajje'	Disparar a un animal con escopeta.
tyujbuty, tyujbus	Gordo, con mucha gordura.
tyujcuij	Sordo, desobediente, sin oídos.
tyujcujcuij	Sin oídos.
tyujjeyaqui	Zapatear.
tyum' tŝọij	Caer desmayado.
tyumyejoij	Desmayarse.
tyumaqui	Chupar.
tyum'chuti	Tener paciencia, con control.
tyum'dyeij	Negro, espeso (como humo).
tyum'je' tyum'taqui	Chupar, mamar.
tyụm'je'	Apagar: radio, linterna, fuego, morir, desmayar.
tyụm'joij	Desmayar, agonizar, apagar.
tyum'taqui	Chupar (de sacar kerosén con manguera).
tyum'taqui	Apagar motor, lamparina, fuego (de su propiedad).
tyum'yi ĉojtyi'	Miedo, con miedo, asustado, desamparado.
tyúñe'	Suegro, yerno.
tyụ́qui, tyụcsi, tyụii', tyụ́te	Tener relaciones sexuales.
tyu'tyi'	Cumbre, remolino de la cabeza.
tyu'shi'	Gallina (lengua mosetén).
tyushje'	Violar, robar de, tener relaciones sexuales con.
tyushtye'	Tocar por primera vez (sexualmente).
tyutyu'ra	Palma real.
tyuyuij	1. Trabajar con goma. 2. Enfermedad del ojo, mal de ojo.
tyuyuj	Goma, hecho de plástico, cosa impermeable, honda.
tyäcärje', tyäcäryi	Sonido de golpear canoa con singa.
tyäjnaqui	Desbarrancar.
tyäpä'	Silencio, no hablar.
tyä'päi'tyi	Un rato, media hora, etc.
tyä'päj	No hay, no vino, no llegó.
tyäpi	Tardarse.
tyä́pi	Callado, no hablar.
tyäquij	Cepe.
tyäväi'	Papel, cuero, sábana extendida.
tyävädye' pan	Plumas de las alas.
tyä'väij	Papel, tela tendida en el suelo o en la mesa.
tyä'väty	Sábana, mantel.
úĉan	Aquí adentro.
uĉán	Debajo de.
uĉántyi'	Neumático, blader (de pelota), lo que es de adentro.
u'care'	Melero.
úĉhetute	Apuntar, interceptar, ganarle adelante.
úche'	Aquí arriba.
úduduj	Gallinita.
úve	Aquí al otro lado.
úya'	Aquí, aquí está.
u, uj	Ahí lejos.
ụ́bu'	Jasayé.
ụ́buij	Hacer jasayé.
ụ́buyeja'	Hacemos jasayé.
úĉanyaty, úĉanyas	Más pequeño, más guatoquito.
uij	Fuego, antorcha.
ujaij -jai'	Terminar.
ụjajyi	Llorar (bebé).
ujate	Lo mató.
ujaqui	Matar lo que es de uno.
ujru'naqui	Tronar (se oye de lejos).
ujtyusu'	Lobo.
úju	Mujer mitológica.
un	Mano.
unĉan	En la mano.
ụntyutyu'	Tapiti, conejo del monte.
ụ'nuij	Hundirse, caer en un poso.
ununu'	Reptil como jausi, lagartija.
unyaty pelota	Básquetbol.
úñedye'	Trabajo, empleo, labor.
úñedyety	Trabajador.
úñeyeja'	Trabajar, ser mozo, trabajar para otro.
úñi, úñe', úñete	Trabaja.
úñityi', úñity, úñis	Mozo, empleado, trabajador, esclavo.
u'puyuj	Clase de árbol (matico).
uru'	Manechi.
úrubej	Perico.
urucya'	El pasado, tiempo antiguo.
urum'	Insecto familia mosca.
ushnuty-nus	Opaco, opaca.
ushtururujnaqui	Reír despacio.
ututy, utu'yaty	Mediano, más grandecito.
uts, útsi	Este, ese.
utsĉan	En este.
utsí	¡Oye!
ụtsụtsụ'	Patito pun-pun.
úva'	Paraba.
ụjujyi	Forzarse, cansarse mucho.
úve, úvemun	Entre, en cada lado.
uvetaque	A este lado.
uveveruj	Londra.
uveya'dye	Antes de legar.
úya'	Aquí.
uya'qui', ọya'qui'	Excesivo, mucho (hacer mucha bulla, etc.).
úya' qui', ọ́ya' qui'	Hasta aquí, poner limite.
úyaty	De este lugar, de aquí.
uya'ya', ọya'ya'	Menos, inferior, poco menos.
uya'ya'dye, ọya'ya'dye	No lograr la meta.
uya'ya'taqui	Menos de, inferior a.
uya'ya'jeyaqui	Hacer menos, hacer inferior.
uya'yaty, ọya'yas	Menor que no tiene poder.
va'	Fallar.
va'ya'	Otro lado no donde debe ser.
va've	Otro lado.
va'acsequi	Véase VA'CAQUI. Botar el agua de un poso.
va'ajva'aj	Zorro.
va'bunyi	Mostrar orgullo, murmurar, hablar ofensivamente (abusivamente).
va'bunnaqui	Orgulloso, farsante.
va'bunyi	Jactarse, tener orgullo, meterse a lo que no es capaz de hacer.
va'bunyity	Él que se jacta, tiene orgullo, farsante.
va'cactyi'	Persona botada de un trabajo.
va'cacsis	Persona que le gusta botar a la gente de un trabajo.
va'cacsequi	Botar o llevar a otra parte.
vacam'quedye'	Ola.
vacam'qui'	Que tiene ola.
va'caqui	Sacar agua de la cuneta para que se seque o de la canoa.
va'que'	Botar agua.
vacje'	Echar agua.
vacunaij	Ser vacunado, vacunar.
vada'ĉa	Clase de fruta (pachío).
vaijje'-te	Llamar con la mano.
vaijjoij	Despintar.
vaijna	Vaina.
vai'joij	Caerse de un árbol, fruta madura que se cae.
vai'jos	Barranco muy alto.
vai'naqui'	Derrumbar, desborde del rio.
vaijnaqui -ñe'	Desbaratar, deshacer.
vai'ñi'	El agua cuando está hirviendo.
va'je'	Arrojar en la boca algo para comer (grano, chivé, etc.).
vaj meij	Recíproca, una al otro: vaj meij.
ñútyitidyeij in	Ellos se ayudan entre ellos.
vaj mu'ya'	Reunidos.
vaj mu'ya'taqui	Juntar, amontonar algo propio.
vaj vejti	Cara a cara, estar cara a cara.
vajac	Gusano venenoso, burro.
vajca'	Cuajo pico ancho.
vạjque'	Gastar, comer todo.
vajedyedye'	Fiera, animal grande.
vajna'na	Mariposa grande de color negro con azul.
va'joij, va'joi'	No tener éxito en cazar animales.
vạjpedye'	Cuatro.
vajru	Todos.
vanĉhui'	Abrir Ej: la puerta.
vanĉhute	Abrir, destapar.
vanchuqui	Abrir puerta cuando la casa es propia.
vanacje'	Abrir: puerta, cartón, lata.
vanaijje'	Deshacer, destechar, separar.
vanajmi	Clase de víbora venenosa.
vancaij	Estar abierto: puerta, olla.
van'jeyaqui, va'ñe'	Tragar, tomar todo de una vez.
vañinyi	Despertar, levantar, resucitar.
vañinti	Despertarse.
vápeyo'	Garza moreno.
vápi	Trompillo, árbol.
vạ'queĉúnaque'	Rechazar.
va'quicdyi	Por morir, bien enfermo, bien borracho, estado de coma.
va'quicte	Botar, empujarlo.
va'quicte	Botar, empujar, echar de la casa.
vára	Cartuchos de calibre 22.
varaijje'-te	Arañar.
vara'jos	Viruela loca, sarampión.
varaqui	Desplumar.
vara'shaqui	Llorar cada rato.
varashdyij	Estar llorando.
varishi	Carachupa.
vash	Pintón, casi maduro.
va'sharaij	Tener mala suerte.
vashi'	Bejuco, para embarbasquear.
vashna'	Chancho joven del monte.
vashtaij -tai'	Áspero.
vashti	Pintonear.
vashvashyis	Animal mitológico.
va'tacdye'	Castigo.
vata'chi	Oso oro.
vatajta	Paleta, hueso omóplato.
vatani	Clase de concha.
va'taqui	Tirar, disparar arma, castigar, recibir castigo.
váti	Llorar.
vátis	Lágrima.
váteja'	Lloramos todos juntos.
vátse	Clase de pez (carancho).
vátyequej, vatyquej	De repente, tal vez.
vatyequejdye	Al mismo rato.
va'tyiyin	Véase VA'TAQUI. Tener castigo.
vav	Espacio, campo.
vavdye'	Cuarto de una casa.
vavti	Casa abandonada.
va'va'	Quijada, debajo de la quijada.
va'ves	De otro lado que no tiene importancia.
va'ves p̂eyacdye'	Doctrina, enseñanza falsa.
va'vesĉan aca'	Casa: apartado, lejos.
vaya'bu'vich	Mala suerte, palabra usada por gente mitológica.
vayacjeyaqui	Borrar, desaparecer, perdonar pecado.
vayacyetaqui	Desparramarse, huir, esparcirse (animales).
veca'	Quijada.
vécaqui	Le picó la víbora.
vecdaij -dajoban	Curvo, torcido, no recto.
vecdas, vecdaty	Torcido (palo).
vecje'	Colgar.
vecjetyete	Trancar el paso.
vecjeyaqui	Enganchar, sacar con gancho algo propio.
vechen'je', veche'ñe'	Abrir: trampa, ojo, levantar.
vechoro'rojyi	Dar llanto, agonizar.
ve'ej	Visible, claro (escritura).
ve'ij-i', ve'eja'	Desvelarse.
vei'seij -sei'	Nariz grande.
vej	1. Ojo. 2. Semilla.
vej c̣homren'jeyaqui	Mirar con asco.
vej jị'caveyaqui	Mirar con asco, examinar los ojos.
vejdye'	Semilla de chonta, fina.
vejdyes	Para ojos, anteojos.
vejtaqui	Cuidar.
vejtuqui	Cuidar.
vejvacdyes	Medicina para mal de ojo.
vejvaqui	Tener mal de ojo.
vejya'	Cara, en la cara.
veme'	Llevar en el hombro.
vemen'je', veme'ñe'	Alzar, llevar en el hombro.
ve'mi, ve'meban	Atorar.
venai'quedye'	Rayo de relámpago.
venai'yi'	Relampaguear.
vena'yaqui	Relampaguear seguido, refucilo.
venchuij, venchuban	Llegar de regreso.
venjoij	Llegada.
veque'naqui, vequeñe'	Amenazar.
veque'queij	Colgado, sobre hombro, etc.
véqui	Cargar: hijo, trastes, otra cosa.
véra	Vela, luz eléctrica.
veracochaj	Caravana, persona de habla castellano.
vereshdyij - dyi'	Gritar, chillar de chanchos.
ver'je', ve'raqui	Romper: tela, papel, etc.
vesejseij -eyeja' -i'	Narigón.
vesen'je', vese'ñe'	Llevar hacha.
veshyi	Picar (gusano boro cuando pica).
vetsetsej	Caer en cantidad, derramarse.
vetsi'tsiij -tsi'	Caer, desprender (botón).
vetsje', ve'tsaqui	Desprender: botón, fruta, etc.; destetar.
vị'	Cuñado.
vicoi'	Clase de fruta (lúcuma).
viĉoĉo	Gorra.
vichuchujdyi	Ruido del tejón, etc.
vi'i	Hacer gancho.
víjitis	Clase de víbora.
vijre	Calucha de motacú.
vijri	Pachuba, palma.
vijtui'	Sacar, enganchar fruta, figurativamente: robar.
vijviya	Clase de ave (siriguero).
vijyo	Cañuela, pasto.
vinodye'	Puente.
vị'nuij (-i')	Largo, delgado: nariz puntado, cuchillo delgado y largo.
vị'nus vị'nuty	De nariz largo.
viñus	Descompuesto: cuerpo.
viñus	Descompuesto de los huesos.
viqui	Tejer hilo.
víqui	Cargar hijo, trastes, acomodar.
vị́qui	Tocar bombo, guitarra; pegar, golpear.
víquis	Mochila, maleta.
viraqui, virja	Desgranar maíz.
viricje'	Sacar todo: espinas, fruta de un árbol; caerse: engranaje.
viricyi	Caen muchas frutas juntas.
viririjyi	Chispear.
viroj	Caña de azúcar.
vírui'	Pacay.
vise'	Raspar.
visdaqui	Raspar, sacar escama de pescado.
vịsi' ịvaj	Luna menguante.
vịsịsị	Putiri.
visje'	Raspar, rasgar.
vịsujsuij, vịsujsui'	De mal olor (fuerte).
visun'dyi'	Parcialmente fermentado.
vịsu'suij	Mareado.
vịsu'suyeja'	Estamos mareados.
víshety -shes	Color gris, que brilla, ropa de buena calidad.
vishi'	Somó, maíz sancochado.
vishyi	Ropa luminosa, lustrosa.
vịté	Tocar instrumento musical, como ser: caja, bombo.
víte	Tapeque, comida para viaje.
vítidye'	Carga, mochila.
vitsicje'	Ligar, amarrar.
vịya'	Abuelo, nieto.
vịyandye'	Apellido.
viyocojco'	Clase de araña.
voc	Precipicio, barranco.
vocje'	Sacar pedazo de carne o cascara de un palo.
vo'co	Barriga, intestinos.
vo'coij	Destripar.
voco'	Carga, trastes que lleva en mochila.
voco'coij -coi'	Ir con bolsa, cargar (su bolsa de uno).
voco'je'	Dejar una bolsa lista para el viaje.
voco'naqui	Alistar bolsa para viaje.
vocon'je' vocon'tye'	Mosquear palo.
vo'cotute- tui'	Destripar, operar el abdomen.
vocraqui	Labrar, cortar, tallar, cavar: madera, palo.
vocrete	Labrar, tallar.
vocroij, vocroty -ros	Parte podrida, cavada en un palo.
vocro'joij, vocro'joi'	Carcomido.
vodo'doij	Andar gateando: cuadrúpedo (hombre o animal).
vodo' vodo'yi	Gatear.
vodojdoij	Parado (animal).
vodyen'yi	Hombre que se convierte en tigre, etc. Mitología.
voijdaqui	Liar, envolver, empaquetar.
voijje'	Liar.
vojco'	Cáscara (corteza): árbol, cuero de pescado, casco de peta.
voji'	Hermana.
vojity	Hermano.
vojitytuqui, voji'tuqui, vojitytuja, voji'tuja'	Hermandad (estar en hermandad).
vojityyetacdye'	Primo hermano.
voji'yetacdye	Prima hermana.
vojñi	Cáscara de chonta (concha).
vojpina	Tacuara gruesa.
vojraqui	Cavar en madera, cosa dura; ensanchar hueco.
vojro	Copa, palma.
vojrodye'	Víbora negra, acuática, yoperojobobo.
vojvo	Ají redondo, grande.
von	Caracol.
vonej	Sábalo.
voquen'je'	Cargar en la espalda: alimento, plátano, carne.
voravoraj	Borochi.
voryedye'	Saludo.
voryi	Saluda.
vórei'	Clase de rana.
vóri	Llamar, ir a llamar.
vóri	Lechuza.
vor'je'	Arrancar.
vorjetacte	Despedirse.
vorjeyactaqui	Despedirse de una persona de la familia.
vorjeĉúnaqui	Reprender.
voro'ros	Tigre mitológico.
voro'shaqui	Aburrido, vivir enojado.
voroshyi	Grito de los animales, como ser marimono.
voro'tacsi	Predicar, aconsejar.
voro'tacsity	Predicador.
voro'yi	Predica.
vorsa	Bolsa.
voryedye'	Saludo.
voryedyes	Carta, saludos escritos.
voryetacdyes	Despedida.
voryetaqui	Despedirse.
vóshi'	Bisabuelo, bisnieto, antepasado, descendencia.
vójshinaj	Toborochi.
vo'vodye'	Adulterio, concubinato.
vo'vodye'	Concubina, querido, amante.
vo'voij -voi'	Cometer adulterio.
vóye	Buey.
voyo'	Mono nocturno, mono michi.
voyo'tyity	1. Término genérico de víbora 2. tela, corte de tela.
vuc	Cachuela, caída de agua.
vụdu' vụdu'	Andar agachado.
vụdu'duij, vụdu'dui'	Andar acogido, agachado.
vụdui'je	Hacer inclinar.
vụdui'yi	Agachar la cabeza.
vụdujduij, vụdujdui'	Estar agachado, doblado, inclinado.
vụdujduj	Agachado.
vuijcu'	Clase de rana de color negro y comestible.
vurum'	Burgo cabeza azul.
vunyi	Daleado.
vútutuj	Yacamí.
väcje'	Arrollar, enrroler.
väctäjtäij	Vista solo la parte arriba de persona, animal, ave, etc.
väch	Espiga, fruta.
vachätyity	Soldado.
vächä', vächä'sis	Gorra.
vä'chäij	Engorrado.
vächäjchäij -i'	Casa, choza, medio techo.
vächäjchäs	Casa de medio techo, refugio.
vächje'	Cosechar, sacar fruta.
vächtaqui	Sacar, cosechar: una fruta, un racimo.
vädächyi	Levantar la punta de la canoa.
vädaqui	Cosechar, arroz, etc.
väij	Chonta.
väi'yi, väi'väi'yi	Andar: cojo, rengo.
väjnaqui -ñe'	Ladrar.
vämedye'	Casamiento, matrimonio.
vämi	Casarse.
vämtute	Casarse (mujer a hombre).
vämtyi'	Marido.
vämtyidyety	Novio, prometido de la mujer.
vänĉhäs	Pozo, hoyo, valle.
väñ'yi'	Tumbar: árbol, planta, etc.
väñ'joij	Caer de por si (árbol).
väñ'yi	Dislocarse, caerse de por si; en negativo: desobediente.
väñädye'	Mentira.
väñäij-i'	Miente.
väñäjyaqui, väñäjyete	Mentir de algo.
väñäjjeyaqui	Mentirle.
väñätuqui	Mentirle a su familiar.
väñätute	Mentir de algo.
väquir'yi	Moverse: algo aflojado, no sólido.
väquis	Misa de plátano.
väquity	Manija, atado, manojo de arroz, etc., mano de tacú.
väräcyi	Ronco.
väräshyi, varashyi	Llorar con grito.
väs	Excremento, estiércol.
väsaquis	Servicio higiénico, baño.
väsdyes	Remedio para diarrea.
väsedyes	Servicio, baño.
väsi	Defecar.
västaqui, västyete	Defecar sobre (tal cosa).
västyiva'ti, väsvaqui	Tener diarrea.
väsh	Fruta.
vạ̈sh	Tatú.
väshedye'	Tiempo de fruta.
väshi'	Frutear.
väshtätäi' -äyeban'	Caminar: peta.
väshtätäi'tacñi	Sábalo, pez.
väshtä'täraj	Clase de tela tejido a mano (traje).
vätäcjeyaqui	Mosquear un palo, hacer escalera.
vätäctacdye'	Palo usado para escalera.
vätäctaqui	Mosquear palo para escalera.
vätidye'	Pelea.
väväij	Clase de árbol (totoi).
väväi'dye'	Víbora coral.
väväjñity -nis	Mentiroso.
väväjti'	Demonio.
vävämejoij -joisi'	Adulterar.
vạ̈väs	Hormiga negra.
vä'yi	Asustar de algo.
yạ'	Crudo.
yabinyi	Asustarse.
yacchuqui	Dejaro abandonar.
yacchuti	Empezar, iniciar, comenzar.
yacchutis	Comienzo, inicio.
yacñi-ni'	Planta que se marchita.
ya'idye'	Pago, compra, sentencia.
ya'ij, -i'	1. Comprar algo. 2. Costo de alguna cosa.
ya'itaqui	Pagar deuda, cuenta.
ya'iyaque	Compró para el mismo.
ya'iyequi	Ir a comprar.
yạyajcai'	Dejar atrás.
yajcamaj	Río yacuma.
yạjcaqui	Dejar cosa de paso.
yạji'	Tamal de maíz.
yạjquiqui	Dejar, abandonar.
yạraquety -ques	Tieso de muerte.
yạri	Duro, tieso, cuando está muerto.
yajsi	Flecha sin plumas.
yajshaqui	Encerrar rio o laguna con hoja de motacú.
yamjoij -joi'	Tener mucha hambre.
yapa'	Sin tener nada.
yapa'naqui	Levantando la mano de enojo.
yapa'tyity	Palabra arcaica (camisa).
ya'pe'naqui	Enojarse con alguien, denigrar.
yaquin	Olvidarse.
yaquintuqui	Se olvidó.
yara'rai'	Aumentar el río.
ya'taj	Palabra antigua para tigre.
yạ'tuqui, yạ'tui'	Comer comida antes de coser.
yạ'si'	Crudo Ej: Tata ujate mumuñi mo'ya' dai' shush ya'si'.
yavyi	Mover, saltar de susto.
yạvituij -tui', yạvitudye'	Mal anuncio.
yaya'	Suegra.
yeja'	Digamos, algunos la usan para dar énfasis.
yejĉoij -ĉoja'	Continuar, progresar, multiplicar, crecer en algo.
yejnamca'cai'	Picar (pescado).
yemaqui	Llevar agarrado de la mano o ayudar a andar algún familiar.
yemen'je'-te	Agorar de brazo.
yenso	Lienzo, tocuyo.
yen'tyi -tyi'	Continuar con el mismo tema, seguir la misma cosa, insistir, persistir.
yéqui	Ir a decir.
yetaqui	Avisar antes de salir.
yéti	Venir a decir o avisar.
yi, yeja'	Decir algo.
yicdye'	Costumbre.
yictaqui, yictacsi	Acostumbrado.
yi'dye, yídye	Decir lo mismo.
yịjyi	Distintos, varias clases.
yin tyeij	Varios, distintas clases.
yinum'yis	Parásito intestinal.
yiri'	Una vez.
yiri'tac	Diez.
yiristum	De una vez.
yiri'tacĉansi	Ofrenda, diezmo.
yirity	Uno, solo.
yiris	Una, sola.
yirity bä'yi	Vive solo.
yirityityij	Uno por uno.
yirisisij	Una por una.
yiri'ya'	Todos juntos.
yita'raqui	Patear, jugar fútbol.
yíya', yi'ya'	Si es que dice.
yoc	Diferente, distinto.
yóĉandye' yóĉandyem'	En el lugar mencionado.
yocdyeij -dyei'	Diferente, distinto.
yocdyejyeja'	Estar distinto.
yocjoij	Que cambia cada vez más.
yoctyi', si'	Otro.
yoctyi'dye	No pariente o familiar.
yocve	Otro lado, lugar, otra manera.
yocvetaque	En otro lado.
yocvejtaqui	Poner otro lado.
yocvevej	Distinto, hacer en muchas maneras distintas.
yocveya'	Manera distinta, errada: doctrina, enseñanza.
yocya'	Otro lugar.
yocya'je'	Mudar, trasladar.
yocyejoij	Extrañar, tener pena.
yocyi, yocyi'	Cambiar, enseñar errado.
yocyoc	Distinto, variado.
yóche'	Estar ahí arriba.
yódyeijdyem', yódyei'dyem', yódyesdyem', yódyetydyem' (alt: yojdyeijdyem', yojdyei'dyem', etc.)	Lo mismo, de lo mismo.
yoj	Así, de esa manera.
yojcaty	¡Mire ese, como está!
yojdye, yojdyem'	En esta manera, como esto.
yojdye bo' o	¿No ves?, Ya ves como es.
yojna	Así, aun.
yojyojdyem'	Cualquier, cada uno, todo.
yojtumdyem'	Todos que lo que son.
yómo'	Tarde, noche.
yómodye'	Año.
yómodyeij	Durar un año o tardar un año.
yómoi'	Saludo: ¡Buenas tardes!, ¡Buenas noches!
yómoi'si'	Primeras horas de la noche.
yómoi', yómoyeja'	Anochecer.
yómoi've, yómo'qui've	Horas de la tarde.
yomojtacdye'	Cine.
yomomo	Colcha que nace encima del agua de una laguna.
yómoi've	El oeste.
yóque'	Aguja.
yoque'queroj	Burgo cabeza amarilla.
yoquij, yoqueja'	Ponerse triste, extrañar a alguien.
yoqui'dye, yoqui'dyem'	Hasta (ubicación), hasta el punto de, hasta donde, mientras que.
yorishi	Cabeza seca.
yósi'dye, yósi'dyem'	Al fin, después de tanto tiempo.
yoshoropaij	Gracias, agradecido.
yóvedyem'	Hacia, a donde, por ahí mismo.
yovi'	Anzuelo, liñada.
yovidyety	Liñada para pescar.
yo'vijvij	Tucán.
yovityi	Pescar con anzuelo.
yóya'	Ahí donde, a donde.
yoyocarej	Yura.
yụ	Yo.
yuj	Pie, huella.
yujches	Sandalia, Zapato.
yujve	Al lado del pie.
yujĉan	Parte baja de los pies.
yujya'	Ir de/a pie.
yum'jeyaqui	Poner un palo junto a otro para subir.
yuñij	Sin comer.
yúshi'	Oso bandera.
yushñuij, yushñuty -ñus	Color azul.
yụ'tacdye'	Ley, compromiso, autorización.
yụ'tactyi'	Soldado, oficial, encargado.
yútaqui	Pisotear, pisar, desgranar arroz.
yụ'taqui, yụ'te, yụ'tyeja	Poner, autorizar, dar encargo.
yu'ti, yu'tiĉa', (deriv: yu'taqui)	Llegar a ser, considerarse, pretender.
yu'tidyes	Envase.
yútyeja'ĉan	Debajo del pie.
yútyeva'caquity, yútyeva'caquis	Él que pisotea (arroz).
yútyeva'te	Estar pisoteando (arroz).
yútyi, yútyi'	Pisar sobre algo.
yäcäj	Duro, tieso, firme, bien tomado.
yäcäj ĉọ́qui	Hacer: sin ánimo, de mala voluntad.
yäcäñi	Madera dura (tajito, cuchi, etc.).
yäjcädye'	Poción, remedio de brujo.
yäjcäj	Duro.
yäcäty tạ́ra'	Maíz duro.
yäjdyä'dyä	Palo maría.
yäjquetaqui	Endurar.
yäjqui	Endurarse.
yäjquity, yäjquis	Paralizado.
yävätidye'	Siete.
yäväjtidye'	Guerra.
yävätij	Dispararse arma.
yäyäm' cati'	Contagiarse (enfermedad, idea).
ä	Ultima letra del alfabeto Chiman.
ä!	Hola.
ä'bäs	Tapado.
ä'bäty	Volcado.
ä'äm'	Ave nocturno, sumurucucu.
äbäbä'	Sapo.
äbij	Volcar.
äbi'vaqui	Enjaular.
äcäij yi	Repugnar, contra decir.
äcäijjeyaqui	Despreciar.
ächje'	Poner doble.
ächjeyaqui	Poner doble encima de otro.
äfäc	Hierva.
äj	Perdón, disculpe.
äjyi	Gritar.
äjdyij	Gritar varias veces, gritando.
äjquedye'	Grito.
äjjetaqui	Gritarle, espantar (hacer huir con gritos).
äjnaqui	Grito permanente de una persona.
äjsäty -säjsäij	Sucio, con ropa sucia, mugriento.
änac	Poner encima de otra.
änac ji'taqui	Colocar encima de otras como ladrillos.
äñäj	1. Cera de miel. 2. giba de toro.
ä'naqui	Amontonar.
äñ'jeyaqui	Acumular, amontonar, apilar, poner (como libros en el estante).
äñ'je'	Tapar olla u otro objeto.
äñ'yis, äpyis	Tapa, de olla, etc.
äñivaqui	Acumular alguna cosa u objeto.
äpjeyaqui	Volcar canoa, olla, etc. de uno mismo.
äpyi	Volcó.
äräjjeyaqui	Protegerlo, mezquinarle de algo (castigo).
äsäjje'	Dejar sucio alguna cosa.
äshen'yi	Ponerse muy triste como para llorar.
äts ätsjeyaqui	Acumular poner uno encima del otro.
ätsjeyaqui	Colocar encima de otro.
ätsi'	Montado.
ätsijtsiij	Montado en el caballo.
ätsijtsis	Palizada.
ätsi'naqui	Montar cada rato, engendrar.
ätsin'jeyaqui	Montarlo.
ätsi'tsiyeva'joij	Andar montado.
ätyäñä	Insecto escarabajo (que mueve heces).
ä'vä	Mate grande.
