achapu'u	Palabra que se pronuncia cuando a la persona no le agrada lo que le dicen.
achiskwa	Estornudar.
achichi	Estar manchado.
achichi:na	Manchar algo.
ajalo:maj	Contar. Relatar, narrar algo.
aja:pa	Acomodar algo. Arreglos.
ajato:to	Acomodar una coas tras otra.
aja:ra	Contar narrara relatar algo. Chisme.
ajarawa:nas	Cuento narración.
ajasi:pa	Cuentero, chismoso.
aje:łe	Escoger.
ajkabaycho:ni	Alguien que se mejora de una enfermedad.
ajkalo:wes	Estar acomodado(a), arreglado(a).
ajkalowescheł	Acomodarse, arreglarse.
ajka:pa	Acomodado, por ejemplo una cama acomodada.
ajkapa:na	Acomodar, poner en orden.
ajka:ra	Estar compuesto, arreglado.
ajkara:na	Componer, arreglar algo.
vi	Acomodar la cama.
ajkaye:na	Arreglar a alguien.
ajlomajcheł	Contar de si mismo, contar la historia de uno.
ajłabał	Andar a pie.
ajna	Separar algo.
ajpa	Estar guardado.
ajpa:na	Guardar algo en un cajón.
ajsi:kwa	Contar de su sueño.
ajtejni	Descansar.
ajtivijni	Calmar el dolor.
aj'imeł	Caminar de noche.
a:kay	Hermano(a) mayor.
a:lalas	Todas las veces.
alasełni	Chillidos estridentes por todas partes.
ala'kwa	Encontrarse entre varios.
albaycho	Amigo(a).
albijraneł	Juntos en el río.
alchiwanneni	Ser enemigo.
alcho	Al otro lado.
alcho:ni	Dividido en dos, por la mitad.
aldi	Lado opuesto, al otro lado del río, laguna o de una calle.
aldimmajye	Vivienda de la banda, del otro lado.
aldi:na	Ir al otro lado.
alimeł	Anoche.
alkaka:ye	Pariente.
alkapanełe	Comedirse, ayudarse.
alkapa:ni	Ayudarse.
alka:va	Insistir.
alkava:ni	En este momento.
alkawanłe	Al frente.
alkwe:ya	Compañera, hermana.
alla:kwa	Varón.
alle	Paisano, pariente, indígena.
allo:ba	Compañero, camarada de armas.
allo:cho	Compañero de farra.
allo:maj	Compañero de una acción.
alma:kilo	Apellido Almaquio.
almaro:ni	Compañero de ocio; dos personas ociosas.
alo:we	Saliva.
alpa	Ayudar.
alpanełe	Ayudar.
alpa:ni	Ayudarse, apoyarse.
alra	Amigo.
altu:ne	Dos personas de color.
altura:chi	Punta con punta.
alu'	Apegado.
alu'cheł	Apegarse, juntarse.
alu'na	Apegar juntar.
alwa	Con quien converso, dialogo.
alwaj	Esposo(a).
alwajni	Pareja de casados.
alwambeń	Papel de cuaderno.
alwanascheł	Hablar por uno mismo.
alwa:ni	Conversar, charlar.
alwaniwa:nas	Conversación ó forma de conversar.
alwiteł	Compañero(a) de castigo.
alwitełni	Castigados juntos.
al'imeł	Anoche, toda la noche, se dice cuando una actividad a durado toda la noche.
ama'poj	Meter una cosa dentro de otra cosa.
ama:ye	Embarcar a alguien.
ama'kwa'a	Vacío.
amba:łe	Enterrarse.
ambolo	Apellido Amblo.
ambuteł	Metido en el barro.
ambute:łe	Meterse en el barro.
amcho:łe	Ir en ancas.
amka:rim	Utensilios para guardar cosas. Canastas bolsa, cajón.
amloł	Metido en el agua.
amlo:łe	Meterse en el agua.
amłabal	Metido en la tierra.
amłaba:łe	Meterse en la tierra.
amme	Embarcado.
albu:ni	Comer juntos.
alchi	Su par.
alchi:ni	Apareado.
alchiwanne	Enemigo.
a:mon	Entrar.
amriko:neł	Embolsado.
a:na	Hermano(a) menor.
a:nana'ni	Hermano de mentira.
antipa:ra	Lentes.
anti:wo	Anciano, antepasado.
arandi	Chuchio.
arandimmo	Chuchial.
a:ray	Carau.
a:riwa	Arriba.
a:roso	Arroz.
aroso:ba	Pan de arroz.
aroso:di	Grano de arroz.
aroso:lol	Comida de arroz.
aroso:mo	Arrozal.
asbojeł	Sentado al pie de un árbol.
asbojełe	Sentarse al pie de un árbol.
ascheł	Sentarse.
asko	Aquello, eso.
aswa'a	Habitante de una casa.
asłol	Sentado(a) en el agua.
aslo:łe	Sentarse en el agua.
asłabał	Sentado(a) en el suelo.
asłaba:łe	Sentarse en el suelo.
asłe:du'	Batan.
asna	Vivienda, casa.
aspo:jeł	Sentado(a) en la estera.
aspoye:łe	Montar a caballo.
asto'maj	Vecino o compañero de vivienda.
asto'majeł	Estar sentado juntos.
asu'ni	Quedarse en algún lugar.
asu'tomajni	Vivir juntos.
aswa	Asiento.
aswa:nas	Vivienda.
a:te'	Redondo.
aware:sa	Abadesa.
awaro	Loro.
awaro:di	Loro pequeño.
awaro:joł	Huevo de loro.
ay	Ver entrada principal: Ayru.
aya	¿Cómo estas?, ¿Qué tal? ¿Ayakweł? ¿Cómo están? ¿Aya kos jeyan? ¿Qué tienes?
aya:na	Esperar a alguien o algo.
ayaye:na	Cuidar un sembradío.
aykapa	Crece rápido y ligero.
aya'aya:ni	Estar esperando.
ay:loba	Reunirse, estar reunidos.
aylobawa:nas	Reunión o lugar de reunión.
ayru	Esto. Aquí. (Situación demostrativa).
ay'ku	Tía.
a'ko	Esto; esa.
baba:kwa	Fruta.
babakwakwa'a	La papde la planta.
babalkwa	Nido.
babawankwa	Menudos de una res u otro animal.
ba:baycho	Estar enojado, acobardado.
ba:bu	Terminar de comer.
ba:chi	Nariz.
bachinki	El detrás de la casa.
ba:cho	Estar con diarrea.
ba:cho:kwi	Carbonizado.
ba:dineł	Agotarse la munición.
ba:do:don	Desangrarse.
ba:don	Estar sin sangre.
bajasła	Buche del ave.
balra	Ceja.
baka:ba	Cosechar, coger frutas.
ba:kalomajna	Malgastar, deshacer algo.
ba:kalomajwa:nas	Juicio final.
ba:kaloma:maj	Esfumarse, deshacerse, desaparecer.
baka:łe	Coger frutas, quebrar algo de algo.
baka:wa	Renegar, protestar.
ba:kawanne:cheł	Discutir, pelearse.
bakwa:kwa	Cabeza.
bakwaneła'a	Copa de un sombrero.
bakwanłe:kwa	Tronco. Alguien que encabeza algo.
bakwanyiń	Muñeca, antebrazo.
ba:le:les	Terminar de arder.
ba:les	Quemado.
ba:lomaj	Terminado, concluido.
ba:lomajna	Aguantar algo, difícil.
balo:si	Rosado.
balosi:mo	Ave rosada.
ba:loweskwiwa:wa	Terminar un evento.
baloweskwiwa:wa nas pieyesta	Pasó la fiesta.
balowesna	Alcanzarlo a alguien o algo.
ba:lowe:we	Despintarse, descolorizarse.
ba:ła:vij	Terminar de bañarse.
bałewkwa	Cola, rabo.
bałewa'a	Su cola.
bałła	Encía.
ba:mo	Rodilla.
ban	Pero.
bana:maj	Oso bandera.
bancho	Razo, limpio, despejado. Por ejemplo un patio sin árboles.
banełkwa	Cabo, mango.
baneła'a	su cabo.
banal:ri	Con piernas desnudas. Sin pantalón.
banne	Desnudo, sin ropa.
banwa:wa	Misterioso lago de que se cree que haya sido una ciudad.
bańdu'u	Cargado en espalda.
bańkarinwanra:ni	Lugar donde se colocan utensilios.
bańkwanłe	Estar puesto encima.
bańleseł	Estar puesto al fuego.
bańna	Poner algo.
bańsuneł	Crucificado, puesto a la cruz.
bań'ełe	Bautizar. Dar nombre.
ba:ra	Todo completo.
bara:na	Completar, terminar, acabar algo.
ba:ri	Pie.
barinkwa	Pata del animal separada. Mano de tatú.
barinwaj	Huella.
ba:ris	Terminar de caer una fruta.
ba:ruł	Se terminó su lengua.
ba:ruń	Codo.
ba:si	Talón.
baska:to	Tambalearse.
basto	Estar echado de costado. Estar ladeado.
basworo'no	Galápago.
bata:les	Prender fuego.
bataleseł	Ponerlo al fuego.
batamuń	Poner hojas de palmera en un techo. Colocar pluma de ave.
bata:si	Poner en el fuego.
bata:yaj	Huérfano.
batayajmo	Pollos huérfanos.
batejasra	Afanoso, trabajoso, difícil.
batejni	Insistir, bregar.
batesna	Padecer de una enfermedad.
ba:te'	Rendido.
ba:tus	Conejo.
batu'bojełni	Estar prendido en la planta.
batu'mołdi:ni	Grano en chala.
batu'ni	Estar puesto en su lugar.
bawabawa:ra	Tener deudas.
bawankwa	Basura que queda de la caña.
bawaskwa	Sartenejal.
bawanłe:na	Hacerle broma.
bawa:ra	Pagarle.
bawchołna	Reemplazar algo o a alguien.
bawiłna	Molestar a alguien.
bawlomajwa	Devolver un favor.
bawpa:na	Corresponder, intercambiar.
bawpane:łe	Desquitar, vengarse.
bawra:na	Cambiar, permutar algo.
bawrawa:wa	Espíritu, alma.
baw'i	Cuyabo.
baya:cho	Quebrar algo.
baya:ye	Dar paliza a alguien.
baybakwanyiń	Golpearse el antebrazo.
baybijełto	Arepa, alimento cocido al tiesto.
baycho	Quebrado.
baychojoł	Huevo quebrado.
ba:yeł	Cazar. Pescar.
bayłim	Chaco.
bayłimpa	Chacarero.
bayłinwa:nas	Chaco, chaqueado.
bayna	Golpear con un palito. Tocar un instrumento, por ejemplo el tambor.
bayvo:seł	Aporrearse.
bay'bi:jeł	Prendido de la olla.
bay'łełe	Prenderse en algo.
bay'na:na	Arrocillar.
ba:ełna	Completar algo.
ba'kwi	Conseguir.
ba'le:les	Arder.
ba'mayasna	Ir a la abra.
ba'na	Coger, cosechar con la mano, por ejemplo una fruta de un árbol.
ba'wiń	Empezar, comenzar.
bebeńkwa	Cuero.
bele:ka	Estar alegre.
bele'kabaycho	Estar de buen humor.
bele'wa:nas	Alegría.
bełlo	Rocío.
benabeńpa	Escritor.
bena:beń	Escribir.
beńra	Cielo.
beń'i	Pampa, llanura extensa.
beń'immaj	Estar en el campo.
beń'immajye	Persona del campo.
be:ra	Frente.
beranchinamo:kwa	Choquisuela.
besa:choł	Desprender algo.
besa:łe	Desprender algo.
beschoł	Estar desprendido. Pelado.
bescho:łe	Desprenderse.
besna	Desprenderlo. Pelarlo.
betełkwa	Yomomo. Curichi fangoso.
betełkwammo	Yomomal.
bewmo	Plátano maduro.
bewni	Madurar, ser madura una fruta.
be:yas	Nube.
beya'ka	Siquiera. Por lo menos.
be:ye	Flaco.
beye:poy	Animal flaco.
beyesni	Hediondo, con olor a osamenta; se dice sobre todo de ropa.
beyeye:ye	Persona flaca.
beyka	Pobrecito; da lastima.
beyka:pa	¡Qué lástima! me pesa.
beyka:ra	De a poquito.
beylo:maj	Flojo.
beyra	Poco.
beyrimeł	Barato.
beysi	Sueño. Soñar.
beysi:kwa	Soñar.
beysikwampa	Soñador.
beysineł	De pocas palabras.
beytej	Estar sin fuerzas.
be'łała	Pecho, tórax.
bi:chichiḿma	Tejón.
bichichiḿma:bał	Nido de tejón.
bichichiḿmames	Grasa de tejón.
bija:jaw	Mis viejos; se usa para referirse a sus padres.
bi:jaw	Viejo(a).
bijawni	Crecer, criarse, hacerse viejo.
bijawwe	Persona mayor que uno.
bijra	Orilla del lago, laguna, río, arroyo.
bi:law	Pescado.
bilawjoł	Huevo de pescado.
bilawła	Pececillo.
bilawpa	Pescador.
biłna	Rasgar.
bińna	Pellizcar algo o a alguien.
birińcha:ye	Masajear a personas.
birińchaye:pa	Persona que cura mediante masajes.
birińcheł	Friccionarse.
birińna	Friccionar algo.
bisa:choł	Deshojar maíz.
bisa:pa	Hacer algo, llevar a cabo una actividad.
bisi'na	Dar en el blanco; tirar con buena puntería.
bisi'ne	Persona puntera; con buena puntería.
biso'	Persona que tiene habilidad.
bispa	Tener conocimiento, saber.
bispa:ni	Llegar a saber.
bisra	Ser posible.
biswa	Saber hablar.
bite:łe	Arañar; pellizcar ligeramente.
bito'	Viejito. Palabra de cariño.
bo	Por que. Para que.
bo:boj	Parte trasera de una embarcación.
bobojkwa	Tronco, popa.
boboja'a	Su tronco del árbol.
bobojkwakwa'a	Su tronco del árbol.
bocho:mo	Cascara que usaban como vestimenta los nativos.
bojchinkwa	Filtro del cigarrillo. Pedacito.
bojełkwa	Parte del tronco.
bojkoń	Tucunaré.
boko:na	Aconsejarle a alguien.
bokowe:łe	Dar consejo, aconsejar.
bo:law	Príncipe del agua.
bolawmo	Silvaco.
boła:pa	Raspar yuca.
bołna	Raspar algo.
bo:łoḿ	Recto, derecho.
bołoḿ'i	puesto derecho.
bonko	Mauri del grande.
bońyełna	Vaciar.
bońcho:na	Desquitar algo.
bońpoyna	Cambiar los caballos.
bońra:na	Reemplazar algo. Cambiarlo.
bo'wa:wa	Cambiar de lugar.
boń'ojeł	Cambiado de ropa.
boń'ojełe	Cambiarse de ropa.
bopońcho:pa	Aplaudir.
bore:na	Defender algo.
borewanra	Objeto para defenderse.
bo:sa	Brazo.
bo:siń	Murciélago.
bosi'	Lengua de panza.
bo:te	Prestarse.
botepojna	Prestar algo.
bo:ve	Soplador.
bovemo:ba	Jasayé pequeño.
bovijkwa	Chala.
boya:lo	Tomar chive preparado.
boyboy	Tamal.
boyboylo	Chive con agua, reboleado.
bo'chonamo	Barbecho.
bo'tej	Insistir.
bo'we	Oculto.
buwa'ni	Calor agradable al cuerpo.
bubuńkwa	Barro, masa.
bubuńkwambij	Olla de barro.
bubuńkwanti'	Ir por barro, hacer barro.
bubuyaka:pa	Viento huracanado.
bujdi	Hilo.
bujdinmo:ri	Flor de algodón, algodonero.
bujru	Humo.
bujru:kwa	Ahumado.
buka'	Estar en movimiento.
bura:da	Delante.
burankwi	Jopo, cresta.
bu:ray	Anguila ordinaria.
buskwa	Genital femenino.
busuńna	Echarle sal.
busuńni	Salado.
bu:tuł	Especie de papa conocida como gualusa.
butułloł	Comida de gualusa.
butułti'	Ir por gualusa.
bu'karani	De repente.
bu'ni	Quizás.
chabo:na	Cipío (avecilla).
charcha	Cacaré (ave).
cha:da	Martín pescador (ave).
cha:do	Plato.
chajampojkay	Me da vergüenza.
chajani:wa	Con vergüenza.
chajanni	Vergonzoso.
chajampojni:ra	Cosa que hace dar vergüenza.
chajdu'cheł	Encaramarse.
chajkwa	Teta, ubre de animal.
chajna	Aumentar algo, añadir.
chajpińcheł	Añadirse.
chaj'i	Mi seno.
chaka:cho	Punzonear, hoyar; por ejemplo en el chaco.
chakakayra	Achachairú.
chakatora:wa	Pala.
chake:łe	Sunchar con arma blanca.
chala:di	Jarca (árbol).
chaladimmo	Jarcal.
chaladiti'	Ir por jarca.
chamaloł	Echar algo en un líquido.
chama:mi	Aumentar agua.
chama:ye	Echar algo en algo.
chamo:mol	Encresparse.
champa	Piedra.
champammo	Cerro con piedras.
champandi	Cascajal.
chamunkaloba:ni	Erizar del cuerpo.
chamu:yas	Bello, belludo, lanudo.
chaḿmo	Monte, bosque.
chaḿmo:na	Ir al monte.
chanjes	Cornamento de ciervo.
chanko	Frazada, colcha, abrigo.
chankocheł	Taparse, abrigarse.
chankwa	Cuerno, asta.
chanla:vał	Sombra.
chanlava:łe	Ponerse a la sombra.
chapa:ye	Paire, casuela de barro cocido.
chapujni	Áspero.
chapunkwa	Jane; la materia que se encuentra debajo de la cascara de una fruta; la carne de un humano o un animal.
chara:ye	Caña de azúcar.
charape:lo	Niel de caña.
charki	Charque.
cha:soy	Agrio.
chasoyba	Naranja agria.
chasoyni	Sabor a fermentado.
chata:di	Cosechar granos.
chata:mo	Cosechar maíz.
chatełni	Abiscocharse, por ejemplo en el horno.
chavo'	Raya.
chavo'łełewmo	Cien pies.
chavo'mes	Aceite de raya.
chawa:cho	Tostar chive.
cha:wan	Especie de paraba.
chamba	Serere del río.
chamba:joł	Huevo del serere.
chawna	Batir algo.
cha:yał	Bosta de pez.
chayałvas	Bosta de pez molida y cernida.
chaya:wa	Chayava (apellido).
chaychi	Resurtir.
chayi:ma	Chaima (apellido).
chaywa	Contestar.
chaywanełe	Contestar, responder.
cha'di	Cerco, típicamente de curi.
cha'kałałba	Balsamina.
cha'kwa	Boca arriba o mirar hacia arriba.
cha'ła	Horcón.
cha'na	Sunchar algo.
cha'pa	Bastón.
cha'poj	Estar plantado.
cha'si	Estar empinado.
cha'ves	Cerco.
cha'vos	Poste.
che	Y.
chejta	Cuñada, termino usado entre mujeres.
chekascheł	Representarse.
chekasna	Representar algo.
che:kwes	Tarumá.
chekwesła	Fruto del tarumá.
chele:bo	Chelebo (apellido).
chele:ka	Especie de loros cotorra.
chelna	Sacar algo de a poco.
cheła'a	Déjalo.
chescheł	Esponjarse.
cheslo	Turbión, crecimiento del agua.
che'che'e	Antojarse, sentir deseo de algo que uno no puede tener.
che'kapojna	Hacer sentir deseo a alguien.
chichamra	Pochi, planta acuática.
chichanramlo	Agua donde hay pochi.
chi:chi	Salir.
chichi'ła	Marigui.
chido:don	Sangrar, verter sangre.
chi:jeł	Hormiga.
chi:ji	Ají.
chikaba:ba	Hormiga cazadora.
chika:pa	Sorprender, pillar a alguien haciendo algo.
chika:wa	Chicaba (apellido).
chika:wa	Sorprender hablando a alguien.
chika:ye	Encontrar algo.
chiki:lo	Golondrina.
chikilo:joł	Huevo de la golondrina.
chi:ko'	Tordo.
chile:les	Evaporarse.
chilna	Propinarle, sobornarle a alguien.
chi:loj	Tapeque.
chilojcheł	Tapequearse.
chilo:lo	Dejar pasar el agua.
chimili	Picaflor.
chimpa	Corona, por ejemplo de la casa.
china:cho	Ordenarle a alguien. Empleado(a).
chinała	Yuca.
china:mo	Rodilla.
chipojlababałkwanra:ni	Maquina fotográfica.
chipojna	Sacar algo o hacerlo salir.
chi:ra	Perfume o aceite fragancioso para untarse al cuerpo.
chiraskwa	Tripas.
chiraskwanwo'wo	Cebo de la tripa.
chira:ti'i	Aceitarse el cuerpo.
chirima:ni	Chimani (apellido).
chiri:wan	Tacuara.
chirwła	Pájaro pequeño.
chisa:was	Bajío.
chisawascho	Poza parte de un bajío.
chisisi'	Burbujear.
chi:tań	Tarechi. Loro come arroz.
chi:ya	Chuvi, ave de rapiña.
chi'chi	Maní.
chi'china:na'	Piñón.
chi'i	Excremento, bosta.
cho:cho	Cotiví.
chochobakwa	Oído.
chocho:kwi	Parrilla, molde.
chocho:łim	Infierno.
chochołkwa	Calucha, almendra.
chocho:res	Ano.
chochokwankwa	Concho del agua u otro liquido.
cho:dis	Matico.
chodo:wi	Barriga. El interior de una casa. Debajo de un mueble. Interior de un tejido; lo que no se ve.
chojkwa	Orinar.
chojlo	Orina.
chojlolo:muy	Coñera, mosca diminuta.
chojsi	Orinón.
chojsicaha'kwa	Querer orinar.
chojwamba	Vejiga urinaria. Bacín.
chokwammo	Panza.
chokwammowo'wo	Cebo de la panza.
choli:ma	Cholima (apellido).
cholo:ma:maj	Recaer de una enfermedad.
chompa	Totora nudo ciega.
chonajna	Devolver algo. Colocarlo en su lugar.
chona:ra	Adivinar, decir la verdad.
chona'naj	Volver a casa.
chondini:wa	Víbora yoperojobobo.
chondusłe	Estar a la vista, visible.
cho:ne	Cuidado.
cho:ni	Mano derecha, lado derecho.
chonjeł	Hormiga brava.
chonlo	Ir directo.
chonlo:maj	Es cierto, es verdad.
chonlo:wes	Día del festejo.
chonsi	Mediodía.
chonsineł	Idioma nativo.
chonte'	Acabar de morir.
chonveni:wa	Canoa.
chon'oj	Tipoy.
chon'ojeł	Estar vestida de tipoy.
choń	Cada vez, siempre.
cho:pa	Mano.
chopayni	Salir de pena terminar.
cho:ra	Mi ojo.
chora:da	Calle.
choradaneł	Calle de uno.
chorammo	Tábano grande.
chorankwanto	Sombrero.
cho:ri	Chori (apellido).
chorimpa	Uña del pie.
chorimpoj	Uña del pie.
chorni:ni	Chormini (apellido).
chosdi	Cuervo margullón.
chosoma'ni	Tirarse o caerse al agua.
cho'vaj	Paladar.
chovajdimpo	Cuello de los dedos. Sobaco, axila.
choy	De verdad.
choya:lo	Vomitar un líquido.
chowiń	Sobaco, axila.
choykabaycho	Arrepentirse.
choymuj	Viento del norte.
choyrey	Si pues, claro.
choysi	Retroceder.
choyte'	Resucitar, revivir.
cho'ba:łe	Taparse bien.
cho'es	Feo. Sucio.
cho'eslowe	Que camina feo.
cho'eskakaye	Mal del estomago.
cho'esni	Ser feo. Sucio.
cho'espojkay	Me da asco.
cho'esye	Persona fea.
chu:chu	Cachorrito.
chuchuchi	Urucú. Planta utilizada para teñir ropa de color anaranjado.
chuchu'	Pene del niño.
chu:jań	Motacú.
chujańdi	Fruta de motacú.
chujammo	Motacusal.
chujańmuń	Hoja de motacú.
chu:kul	Picazón, cosera, escozor.
chukula:te	Chocolate.
chukulni	Me pica.
chukuwampa	Totora fina.
chulumna	Chupar algo.
chumaycho:na	Hacer humo en un cuarto.
chumayna	Humear algo.
chuydimsi	Mosquito puguilla.
chu:na	Hurgar, zunchar algo para ver qué es.
churudu'a	Su punta.
churo:kwa	Punta de la caña.
churo:na	Ir a la punta.
chusa:pa	Mostrar algo.
chusa:waj	Mostrar un lugar.
chusbo'	Pacaí (árbol).
chuscheł	Persinarse.
chuse:łe	Apuntar.
chuskaba:ba	Bello en la parte genital de la mujer.
chuskabeń	Piel belluda.
chuskachuskwa	Bigotes.
chuskalo:ri	Bello en la parte genital del varón.
chuskamo:ra	Persona con barba.
chuskwa	Pico, hocico.
chuswanmi	Agua bendita.
chutacho:pa	Entregarle en la mano a alguien.
chutatachopanriyasa	Entregar en manos propias.
chuta:les	Prender fuego.
chuwi:sa	Cardenal (ave).
chuya:kwa	Tapar una apertura con algo que no es específicamente su tapa.
chuya:ła	Hormiguero, posetacú.
chuydi	Abeja.
chuydimayle	Petoabeja.
chuydimba	Cera.
chuydinlo	Miel de abeja.
chuykwa	Tapado.
chuyna	Espesar o calafatear algo.
chuyu:wa	Gato montes.
chuyuwambeń	Cuero de gato montés.
chuyuwanmes	Grasa de gato montés.
chu'	¡Dejá!
chu'na	Hurgar con un palo, por ejemplo una fruta para que caiga.
dachisna	Rociar con gotas grande de agua, por ejemplo con una tutuma.
dachis'i	Rociado, regado, bendecido.
daja:cho	Cobrar algo.
daja:ja	Preguntar por algo. Pedir algo.
daja:wa	Preguntarle a alguien.
dajawane:łe	Preguntar.
dajkwanascheł	Encomendarse.
dajkwanasłena	Pedir, orar por alguien.
dajna	Alzar algo.
da:ka	Ceboro, cangrejo.
daka:cho	Partir o cortar, especialmente el cuerpo en una cirugía. Partir la sandia.
daka:tu	Degollar.
daku:kul	Descomponer, por ejemplo cuando uno se quiebra un hueso.
daminni	Carne por demás de flaca.
damna	Buscar piojos.
damoyloł	Estar exprimida una fruta o una caña.
damoyna	Torcer algo.
damoy'i	Estar torcido.
dam'i	Piojo.
dam'immo	Garrapatilla.
danka:ba	Todo mordido, por ejemplo una fruta.
danna	Masticar algo.
danuyni	Duro como la goma.
dapilna	Darle la vuelta a algo.
da:rań	Valiente.
darańpojcheł	Hacerse el valiente.
dasachocha:vos	Labrar madera.
dasa:mo	Rosar, desmontar.
dase:łe	Hachear.
dasna	Hachear, cortar algo con un machete.
davulcho:di	Especie de soga.
davuldi	Liña, pita entorchada.
davulna	Hilar, torcer algo.
dawanmo	Canasta que tejen los collas.
dawjes	Ciervo.
daya:buń	Dejar fermentar una masa o un barro.
dayachołwi:teł	Estar acostado después de un castigo.
dayajna	Traste, pertenencia.
daya:moł	Dejar en el monte.
daya:ra	Poner algo en el suelo.
daya'	Estar sentado o echado.
daychoł	Adentro de una casa.
daydaywi'na	Avanzar.
da:yim	Tristeza.
dayimkay	Lo extraño, me hace sentir triste.
dayimni	Que da miedo.
dayimni:wa	Tener miedo.
daykabaycho	Estar pesaroso(a).
daykaka	Siempre hasta ahora.
daykara:na	Dejar o asentar una cosa en el suelo.
dayko	Debajo de algo.
daylo	Ambiente tranquilo.
daylo:va	Lastimado, herido.
daylova:na	Lastimar o herir a alguien.
dayima'ni	Desaparecer.
daytereschoł	Estar acostado(a) en el centro del cuarto o la cama.
da'ra	Piyu, ñandú, avestruz.
da'tu	Degollado.
da'tucheł	Degollarse.
de:cheł	Acostarse.
de:chijni	Acostarse juntos.
dede:ye	Estar visible.
deja:jal	Cocinar.
dejdejra	Carne sancochada.
dejna	Sancochar algo, cocer algo en agua.
daka:łe	Ser capaz de alzar algo pesado.
deke'mu:muj	Viento del oeste.
deku'ni	Quedarse acostado.
de:kwes	Liendre, huevos del piojo.
dela:kwa	Brasa.
dela'wa	Dizque, dicen.
deltoveń	Mariposa.
de:łe	Estar acostado marido y mujer.
deńchoł	Estar frito.
deńchołba	Frito de harina.
deńchołmo	Plátano frito.
deńchołpa	Yuca frita.
deńchołra	Carne frita.
deńdeń	Estar infectada una herida.
deńna	Tostar algo.
deń'i	Tostado.
de:pa:na	Ver lo que alguien hace y no entenderlo.
dere'to	Arepa.
desa:kwa	Saltar a algo.
desayni	Esfumarse, huirse.
descheł	Brincar, saltar en el piso.
deskalo:boj	Brincotear cuando se baila.
despu	Mono nocturno.
deta:choł	Fritar en manteca o aceite.
deta:di	Curucusí o luciérnaga.
dewajkwi	Tener una buena vista.
dewajna	Ver algo.
de:wajna	Ver las huellas de alguien o algo.
deya:łe	Acostarse con alguien.
deyałechakwe:ya	Acostarse con una mujer.
deyałe:mo	Ave que está empollando.
deyałe'a	Acostado con alguien.
deyko	Debajo de algo.
de'de'bakwa:ni	Con la cabeza levantada.
de'kała:ri	Suspender las piernas a cada momento.
de'łe	Pesado. Levantado.
de'łełe	Suspendido.
de'piń	Estirarse.
di'bakwa	Almohada.
dichi:ye	Niño(a).
dichiyenjeł	Hormiga chotota.
didinkwa	Semilla. Estrella.
didi'	Querer hacerlo, pero no.
dijoyni	Magulladura.
dila:cho	Apretar algo.
dili'na	Aliñar algo.
dilpoj	Arrimado, apoyado.
di:mas	Paja que se usa para techar.
dimasdi	Casa con techo de paja.
dimbaychovałna	Procurar algo.
dimmo	Ombligo.
dimpa	Dedo de las manos.
dimpoj	Dedo del pie.
dineła'a	Su mango o cabo de un machete, pala, hacha, etc.
dinełbakwa	Nuca, cerebro.
dinła	Jajo.
di:noj	Muslo.
dino'	Pesado.
dino'ni	Ser pesado, volverse pesado.
dinra:kwa	El jachi de la harina.
dinsi	Nalga.
dińbaychovałna	Insistir en tener algo.
dińchoba:kwa	Cabeza dura.
dińka:ye	Apurarse.
dińmuj	Viento fuerte.
dińra	Duro.
dińrimeł	Caro.
dińtej	Fuerzudo.
dińtejcheł	Hacer lo posible.
dińtejna	Con más fuerza, con más ahínco.
dińtełe	Hacer el esfuerzo.
dińtokwi	Corredor.
dińvaw	Corriente fuerte de un río.
dińwel	Sol caliente.
di:ra	Todavía.
di:rał	Llegar a su pueblo de origen.
dirałe:na	Llegar con algo al pueblo.
di:re	Bien arrimado para no caerse.
dis	Indica que la acción no a realizado todavía, solo está la idea.
disłańwa	Ojalá.
disoy	Si fuera.
ditasłe	Sonido fuerte.
dita:toł	Denunciar algo.
dita:ve	Encostar.
di:tes	Olor fuerte, rancio.
diteswiń	Ponsoñoso, doloroso.
diveḿba	Almidón de yuca.
di'joy	Será así.
di'łe	Estar encerrado.
dochi'	Un poco más.
dochi'ta'	Choclo, maíz tierno.
dodo:kwa	Vaina. Fruto. Semilla grande.
dodomba	Cañuela.
dodombammo	Cañuelar.
dojadoja:łe	Espiar cautelosamente.
doja:łe	Robarle a alguien.
do:jiń	Filo, puntiagudo.
dojka	¿Será? Palabra que utiliza para expresar incredulidad o sorpresa.
dońwanojbeń	Trapo.
dokacho	Ensatar o enganchar algo.
dokado:ka	Mono león.
doka:piń	Traspasar algo con algo punzante.
do:ki	Donde se junta el fuego.
do:koy	Bueno.
dola:mi	Llenar algo con agua.
dola:ra	Llenar algo con algo.
dole:ya	Dolea (apellido).
dolra	Estar llena una cosa.
domba:chi	Peto chuturubí.
dońlo:wa dombaycho	Mezquino.
dommo	Japutamo.
donajoylo	Santa rosita (avecilla).
dona:ye	Odiar, malquerer a una persona.
doncheł	Odiarse aborrecerse.
donkara:na	Criticar, tratar a alguien mal con palabras groseras.
donlowe	Color anaranjado.
donłe	Nacer, ser nacido.
donna	Despreciar, aborrecer, insultar a alguien.
donto:kwa	León.
don'i	Sangre.
dońkatotołni	Hecho el malo.
dońlosi:mo	Color pardo de las aves.
dońlo:wa	Pus.
dońpoyni	Cadáver de animal en descomposición.
dońra:ni	Descompuesto, podrido.
dońreskwa:ni	Mal del estomago.
dońsese:wa	Hiel.
dońtoł	Malo.
doposcheł	Reventarse con sonido.
doposchacha'as	Reventar caña.
doposcho:na	Hacer reventar algo.
dorosba	Viruela.
dorosbawa:wa	Tiempo de la viruela.
dosła	Labio, jeta.
dotojna	Golpear o tocar algo.
do:toń	Saliva.
dotońła	Escupir.
dovayni	Marchito.
dowajbojna	Trasplantar una planta.
dowajdes	Dar paso.
dowajna	Mudar algo.
dowa'waj	Mudarse.
doya:as	Chupar caña.
doyna	Lamer algo.
doyoḿpa	Tarope.
do:yoń	Sal.
do'cho	Ensartado. Enganchado.
do'ewa:noj	Tela.
do'ewanojbeń	Retaso de tela.
do'ka:łe	Hilvanado.
do'kałe:na	Hilvanarlo.
do'la	Cucharon de tutuma conocido como matato.
do'la:la	Hombro.
do'łe	Salir de pena.
do'na	Ponerse una vestimenta o joya.
dońpiń	Traspasado. Bandeado.
do'si	Estar en cuclillas.
do'we	Ropa, vestimenta.
do'we:cheł	Vestirse.
do'wewanra:ni	Vestimenta de las personas.
dudu:du'	Espalda.
dudułkwa	Raíz.
dudu'kwa	Filones de altura. Loma.
dudu:tus	Puerco Espín.
duka:di	Moler granos.
dukaro:so	Moler arroz.
duke:łe	Moler, pisonear.
dula:ye	Visitar a personas.
dulna	Visitar a alguien.
dulwe:kwa	Jipurí.
duma:ye	Hallar después de haber buacado.
dumuychi:ya	Queresa, huevo de mosca.
du:muy	Mosca.
dupe:łe	Picotear.
du:yuḿ	Tupido.
duḿmo	Pajal espeso, espesura de bosque, cabello espeso.
duyuḿmoł	Herboso.
du'cham	Harina de maíz tostado.
du'cho	Estar machucado.
du'na	Moler, pisonear algo.
du'na	Estar molido. Batan.
ela:cho	Terraplenar.
ela:na	Dejar atrás.
elasłe	Quedarse atrás.
ela:ye	Quedarse atrás.
elełwa	Regalo.
elełwa:ni	Regalos.
elełwanra:ni	Regalo (de nadie en particular).
ele:siya	Iglesia.
elna	Regalarle a alguien.
e:ła	Peine.
eła:di	Masticar, mondar granos.
eła'lomajniwa	Nunca.
ełdimba	Embarazada.
e:łe	¿Quién?
ełełan	¿Cómo te llamas?
ełe:ni	No tener nada, no haber nada.
ełkwa	Bocón.
ełkwammo	Búho.
ełlomaj	¿Cuándo?
ełpanchi	Tocayo.
ełwanra	Nombre de una persona no identificada.
ełwawankwa	Palabra que es un nombre pero sin referir a ninguna persona en especial.
ełworo:ba	Coto, garganta.
eł'i	Mi nombre.
enałe:mo	Gallina con pollitos.
enałe:poy	Animal con cría.
ena'	De parado.
enbari:na	En donde está la huella.
enbijraneł	Parado(a) en la orilla.
encheł	Pararse.
enchina:mo	De rodillas.
enchodowineł	Estar parado bajo techo.
enchoradaneł	Estar parado en la calle.
eney	Este.
enłe:du'	Tacú.
enna	Lugar donde está parado.
eno:na	Autoridad.
enonawa:nas	Ser autoridad.
entomajni	Estar parado lado a lado.
enu'ni	Quedar bien parado.
en'enra	Aparecido.
en'enye	Espantajos.
en'en'oj	Espantapájaros.
ewa:poy	Coger un animal.
ewejni	Peligroso.
ewejpojkway	Me causa temor.
e:wel	Calor.
ewelni	Caluroso. Hace calor.
ewelni:wa	Me hace calor.
ewelwa:wa	Tiempo caluroso. Verano.
ewna	Agarrar, coger algo.
eyajna	Acrecentar o multiplicar algo.
eyajni	Acrecentarse, multiplicarse.
eya:mi	Recibir agua.
e'a	Elay, así es.
e'i	Ellos son.
i:de	Nosotros, incluyendo el oyente.
ij	Tu, usted.
ijikapa:na	Imitar, remedar algo.
ijikapane:łe	Imitar una acción.
ijikawa:na	Remedar el habla de otra persona.
ikacho:na	Acomodar un cuarto.
ikamba	Hormiguero.
ila:cho	Tender chive. Tender algo con su apertura al sol, por ejemplo una tutuma para seque por dentro.
ila:'oj	Tender ropa para que seque.
ilba:łe	Asolearse en un barranco, por ejemplo un lagarto.
ilcha	Ilcha (apellido).
ilijba	Granizo.
i:lim	Cristalino, transparente, por ejemplo el agua.
ilimni	Agua clara.
ilna	Tender algo al sol.
i:lolomajni	Perdurar, preservarse.
ilo:ni	Andar, caminar.
iloni'imma	Caminar de noche.
ił	Yo, nosotros.
i:may	Noche.
imaye:ni	Anochecerse, cogido por la noche.
imayni	De noche.
imayniwandi	Lucero de la noche.
ima:yoj	De mañana.
ima'kwa	Encontrar.
imbaycho	De la misma edad.
imkabaycho:ni	De la misma idea.
imkakawajni	Terreno plano.
imkalo:ni	De la misma altura.
imkakara:ni	Ser igual.
imkarimełni	Del mismo precio.
imkakatejni	De la misma fuerza.
imkato:ni	Nivelado, recto.
imkawane:łe	Hablar como otro habla.
impa:na	Imitarlo.
impane:łe	Hacer lo mismo.
imtinonake:łe	Cumplir año.
i:ni	Ella.
inlowesni	Componerse.
inła	Yo.
iń	Yo, en oraciones intransitivas.
ińkaba:cheł	Echarse a perder sin razón.
ińlo:ba	Reunidos.
ińlobawa:nas	Lugar de reunión.
ińna	Juntar, contagiar, por ejemplo una enfermedad.
ińwa	Río grande.
i:ri	Estos, artículo demostrativo para personas.
is	Estos, artículo plural para objetos y animales.
isa:cho	Quemar o calentar algo por dentro.
isa:ra	Asar carne.
ise:łe	Quemar.
isełlowa	Picapica.
isko	Ellos, para referirse a personas o cosas que no están presentes.
isna	Quemar algo.
isne	Ella, persona del sexo femenino ausente.
isnos	La, persona del sexo femenino en tiempo pasado.
isos	Los, de tiempo pasado.
is'isra	Asado; carne asada.
ita:ba	Atizar, juntar el fuego.
ita:bał	Anidar.
italo:ba	Coleccionar. Ahorrar.
ita:na'	Persona extranjera de otra lengua y que no es indígena.
ite:łe	Contagiar.
ite'ni	Estar vivo.
ite'niwa:nas	Vida.
itila:kwa	Hombre.
itilakwanchi:ye	Niño varón.
iwa:ni	Hablar.
iwaniwamba:ni	Teléfono.
iwaniwansi	Idioma. Lengua. Lenguaje.
iwansi	Idioma, lenguaje.
iye:kani	Moverse repentinamente en un lugar.
i'ko	Estos(as); aquí presentes.
i'łi	Nosotros (menos el oyente).
i'ne	Ella (presente).
i'nes	La (presente).
i'to:we	Frio (ave).
jaje:łe	Enganchar. Ranchear.
jajła	Gancho.
jaka:mi	Estar acarreando agua.
jaka:rim	Acarrear sus trastes.
jala:la'	Camote.
jalala'so	Chicha de camote.
ja:lay	Rabia.
jala:yij	Estar enojado, rabioso, enfadado.
jalayikaye:ye	Estar de mal humor.
jalaykwa	Bostezar.
jalayni	Da rabia.
jalaypojkay	Me da rabia.
jalo:maj	Herencia psicológica.
ja:ma	Peni (reptil).
jama:ba	Hacer un nudo.
jama:łe	Amarrar.
jamba	Lucha cuerpo a cuerpo.
jambaycho	Tener presentimiento.
jamnba:yiń	Brazos cruzados.
ja:mi	Traer agua.
jamłe	Estar amarrado.
jamna	Amarrarlo.
jampa	Hacer algo así.
jaḿkałe:na	Dar vueltas alrededor de algo.
jaḿłe	Estar liado alrededor de algo.
jaḿna	Liar algo.
jan	Por eso.
jana:łe	Poner sobre algo.
jana'kwa	No decir nada.
jana'pa	No querer.
jane:ni	Ser parecido.
jankara'is	¿Cuánto son? ¿Cuánto hay?
jankarimeła'a	¿Cuánto cuesta?
jankwa	Decir.
janlo:maj	Pasar así, ser así.
janlo:wes	Forma de algo.
janra	Tamaño, grosor.
janwa	Así es.
janwaja'a	¿Dónde es el lugar?
janwitan	¿Qué has hecho?
jańna	Pegar, maltratar a alguien.
japalo:los	Dar vuelta por la plaza.
japa:łe	Dar vuelta por algo.
ja:pil	Redondo.
japilba:kwa	Cabeza redonda.
japilna	Hacer algo redondo; dar vuelta por algo redondo.
ja:poy	Traer el ganado.
jarachijni	Aborrecerse, malquererse.
jaradada:mo	Que vive en el pleito, que no tiene paz con nadie.
jaradakwa:na	Pleitear.
ja:rał	Pelear.
jarałe:na	Pelear con alguien.
jara:pa	Peleador.
jarawa:nas	Guerra, pelea.
jara'chołna	Botarlo de su casa o de un lugar.
jara'cho:na	Aguantar, soportar algo.
jara'loł	Tirado o botado en el agua.
jara'lo:łe	Tirarse al agua.
jara'mołna	Botarlo en el monte.
jara'na	Botar algo.
jasjascho:na	Asesando.
jasła	Corazón.
jasławanra	Corazón humano.
jasławanra:kwi	Corazón fuera del cuerpo.
jasłabakwanina	La parte blanda de la cabeza de un bebé.
jata'	Este, naciente, donde sale el sol.
jata'mu:muj	Viento del este.
jatełchaye:pa	Persona que pega a otras.
jate:łe	Pegar.
jatełwanra	Objeto para pegar.
javu:buḿ	Volar.
javułcho	Inflado.
javułcho:na	Inflar algo.
javułlo	Pitaí, granos que salen en la piel.
javułna	Soplar, tocar instrumento de viento.
javuńwa:nas	Aeropuerto.
javu'chonawanra	Huso.
javu'na	Hilar.
jawjawcho:na	Aullar del perro.
ja:wo	Jabón.
jawo:ba	Bola o pasta de jabón.
jawo:kwa	Estar enjabonado(a) con jabón.
jawo:mi	Agua con jabón.
jaya:cho	Curiche.
jayacho:mo	Curichón.
jaya:moł	Llamar a alguien.
jayamołcha:ye	Llamar a personas.
ja:yaw	Hermoso, bueno, bonito.
jaya:was	Tiempo bueno.
jayawbaycho	Sentir alivio, tranquilidad.
jayawka:pa	Con cuidado.
jayawkapa:na	Tener cuidado.
jayawlo:maj	Estar contento.
jayawlo:wes	Caminar bien.
jayawna	Hacer algo bien.
jayawpojna	Hallar algo bien.
jayawwe	Persona bonita.
jaya:yas	Quejarse de dolor.
jaya'na	Cada vez.
jayeni:kay	Salió como yo.
ja:yi	Correr.
jayi:łe	Huir dos personas.
jayiłe:na	Correr con alguien o con algo.
jayka'asnapanjeł	Hormiga loca.
jaykwani	Confiar.
jaylo:ba	Allegarse (reflexivo).
jaylopa:na	Aceptar una cosa que alguien le da a uno.
jayłe	Entonces, después.
jayna	Ya.
jaysoń	Parece ser.
jaywa:na	Aceptar a alguien, hacerle caso.
jaywane:łe	Aceptar, obedecer.
jaywisełpammo	Avecita de las playas.
jay'asłe	Darse a la fuga.
jay'i	Vete, váyase.
jay'lo	Que te vaya bien.
ja'	Nomás, solamente.
ja'lala	Londra.
jeje:	Nové.
jeka'ni	¿Qué cosa?
jela	Ven, venga.
jela:ba	Horizonte; donde el cielo se pinta mañana y tarde.
jela:ra	Alumbrar con vela.
jele:łe	Alumbrar, enfocar.
jelełwamba	Linterna.
jelesni	Que brilla.
je:lew	Claro, una noche con luna.
jelewa:na	Hacerle recuerdo, ponerle en claro a alguien.
jelewna	Alumbrar algo.
jelewni	Amanecer, aclarando el día.
jelewwe	Persona de piel clara.
jelewweni	Amanecerse sin haber dormido.
jelna	Alumbrar algo.
jelra	Objeto que da luz.
jemalo:si	Manchar algo con resina.
jemme	Puro.
jema'	También.
jemes	Cada rato.
je:mes	Día.
jemeslu'	Día lluvioso.
jemlo:si	Pura resina.
jemme	Persona pura, sin mezcla.
jemnun	Esqueleto.
jempa	Soportar, hacer algo solo.
jempa:ni	Solito(a); ser soltero(a).
jempiteł	Persistir.
jemsi	Puro hoyo.
jene:neł	Como me hacen a mí.
je:ni	Estar mal. Vieras que estoy yeta.
jenni:kwa	Igual que otra persona.
jere:łe	Hablar con energía.
jerełna	Hablarle fuerte a alguien.
jesacho:pa	Desgajar.
jescho:pa	Desgajado.
jeschopa:pa	Desgajarse.
jeya'a	Así es.
jeykwa'a	El que viene del lugar indicado.
jeylo:wes	Mal hecho.
jeyłe	Descendencia.
jeyna	De donde se viene.
jeyra	Fantasma. Mal colocado.
jeysi	No sirve, de mala calidad.
jeyto:va	Estar en hilera.
jeywaj	Lejos.
jeyye	Persona de otro lugar o de otra raza.
jekakara	Al disparate.
je'ka:ka'	No tener nada, estar sano.
je'kaka'is	Están bien.
je'la	Ven. Venga.
ji:bal	Lento, despacio, tardo.
jiballo:wes	Caminar lento.
ji:dam	Estar lleno.
jidammi:na	Llenarse con agua.
jiliwni	Hieloso.
jilo:ka	Tener frío.
jilo'	Frío.
jilo'ni	Hacer frío.
jilo'si	Persona friolenta.
jiłapa	Rallar la yuca.
jiła:vos	Aserruchar madera.
jiłna	Rallar, aserruchar algo.
jimo:ba	Embarazada.
jimo:poy	Animal preñado.
ji:nana'	De repente. Había sido.
jina:ye	Confiar en alguien.
jina'	Quizás, tal vez.
jinne:cheł	Atenido en si mismo.
jirampojkay	Me gusta, me agrada.
ji:ran	Bonito.
jirankabaycho	De buenas ideas.
jiranlo:we	De color bonito.
jiranna	Hacer algo bonito.
jirannesni	Oler algo agradable.
jiranni	Bonito.
jiransinełni	Hablar bonito.
ji:sa	Juguete.
jisa:na	Hacer, fabricar algo.
ji:sawanrani	Juguete, cosas para jugar.
ji:sim	Fino.
jiwałe:na	Traer algo.
jiwamba	Llorón, llorona.
ji:wanlo	Lagrimas.
jiwa:wa	Venir.
jiya	Vamos.
jiyakweł	Vamonos.
ji:yi	Llorar.
joba:kwa	Calentarse la cabeza.
jo:be	Viajar, ir a un pueblo.
jobewanne	Viajero.
jo:jo:di	Arroz calentado.
jo:jo:loł	Comida calentada.
jo:jo:mi	Agua caliente.
jo:jo:ra	Carne calentada.
jo:jo'	Si.
joko'	Cuajo (ave).
jo:kwan	El/la último(a).
jolbaycho	Sorprenderse.
jolcho	Estar volcado.
jo:li	Mano izquierda. Mujer que no puede tener hijos.
jolkwa	Al revés, volcado.
jolkwandoneł	Remo de boga.
jollej	Chichapí.
jollejmo	Chichapisal.
jolobuteł	Hundirse en el barro o el fango.
jolo:wes	Bien seguro.
jolteresmo	Canasta de cogollo de motacú que se empieza a tejer del asiento.
jolwaj	Estar en un logar desconocido.
jołkwa	Huevo.
jołti'	Poner huevo.
joma:ni	Comer algo.
jome:me	Extrañar, estar desesperado.
jomepa:na	Extrañar a alguien.
jo:mi:na	Calentar agua.
joḿjoḿme	Tener ave.
joḿkaye:na	Despachar a varias personas.
joḿpa:ni	Engrosar la yuca.
jo:na	Calentar algo.
jońye:na	Escoger a personas.
jońna	Recoger o escoger del suelo algo.
jopa:ye	Despachar a alguien.
jopa'si	Derramado.
jo:ri	Tojo del grande.
jo:ro	Dormir.
jorojorowamba	Dormilón.
joroka:poj	Hacerse el dormido.
joro:kwa	Estar dormido.
joro:na	Donde uno duerme.
jorosicha'kwa	Tener sueño, querer dormir.
jo:si	Risa.
josika'asna:pa	Reilón, reilona.
cosipa:na	Reírse de algo o de alguien.
josiwanra	Cosa para reírse.
josiwanra:ni	Chiste.
jotaye	Escoger a una persona entre varias.
jote:łe	Escoger, ir escogiendo.
jo:we	Calentarse en el fuego.
jowe:na	Alcanzar a alguien.
jowesni	Olor agradable al olfato.
jo:wo	Tos.
jowo:ba	Gargajo.
jowo:kwa	Toser.
joy	Posiblemente.
joyalo:maj	Concluir algo.
joya:łe	Llevar consigo algo o a alguien.
joya:ra	Armar algo.
joycheł	Irse.
joychoy	Probablemente.
joychoyka	Posiblemente.
joydajay'łi	Nos vamos.
joyda'	Hasta luego.
joydi'	No se.
joyka	A lo mejor.
joykał	Irse inmediatamente.
joykwa'a	El que va al lugar indicado.
joynan	¿A dónde vas?
joyra:ni	Una cosa concluida.
joywaj	Estar concluido un lugar para vivienda.
jo'ka:toł	Farsante, altivo.
jo'me	Ave.
jo'mi	Recién, hace poco.
jo'wes	Fragancioso.
jo'yaj	Llegar.
jo'ya:łe	Mellizo.
juchu'	Refregar.
juchu'ojna	Refregar ropa.
ju:di	Mono manechi.
judimmes	Grasa del manechi.
judimmo:ra	Cara de manechi.
judimlo:wes	Traza de manechi.
ju:juma'lo	Ser lento.
juke:łe	Amonestar, reñir.
jukuy'na	Estrujar algo.
jula:łe	Dar vueltas por algo, rodearlo.
julałełe	Rodear.
jula:ra	Ganarle a alguien.
jularawe:łe	Ser ganador.
julłe	Estar abrazado.
julłe:łe	Enredarse en algo.
juła:ye	Abrazar a alguien.
jułna	Abrazarlo a alguien.
jułpa	Flecha.
jułpiń	Estar abrazado por la cintura.
juma:ra	Estimar, necesitar a alguien o algo.
jumara:ni	Necesitar.
juma'pojdo'	Por favor, hazme un favor.
jumlo	Estar atrasado. Tardar.
juḿna	Ventear algo.
juḿwammo:ni	Plumero, venteador.
juḿwanra	Soplador.
ju:na	Amonestar a alguien.
jusa:di	Éncebar huasca o lazo.
jusawni	Blando, suave.
jusna	Untar, sobar despacio con algún ungüento.
ju:ve	Canoa.
juwankwa	Persona retada.
juyeni	Persona.
juyeni:nun	Hueso de humano.
juyenirulrul	Tigre gente.
juyeniwa:nas	Gentileza.
juyna	Horadar algo con el dedo.
kama:may	Gritar.
kamaro:te	Toldo del carretón.
ka:may	Grito.
kamayasna	Estar agritos.
kamayłe:na	Gritarle a alguien.
ka:na	Alimento, comida.
kana:wa	Ochoo.
kanawanlo:si	Resina de ochoo.
kankame:ni	Andar uno detrás de otro.
kańboje:łe	Quebrarse al tronco del árbol.
kańcho:cho	Quebrarse, desportillarse.
kańpiń	Quebrado.
ka:pe	Café.
kape:lo	Café preparado.
kapelo:ti'	Tomar café.
ka:ram	Lagarto.
karamjoł	Huevos de lagarto.
kabo	O.
kabo di'	O será.
kachi:chi	Mono chichilo.
kachiḿpoj	Resbalarse.
kachi:ra	Cuchillo.
kachirampiń	Cuchillito.
kachi'ni	Resbaloso.
kaja:łe	Atajar va alguien en el camino.
kajłe:na	Atajar, salir al paso.
kajo:ne	Cajón.
kaka:ra	Otra cosa.
kakaye:mes	Otro día.
kaka:'oj	Otra ropa.
ka:loy	Quiabó (olor a pescado).
kaloyni	Quiabó.
kalru	Eso.
karawa:chi	Chupacoto.
baraya:na	Persona blanca, adinerada.
karaye:łe	Suplicar.
karaye:na	Pedir un favor.
kara'	Paraba.
kara'muń	Pluma de la paraba.
kare:ta	Carretón.
karso:ne	Pantalón.
kas	No.
kaste	Castellano.
kata:boj	Quebrar un árbol.
kata:łe	Quebrar algo de algo.
kata:piń	Quebrar algo largo por la mitad.
kate:na	Coquino (árbol).
katena:di	Fruto de coquino.
katenammo	Coquinal.
katenammomajye	Coquineño.
kavosdi	Curi.
kavujłe	Llevado por el viento.
kavujna	Ventear algo.
kavu'ni	Ventilado.
kaw	Artículo que sirve para enfatizar a la persona.
kaw ninła	Dueño.
kawasłe	Chistear, bromear.
kawa:wa	Resino de macororó.
kawa:yo	Caballo.
kawayo:ba	Manga caballo.
kawayo:di	Caballito. Semilla que se usa para hacer collares.
kawka:ye	Estar fatigado, preocupado.
kawmoł	Cáumol (apellido). Paicahne (arbusto).
kawpojsi	Muchas vueltas.
kawra	Muchos.
ka:wuḿ	Mosquito.
kayajuyeni:pa	Caníbal, comegente.
kaya:lu	Cayalo (apellido).
kayałaba:pa	Cometierra.
kaya:łe	Darle algo.
kaya:na	Tipo de caña.
kaya:poj	Darle de comer a alguien.
kaykay	Comer.
kayłewawa	Regalo.
kayna	Lugar donde se come.
kayni	Muerto, difunto.
kayni:beł	Viudo.
kaynimo:ra	Semblante de muerto.
kayni:poy	Animal muerto.
kayniwa:nas	Muerte.
kayniwandi	Cementerio.
kayo:ti	Puerco taitetú.
kayotimpa	Cazador de teitetú.
kaypa	Persona que come mucho.
kayu'	Cayú (apellido).
kaywanra	Comida.
ka'	¡Deja! ¡No!
ka'cheł	Déjame.
ka'de'a	Hasta ahí.
ka'i	No.
ka'pojcheł	Dejarle hacer algo a alguien.
ka'pojna	Permitirle algo.
kele:le	Pato Puga. Pato cuervo.
kele:łe	Abrir una puerta u otra cosa.
kelwa	Destapada la apertura de un recipiente.
kelna	Abrir una puerta.
kemaka'ra'a	No sirve.
kemakemalo:to	Explicarle punto por punto.
kemakema:ra	Sirve.
kemalo:maj	Decirle a alguien lo que tiene que hacer.
kemara'a	¿Para qué es?
kema:si	Denunciar.
kema:ye	Equivocarse con lo que es.
keraaye:łe	Celar, ser celoso.
kemayełewamba	Persona celosa.
kema:'eł	Dar nombre.
kemlo:maj	Mandato, lo que uno tiene que hacer.
kemme	Calumniado. Achacado.
kepanascheł	Confesarse.
kem'eł	Apellido.
kena:pa	Avisarle a alguien.
kewwe	Acostado(a) de espalda.
ke'a:ra	Ultrajarlo, molestar.
ke'arani:kay	Me maltrata.
ke'chita	Hermanita (en saludo).
ke'e	Hermana mayor. Termino que se utiliza como saludo de respeto a una mujer mayor.
kide	Están.
kilajna	Apartarlo, llevarlo lejos.
kilajni	Irse lejos.
kilajwińni	Avanzar en un trabajo.
kila:laj	Alejarse.
kilayni	Olvidarse.
kilayniba:kwa	Olvidadizo(a).
kila'moka	Insignificante.
kila'wa	Están viniendo. Servite, ¡salud!
kilde	Están.
kili:liń	Desportillarse.
kilmo	Picaro.
kilmomo:ye	Persona picarosa.
kilmowa:nas	Picardía.
kilpa	Están.
kilwa	Están.
kinede	Esta ella.
kine	Está ella.
kinos	Ausente.
kino'	Está ella.
kipa	Están ellos.
kiro'	Están ellos.
kis	Ausente.
kisa'	Chaaco (árbol).
ki'laj	Lejos.
ko:chi	Cerdo.
kochimmes	Grasa de cerdo.
kode	Está.
kodo:si	Pato (palabra desconocida para algunos hablantes.
kojamutelwambes	Agujón hecho de cuerno, madera o hueso.
koja'as	Meter caña altrapiche.
kojele	Tejer, arreglar un tejido.
kojkachołe	Entremeterse.
kojna	Meter algo en otra cosa.
koka:di	Tragar algo pequeño.
koka:mi	Tragar agua.
kobe:łe	Tragar.
kokońkwa	Pozo, pocita que guarda agua por tiempo.
kola:cho	Destripar.
kolde	Está aquel.
koljoł	Está capado.
kolo:ba	Puño.
kolojni	Limpio, puro.
kolpa	Está.
kolre'e	Está.
kolwa	Está, son palabras demostrativas.
kołna	Cepillar un objeto de madera.
koma:lo	Nadar.
kona:choł	Sacar algo desde adentro.
kona:le	Conal, cernidor hecho de junco.
konale:seł	Sacar del fuego.
kona:loł	Sacar algo del agua.
ko'lo:łe	Salirse del agua.
konna	Sacar algo.
końko:re	Pato.
końła:ri	Quitarse el pantalón.
końna	Sacar algo.
kopa	Está (cosa o animal con alguien visible).
ko:re	Techo.
kore'	Está (cosa o animal parado visible).
kori:di	Palito, varita de madera.
koridimba	Loma donde hay altos palitos.
koro:doń	Estirarse.
korojna	Cernir algo.
korońna	Estirar algo.
koro'	Está (cosa o animal fuera de vista).
kos	Ausente.
kosi'na	Escapar algo.
kosna	Jalar algo de donde casi no se nota.
kota:ki	Arrancar algo de la raíz.
kota:loł	Escurrir.
koti:ti	Caricari.
kotitimmo	Caricarisal.
kotitinra	Leña del caricari.
kovela'ni	Palideció.
kovelni	Pálido.
ko:vij	Delito.
kovijko:vij	Tiene delito.
kowa	Está (cosa o animal elevado).
kowa:cha	Covacha.
koybubu'	Turbio.
koyikaye:cheł	Mezquinar.
koyi'na	Envidiar, codiciar a alguien por algo.
ko'ba:ri	Tronquito de árbol.
ko'cha'	Arco iris.
ko'loj	Limpio, puro, aseado.
ko'na	Tragar algo.
ko'o	Árbol, palo, leña, madera.
ko'o:ti'	Ir por leña.
kucha:ra	Cuchara.
ku:des	Alto de estatura.
ku:duḿ	Pulga, nigua.
ku:juy	Apellido. Sur.
kujuylu'u	Sur con agua.
kujuymuj	Viento del sur.
kujuyti'	Venteando del sur.
ku:le	Lobo.
kule:ma	Tarántula, pasanca.
kulna	Hallar algo, recogerlo.
ku:lo	Arriba, alto.
ku:lolo:ba	Altura.
ku:lopitel	Palabra larga.
ku:lowes	Largo.
kulo:wesna	Hacerlo largo.
kulo:wiń	Saltar lejos desde arriba.
kulujdi	Mechero (árbol).
ku:ła	Gorgojo.
kuḿba:ba	Encogerse. Fruncirse.
kuna:nay	Hacer gestos, mirar mal a alguien.
kunayłe:na	Hacerle gestos a alguien.
kuńsisi:wa	Alacrán.
ku:piń	Largo y delgado.
ku:ra	Largo.
kurakapojsi	La parte recta después de una curva.
kure'	Está él (parado visible).
ku:ri:di	Vara larga.
kuro'	Está (fuera de vista).
kurumna	Duro.
kusała	Come plátano (especie de loro).
ku:si	Hondo profundo.
ku:te'	Tener larga respiración.
kuyna:na'	Jugar.
kuynana'wandi	Casa de juego.
kwaja'pa	El (la) menor, por ejemplo hijo(a) o hermano(a).
kwajescha:ye	Amar, querer estimar a personas.
kwajeswa:nas	Amor.
kwajesna	Estimar, amar a alguien.
kwajka	Negativo.
kwajkabaycho	Esperanza vana.
kwajkalo:va	En vano.
kwajles	Caliente.
kwajlo:maj	Más peor, más grave que lo esperado.
kwajna	Entregarle, alcanzarle algo a alguien.
kwajpa	Empeorado de alguna enfermedad.
kwajra:da	Estar peor ya por exagerado.
kwajradan	De verdad.
kwajrada:ni	De adrede.
kwajta'	Maíz.
kwajta'di	Maíz en grano.
kwajta'loł	Comida de maíz.
kwajta'ła	Espiga de maíz.
kwajta'mo	Maizal.
kwajtej	Travieso, forzudo.
kwala:moł	Esconder algo en el monte.
kwala:ra	Ocultar, esconder.
kwalbaycho	Pensar mal.
kwa:le	Estar perdido.
kwale:łe	Callarse, ocultarse.
kwale:moł	Estar perdido en el monte.
kwale:na	Perder algo.
kwalra	Escondido(a), ocultado(a).
kwałna	Cedrillo (árbol).
kwana:mo	Corva.
kwanres	Trasero.
kwansi	Nalga.
kwan'i	Boca.
kwaresma	Semana santa.
kwaybaycho	Darse por vencido.
kwa:yim	Flojera.
kwayi:maj	Estar con flojera.
kwa'i	Cuajo (ave).
kwełris	Sujo, especie de paja que sirve para techar casa.
kwełrismo	Sujal.
kweńtuj	Cuñado.
kwey	Hoy, ahora, antes del momento presente.
kweyka	Ahora.
kwe:ya	Mujer.
kweyayammo	Mujeriego.
kweyammo	Ave hembra.
kweyampoy	Animal hembra.
kweyanchi:ye	Niña.
kweyanti'	Enamorar a una mujer.
kweyasełna	Corretearle, perseguirlo.
kweye:łe	Ir tras de alguien.
kweykaye:ni	Andar uno detrás de otro.
kwyna	Seguir a alguien sin que el lo sepa.
kwikwi:kwi	Cintura.
kwil	Mucho antes.
kwinto	Cachete.
kwinto:kwa	Cachete de vaca (pedazo de carne).
kwinto:ła	Muela.
kwinto:nun	Mandíbula.
kwiri:dil	Templado.
kwirilna	Templar a algo o a alguien.
lajań	Mucho tiempo atrás.
lajni:ye	Palomaría (árbol).
lala'kwa	Palometa.
la:mis	Cabello fino.
lamisni	Cosa fina.
laḿna	Morder algo o alguien.
lańna	Hachear algo.
lape:łe	Morder.
lari:ya	Ladrillo.
larujkwa	Aserrín.
lata:boj	Tumbar árboles.
latabojcha:vos	Talar árboles.
latato'lej	Desgajar.
late:łe	Hachear.
la:tos	Aplastado.
latosna	Aplastarlo.
latosni	Estar aplastado.
la:va	Vi (árbol).
lava:bał	Sombra. Foto, imagen.
lava:yas	Sombra.
lavińkwa	La tela. Piel suave de una fruta.
lawa:jes	Remedio.
lawajeschaye:pa	Curandero.
lawajesna	Tratarle.
la:wiń	Blando.
lawińni	Blando.
laya:kwa	Embriagado(a).
layakwampa	Persona alcohólica.
layakwanwa:nas	Borrachera.
laya:ta	Cabezaseca (ave).
layła	Hacha.
layła:di	Hacha pequeña.
layłapiteł	Mango o cabo del hacha.
la'	Antes.
la'je:mes	El día anterior.
la'dimpoj	Tropezarse.
le:de'	Estar suelto.
lede'ni	Flexible, blandeado.
leke:cheł	Mecerse.
leke:na	Mecer a alguien.
lela:ba	Mascar algo para saborearlo y escupirlo después.
lelejdu'	Espinazo, columna.
lelejkwa	Espina.
lelejkwammo	Espinal.
lelkwa	Vomitar.
lemlem	Descolgar una cosa.
lemlemkwa:ni	Boquiabierto.
lemłe:łe	Descolgado, sobresaliendo.
lemna	Colgar algo en un lugar.
le:ra	Lastimado.
le:tos	Gaviota.
letosjoł	Huevo de gaviota.
leve:na	Espantar algo.
lewa:beń	Leer.
lewa:lo	Rezar.
lewalokwa:na	Rezar por alguien.
lewalo:pa	Rezador.
lewka'asna	Cantar por cantar.
lewlew	Cantar.
lewpa	Cantor.
lewwansi	Canción.
liki:kiń	Cuando tiembla una cosa que está plantada en el suelo por el viento.
liki:na	Hacer mover algo que está fijo, por ejemplo un árbol.
likwi:kwiń	Ser blando movedizo.
limayka	Limaíca (apellido).
limi:mi'	Que fluye agua.
li:mo	Limón.
limo:mi	Limonada.
liḿra	Pestañear.
liḿrałe:na	Guiñarle el ojo a alguien.
lirijcheł	Sacudirse.
lirijna	Sacudir algo.
litińpojna	Hacer temblar a alguien.
liti:tiń	Temblar.
lo	Pues sí.
loba:ba	Cuerpo.
lochiwamba	Manzanilla.
lodinkwa	Gota. Una lágrima.
lojacha:do	Lavar platos.
loja:'oj	Lavar ropa.
lojba:kwa	Lavarse la cabeza.
lojba:ri	Lavarse los pies.
lojcho:pa	Lavarse las manos.
lojka:rim	Lavar utensilios.
lojna	Lavar algo.
loka:cho	Sacarle un pedazo a algo, desmoronarlo.
loka:łe	Tumbar algo de arriba.
lo:kwa	Locro.
lokwampiń	Picao de yuca.
lol	Sin.
lolba'eł	Persona no bautizada.
lolcho:ra	Ciego.
lolo:lo	Semen humano.
lolołkwa	Jugo.
lo:los	Pueblo, plaza, patio.
lolosmaj	Estar en el pueblo.
lolosmajye	Pueblerino, persona del pueblo.
lolosna	Ir al pueblo.
lomi:ko	Domingo.
lomito:ti'	Dominguera.
lomo:kwa	Gajo con hojas.
lava:bał	Sombra. Foto, imagen.
lava:yas	Sombra.
lavińkwa	La tela. Piel suave de una fruta.
lawa:jes	Remedio.
lawajeschaye:pa	Curandero.
lawajesna	Tratarle.
la:wiń	Blando.
lawińni	Blando.
laya:kwa	Embriagado(a).
layakwampa	Persona alcohólica.
layakwanwa:nas	Borrachera.
laya:ta	Cabezaseca (ave).
layła	Hacha.
layła:di	Hacha pequeña.
layłapiteł	Mango o cabo del hacha. Tallo de la yuca.
loranełe'as	Su follaje.
lorankwa	Hoja de un árbol.
lo:ri	Entrepierna.
lorisra	Gotera.
losi:kwa	Resina.
loto:ba	Tinaja.
lotoba:kwi	Tobillo.
loto:di	Testículos.
lotodinkwa	Huevos de toro de ganado.
loto:kwa	Oreja de vaca.
loto:to	Oreja.
lovełna	Cocer al fuego.
lovełni	Está cocido.
lowadinra	Pestaña.
lowe	Color.
lowe:kwa	Su color, tiene color.
lowe:kwi	Adorno, forma de varios colores.
loy	Ir a, estar por hacer una cosa.
loycho	Alistado la lazada. Lista la parrilla.
lo:ye	Alistarse.
loyełe:na	Invitar a alguien a hacer algo.
loye:na	Alistar.
loyka	Inmediatamente.
loyna	Alistar algo.
loyrane:łe	Anunciarse.
lo'łe:łe	Desprenderse, soltarse de su penga.
lo:na	Coger con la mano una fruta.
lo've	Estar bien cocido.
lu:day	Mojado(a).
ludayni	Mojarse, estar mojado(a).
luku'	Lucú (apellido).
lume'	Jochi pintado.
luḿluḿ	Zambullir.
lu:nes	Lunes.
lu:ve	Noria.
luvenbijra	Orilla de la noria.
lu'cho:na	Tiempo de lluvia.
lu'lu'	Lluvia.
lu'ti'	Está lloviendo, llover.
ła:cho	Vagina.
łakaḿba	Tierra.
ła:kwa	Peor, más todavía.
łała:kwa	Orilla de un objeto, borde, doblés.
łała:kwi	Plátano tierno. Solera de casa.
łaḿłaḿ	Bañarse.
łaḿna	Bañar a alguien o algo.
łań	Dizque. ¡Mira!
ła:ri	Pierna.
łavałkwa	Pared de ladrillo; barranco.
łavokabaycho	Entristecerse, sentirse triste.
łavołavomora:ni	Semblante triste.
łavo:ni	Digno de lastima. ¡Que pena!
łavo:ra	Vivir sufriendo.
łavora:na	Castigar a alguien con crueldad.
łavoye:na	Tenerle lastima a alguien.
ława'cheł	Cuchichear, secretear.
ła'wa	Si fuera así, ojalá.
łeka:cho	Pisar algo.
łeke:łe	Dar patadas.
łekełpa	Pateador.
łere'cho	Rugir.
łewkwa	Plumaje de machetero.
łe'kwa	Tener hipo.
łi:na	Cargar algo en la mano.
łi:ye	Ahijado(a).
łiyeni:kay	Padrino.
łi'na	Pellizcar.
łeła'a	¿Qué fue?
łoka:łe	Hacer caer.
łoka:poj	Tumbar algo o a alguien.
łoko:koń	Hervir.
łoma'na	Añadir sal, salar algo.
łoma'ni	Salado.
łomdi	Estar bien salado.
łoḿpoye:łe	Desmontar de un animal.
łoro:doń	Roncar.
łowa:łe	Sacar, absorber.
łowa:piń	Estirar algo. Jalar, estar jalando.
łowkate	Agonizando.
łowłow	Estirarse.
łowna	Jalar algo.
łowte'	Respirar.
łoyna	Teñir algo.
ło'cho:cho	Desbarrancar.
ło'lokwa:kwa	Babearse.
ło'lo:łe	Gotear.
ło'ło'	Caerse de estar parado.
ło'im	Sujo (árbol).
łu:vuy	Madrugada.
łuvu:ye	Madrugar, levantarse de madrugada.
łuvuyni	Anochecer, entre día y noche, al final del día.
ma:do	Frijol.
madonloł	Comida de frijol.
majni	Hijo(a).
mala:le	Malale (apellido).
malu:we	Malue (apellido).
małaḿ	Curupaú (árbol).
małaḿbeń	Cascara de curupaú.
mama:ku	Mutun (ave).
mambaycho	Estar conforme.
mamipanjeł	Hormiga culilarga.
mana:pil	Cortar distancia del río por el canal.
manara'a	Alcanza, es suficiente.
mana:ye	Encontrar, pillar a alguien o algo.
manaye:na	Lugar donde se encontró.
ma:ni	Disparar un tiro.
mani:ki	Río.
maniwammo	Fonda (arma primitiva).
manka	Manga (fruto).
manka:boj	Planta del mango.
manka:so	Chicha de manga.
manlo:łe	Tirarse al agua.
manna	Disparar con un arma de fuego.
manne	De buen tamaño.
manra	De nada, suficiente.
manran	Por suerte.
ma'cho	Estar desecho o desatado.
mańchori:sa	Cabello suelto.
mańdineł	Estar descocido.
mańlo:lo	Derretirse.
mańłe:łe	Desatarse, soltarse.
mańna	Desatar.
mapo:no	Cedro.
ma:retes	Martes.
mari:ko	Bolsa.
mariko:ba	Bolsita, bolsa pequeña.
mariko'ojeł	Estar vestido de camiseta.
maropa	Papaya.
maropandi	Semilla de papaya.
ma:sa	Oveja.
masa:ro	Mazaro (apellido).
mase:łe	Azotar, castigar con azotes.
masla:pos	Piraquina.
masna	Darle huasca.
matadineł	Descocer algo.
matawa:re	Gallina.
matawarenjoł	Huevo de gallina.
matoy'kałe	Vaivennear.
matoy'kałe:łe	Vaivenearse a causa de algo.
maw'i	Hambre.
maw'inkwa	Estar con hambre.
maw'i:ti'	Estar pasando hambre.
maw'iwa:wa	Hambruna, escases de alimentos.
maya:pu	Mayapo (apellido).
marka:kwa	Pasearse de un lado para otro.
maykakwanmoł	Estar extraviado en el monte.
mayle:wa	Maileva (apellido).
ma:yuse	Piña.
mayuse:mi	Jugo de piña.
mayuse:mo	Piñal.
ma'a	Madre. Señora.
ma'nes	Sabros, lindo.
ma'neskalo:cho	Beber con gusto.
ma'neskwa	Estar con apetito.
ma'nesni	Que está muy sabroso.
ma'nespa:na	Gustarle el sabor.
ma'wawankwa	Madre de familia, mujer que tiene hijos.
mebaycho	Estar ideando.
mebaychovałna	Están ideando.
mejła	Turo (caracol del agua).
me:kaka	Casi, más o menos.
meme:di	Casa vieja, tapera.
meme:lo	Liquido guardado.
memelo:los	Pueblo viejo.
mere'	Grande.
mere'na	Agrandar algo, hacerlo más grande.
mere'ni	Crecer.
me:sa	Mesa.
me:se	Gordo.
mese:ni	Engordarse.
meskwa	Manteca, grasa, gordura.
mesye	Persona gorda.
mi:chi	Gato.
michiri:sa	Pelo de gato.
mimi:di	Víbora.
mimidimmes	Grasa de víbora.
mi:ra	Con los ojos cerrados.
mirińchel	Atreverse animarse.
mirińna	Animarse a enfrentar.
mi:sa	Misa.
mila:cho	Molde para tejer sombrero.
mo	Todavía.
modinła:ris	Aguja.
mo:doń	Chulupi.
modońchi:ya	Bosta del chulipi.
mo:ka	No todavía.
mo:le	Mole (apellido).
molojoła'a	Cojudo, cojonudo.
molo:we	Tribu desaparecida.
mo:lowesni	Sin concluir.
molra	Crudo sin cocer.
mołra	Parpado.
momo:cheł	Oxidarse, defecarse.
momodonna	Defecar sangre.
momo:kwa	Defecar.
mo:molo:cho	Falta de bebida.
momołkwa	Pelecho o cascara del huevo.
momowandi	Letrina.
momoyeskwa	Faltarle, no haber saciado el apetito.
mońlo:to	Aro, pendiente de la mujer.
mo:ra	Cara.
mora:ni	Faltar, hacer falta.
morinkwa	Flor.
morinkwawamba	Florero con flores.
morinti'	Florecer, hacer una flor.
morón	Sumuqué (palmera).
mosi:kwa	Mascara de torito.
mosikwa:kwa	Cadera.
mosi:si	Detrás de mi cadera.
mova:kwa	Basura. Jachi.
mowi:maj	Movima.
mo'incho	Chive.
mo'inchoba	Tortita de almidón de yuca.
mo'incho:buń	Masa de chive.
mo'incho:vas	Harina de chive.
mo'los	Penga, ramillete.
mo'nełkwa	Gavetillo.
mujełkwa	Olor.
mulaykaba:kwa	Tener el cabello crespo.
mulayni	Estar crespo, tener cabello crespo.
muła:cho	Rebanar choclo.
mułna	Desgranar.
mu:masłe	Desparramarse, el humo.
momołkwa	Chala de arroz.
mumuńkwa	Pluma. Hoja de palmera.
muna:łe	Rodear a alguien.
mumele	Estar rodeado.
muele:kay	Me rodean las abejas.
mu:sika	Música.
mutełni	Estar pujusó. Mohoso.
muycho:ra	Estar con los ojos tapado.
mu'lu	Crespo.
nakal	Ahí.
nalomajna	Origen.
nalomajwa:nas	Principio, creación.
nałcheł	Acercarse, apegarse.
nałna	Acercar algo.
nanalopa:nas	Despreciar, rechazar.
nana:ra	Soltar, largar.
nandu'	Alejarse, irse.
nara:sa	Naranja.
narasa:di	Semilla de naranja.
narasa:lo	Jugo de naranja.
narasa:mo	Naranjal.
narasa:mi	Mate de naranja.
na:va	La llegada.
nawa:la	Navala (apellido).
nawaja'	Inició algo.
nawan	Ni aun cuando.
nayalo:wes	Iniciar.
naya'	¿Dónde?
naychi	Adelante, primero.
naychinlo:wes	Primer día de fiesta.
naychinye:mes	Primer día.
na:ye	Casarse.
nayewa:nas	Boda, matrimonio.
naykachin	De primero.
naylese:łe	Juntar el fuego.
nayra	Tener más.
nayra:kwi	Avanzar.
nayra:ni	Aumentar.
nenkwa:na	Donde voy.
nenna	Donde voy.
neńna	Arrear, por ejemplo el ganado.
neta:poy	Arrear animales.
ney	Aquí.
neyru	Aquí (demostrativo).
nijbeń	Sarnoso.
nij'i	Sarna.
nika:ba	Machucar, amasar algo hasta que tenga una forma redonda.
ninninła	Persona que tiene.
nisna	Limpiar con trapo.
ni:yo	Capibara.
niyo:beń	Cuero de capibara.
ni'baba	Hacerse masa.
ni'loy	Suave, sedoso.
ni'loyni	Que es suave, sedoso.
ni'na	Amasar algo.
ni'wis	Polvo bien cernido.
nokode	Ahí (visible).
nokolde	Ahí (más lejos).
nokopa	Así (indicando con la mano).
nokowa	Ahora, más tarde.
nołkwa	Ratón, rata.
nona:poj	Darle el pecho al bebé, darle de chupar.
nona:ye	Darle el pecho.
nonlo	Leche.
nonna	Le hago chupar teta.
nonnon	Chupar.
no:no	Animal domestico.
no:nopa	Perezoso.
nono'	Abuelo(a).
nono'wawankwa	Persona que ya tiene nietos, es abuelo.
no:ros	Aliso (árbol).
noro'chichimba	Moco.
nosde	Allá.
no:to	Pacú (pez).
noto:di	Pacú pequeño.
noto:ti'	Ir a pescar pacú.
nowe:di	Collar.
noyka:kwa	Desviar la mirada.
no'na	Verde.
nunris	Polilla. Tojo del pequeño.
nun'i	Hueso.
nu:ra	Carne cruda.
nu:yeneł	Estrujarse a otra persona.
nuyvuseł	Lleno de tierra.
o:be	Como, parecido a.
ochołna	Probar la calucha.
o:kabaycho	Distraerse.
o:kakapeńna	Hablar por hablar.
o:kaka:ra	De toda clase.
o:kakawajcheł	Ubicar su lugar.
o:kawajna	Ubicarle un lugar a alguien.
oloba'was	Serpiente Cascabel.
olo:na	Mirarle su altura.
olo'tey	Gusano verde que come la hoja de tabaco, tiene 10 cm de largo.
olpiń	Estar colgado por ejemplo encima de una vara horizontal.
oła:łe	Colgar, por ejemplo en un gancho.
oła:poy	Enlazar el ganado.
ołłe	Estar colgado en un gancho o clavo.
ołna	Enlazar algo, ensartado.
ołneł	Churuno, tari.
o:ma	Anta, tapir.
ornato:da	Carne de anta.
omawni	Ser peligroso.
o:mayle	Avispa, peto.
onka:ye	Preocupado, con pena inquieto.
ona	¡A ver!
onabaycho	Dare cuenta.
ona:cho	Nieto(a).
onajri	Onarry (apellido).
onalomajcheł	Conocer su propia actitud.
onalomajna	Conocer la actitud de otra persona.
onalowesna	Conocer algo (en sentido abstracto).
onara:na	Conocer una cosa.
onawajna	Conocer un lugar.
oncho:ni	Mal acostumbrado.
onijni	Estar escarmentado.
onkacho:ni	Estar amañado.
onlolomajni	Oír voces.
onra:ni	Estar acostumbrado.
onridisni	Temor a un peligro.
opa:na	Probar algo, ensayarlo.
ope'	Hermano mayor (saludo de respeto).
o:ra	Hora.
o:ro	Oro.
os	El (tiempo pasado).
osani	Bajó el agua.
osełni	Quedar en lo seco.
ovni	Bajada del agua.
oso'	Estaba (cosa o animal).
otolna	Tentar, tocar algo.
ovempoj	Patujú.
ove:ni	Ser valiente.
ovenipojcheł	Hacerse el valiente.
oveniwankwa	Joven.
owa:le	Ovale (apellido).
owa:na	Escuchar, percibir.
owesna	Probar el gusto.
o:ye	Dos personas.
oyka:ra	Cuatro.
oycho	Dos chorros.
oylo	Acompañante.
oyloniłna	Acompañar.
oyra	Dos.
oyyemeskwy	Con dos días.
oyye:ye	Amante.
o'ochołna	Espiar.
o'ocho:na	Espiando.
o'okakawiłna	De una manera u otra.
o'o:wa	Escuchar algo que suena de manera despacio.
pabaycho	Pensar, planear.
pabaychovałna	Pensar en alguien o algo.
pabaychova:na	Pensar en una actividad.
pachołcha:ye	Vigilar a alguien.
pachołna	Espiar o vigilar a alguien.
pa:di	Guayaba.
padimmo	Guayabal.
padiwa:wa	Tiempo de guayaba.
paja:cho	Partir.
pajachocha:ra	Partir leña.
pajas	De paso.
pajasłena	Encontrar algo en la calle y llevárselo de paso.
pajcho	Que está partido.
paje:la	Fósforo.
pajwela:moł	Caja de fósforo.
paj'i	Bufeo.
pakałe	Cubrí.
pakapaka:ye	Ser abusivo.
paka:si	Volcar.
paka:ye	Abusar de alguien.
pakaye:mes	Contar los días.
pakayewe:łe	Abusar de algo.
paka'orawanra:ni	Reloj.
pake:łe	Contar.
pakełpa	Contador, persona hábil para contar.
pakełpanne	Contador.
pakełwanra	Número.
pa:ko	Perro.
pa:kona:na'	Zorro.
pa:kori:sa	Pelo de perro.
pakuka'as	No sabe nada de ello.
paku'	Ser vivo(a) entendido(a).
paku'kapojcheł	Hacerse el vivo.
paku'na	Tener noticia, saber de algo.
paku'wa:nas	Conocimiento.
palomajcheł	Observar su propia conducta.
palomajna	Observar la conducta de otra persona.
palo:to	Escuchare.
pa:luy	Frío.
paluya:seł	Estar resfriado.
paluyasełni	Resfriarse.
paluyni	Frío.
paluyres	Homosexual, frialdad.
pałna	Pasar la mano sobre algo.
pamba	Pan.
pamba:ti'	Hacer pan.
pampammo'mo	Que va bien cargado.
paḿpaḿ	Nacer, brotar.
panuskwa	Estar adormecido(a).
panwe:lo	Pañuelo.
papawła	Ola.
parajna	Nivelar algo que contiene una basija.
para:na	Mirar algo. Analizar, observar, contemplar.
pariye:wa	Potro.
parukwammo	Cesta de boca pequeña.
pascho	Ser la mitad de algo.
pascho:ra	Tuerto, tener fallo de un ojo.
pasińna	Extender o tender algo que está arrollado.
paskwa	Navidad.
paspas	Todavía; encima de todo.
pa:sul	Enfriado.
pasulna	Enfriar algo.
pasulni	Enfriar.
pasyiń	Trabajar con una sola mano.
pato:re	Marimono.
pawaje:łe	Orientarse.
paya:ba	Darle la forma a algo redondo, por ejemplo hacer tinaja.
paya:bij	Hacer olla de barro.
paya:buń	Hacer objetos de barro.
paya'	Estar oscuro.
paya'ni	Oscuro.
paya'im	Noche oscura.
paychi	Estar nublado.
payesna	Sentir algo, olerlo.
payespayes	Se siente, se huele.
payłava:di	Casa embarrada.
payłim	Isla de monte.
payna	Revocar o afinar una pared.
payto	Terraplén.
pay'na	Empapar. Pringar, amoldar.
pa'a	Padre; señor.
pa:'i	Cura, sacerdote.
pa'kachołna	Visitar.
pa'na	Contar, medir, pesar.
pa'sine:łe	Volcarse.
pa'wawankwa	Padre, persona que hace de papá.
pa'winłe	Ganar cuando se hace una apuesta.
pa'i	Estar contado.
peka:to	Pecado.
pekato:pa	Pecador.
peka:vos	Alzar madera.
peke:łe	Estar alzando.
pelna	Llenar completamente, haciéndolo rebalsar.
pelpel	Rebalsar.
peła:cho	Romper.
peła:mo	Romper el monte.
pełcho	Roto de tal forma que se ve el interior.
pełna	Romper trapo o papel.
pembaycho	Tener ideas.
pencheł	Asentarse un pájaro, un avión.
penlo:łe	Meterse al agua.
penna	Lugar donde uno asienta.
pentej	Comenzar a trabajar.
penwiń	Comenzar a hacer algo.
peńcheł	Saludarse, hablarse.
peńna	Saludar a alguien. Hablarle.
pe:ra	Totora.
pe:rena:na'	Patujú del grande (parecido al plátano).
peresni	Ser filo.
pete:łe	Saludar, ¡saluda!
petełwa:nas	Saludo.
pe'bał	Una botella entera.
pe'łełe	Todo.
pe'łim	Chaco entero.
pe'na	Alzar, levantar un objeto pesado.
pe'nira'a	Hace caso, obedece.
pe'pojeł	Un racimo entero.
pe'res	Filo.
pe'ye:mes	Todo el día.
pe'yemeskwi	Pasó todo el día.
pe'im	Noche entera.
pe'o:ra	Una hora entera.
pe'oraneł	Tardar una hora.
pi:kolo	Pífano.
pilababał	Envolver bien.
pila:cho	Arrollar algo, liarlo.
pilba	Estar arrollado.
pilłe	Estar liado a algo.
pilna	Liar algo.
piłe:łe	Pintar, rayar.
piłna	Rayar.
pitełkwi	Cabo o mango de un hacha, machete, etc.
pi:wa	Lombriz intestinal.
piyesta	Fiesta.
piyo'	Serere de la pampa.
pi'chis	Chapapa.
podońcho	Estar volcado.
podota:wa	Comadreja.
pojełkwa	Recimo.
pojra	Mejilla.
pojsi	Verija, bajo vientre.
poka:cho	Tapar algo su abertura.
poka:choł	Encerrar algo tapándolo.
poka:kwa	Tapar algo con su propia tapa.
poka:łe	Encerrar echando llave.
pola	Tarde.
polababachiya:pa	Hetore.
polala'as	Se fue.
pola:ra	Nuevo.
pola:ta	Dinero.
polatino:na'	Año nuevo.
polawta	Flauta.
polayejcho	Luna nueva.
polkaba:ba	Revolcarse, ir dando vueltas, rodar.
połkabaycho	Componerse, distraerse a pesar de estar triste.
pono:na	Tocar una canción, por ejemplo con guitarra, bombo, violín, etc.
ponot'	Tocar instrumento.
pońmo	Levantarse de dormir.
po:poj	Rincón.
popojmo	Pescuezo, cerebro.
popoykwa	Animal.
popoykwanlo:maj	Persona con instinto animal.
po:ra	Ligero, apurado.
po:raka	Al momento.
posa:kwa	Entreverar algo.
posalobał	Entreverar con otra clase. Engrapar, por ejemplo el ganado.
poskwa	Estar entreverado, mezclado.
pota:mo	Levantar de dormir.
powba	Pam grande.
powcho	Ancho.
powcho:ra	Aujero ancho.
powjeł	Hormiga grande.
powlo	Laguna.
powlo:ba	Cuerpo grueso.
powlobijra	Orilla de una laguna.
powmuj	Viento.
powojlo	Poboslo (apellido).
powojlolo:ba	Pelota.
powol	Estera.
powolpa	Fabricadora de estera.
powolpiń	Estera pequeña.
powto:va	Fila ancha.
poyyey	Venado.
poyna	Mojar.
poy'i	Estar mojado.
po'dala'	Taracoe.
po'kwa	Estar tapada la boca de un objeto.
po'łe	Estar encerrado.
po'łecheł	Encerrarse.
po'na	Cerrar, tapar.
po'ros	Jausi.
po'so	Chicha.
pi:ri:ma	Prima.
pi:ri:mo	Primo.
pujła	Rallador.
pujła:vos	Corcho (árbol).
pujłew	Cola arrancada.
pu:jul	Fangoso.
pujulni	Está fangoso.
pula:cho	Barrer adentro.
pulacho:pa	Barredora.
pula:mo	Basurear.
pulalayasdi	Escoba de jipurí.
pulchinła	Pelar los dientes.
puła:mo	Desplumar ave.
punsi	Jochi colorado.
puńra:ni	Sobrar.
pupo:mo	Escoba.
pu:rań	Totaí.
purańdi	Fruta de totaí.
puruńcheł	Besarse.
puruńłe	Besarse.
puruńna	Besar a alguien.
pu:sa	Hediondo.
pusa:jeł	Hormiga hedionda.
pusa:ni	Estar hediondo.
pusa:ra	Carachupa.
puta:ra	Sobrar comida.
puya:ba	Arrollar, por ejemplo una estera.
puya:choł	Envolver en medio de algo.
puyba	Estar arrollado.
puyba:ba	Arrollarse.
puyna	Costurar el dobles de una vestimenta.
ra:cho	Partido, quebrado abierto.
racho:cho	Abrirse, partirse.
racho:na	Partir algo.
ra:da	Puerta.
radanłe	Puerta.
raka:ba	Deshecho, desbaratado.
rakamocho:na	Desparramar algo.
ra:kwa	Abierto, partido.
ralba	Estar roto.
rała:cho	Hacer reventar algo.
ralba'ojeł	Harapiento.
ralcheł	Desecharse, torcerse.
raładineł	Descocer algo.
rałba	Rotoso.
rałcho	Reventado.
rancho:cho	Reventado.
rałdinełe	Descocerse.
rałna	Arrancar algo.
rałpiń	Soltado.
ra:pal	Rojo, colorado.
rapalni	Enrojecer, volverse rojo.
ra:pis	Fuerte, agrío.
rapisni	Enfuertarse.
ra:pu	Rapu (apellido).
rapu'lo	Río Rapulo.
rapu'lo:mo	Monte del Rapulo.
rapu'ła	Guapurú.
raweta	Gaveta.
reskwa	Erutar.
rey	Pues.
reyka	Otra vez.
ridisti'	Llovizna, chilchear.
riła'oj	Planchar ropa.
riłna	Plancharlo, suavizarlo.
rima:łe	Venderlo.
rima:ye	Pagar a un trabajador.
rímenla	Comprarlo.
rimilni	Estar morado.
rimłe	Estar en venta.
rimni:wa	Herramienta.
rimti'	Hacer compras.
rińna	Barnizar, untar.
riri:ya	Cuco o cigarra.
risa:kwa	Pelo, cabello.
riskwi	Canilla.
ris'i	Canilla.
ri'na	Pintar.
rochindi	Pitón.
rochindo	Pitón (árbol).
roj'i	Semialtura.
roka:kwa	Tapar una vasija que contiene algo.
rokoroko	Insecto como el mosquito de color blanco.
roma:cho	Apretar y amasar.
roma:lo	Ordeñar.
roma:loł	Exprimir algo.
romkacho:na	Masajear algo.
romna	Apretar, masajear.
romo:moy	Con fiebre.
ro:moy	Fiebre.
romti	¡Aprete!
rońlo	Lejía.
rosna	Apagar, borrar.
rosońkwa	Despedir gas.
ro:so'	Gas.
rosros	Apagarse, borrarse.
ros'i	Estar apagado.
ro:ya	Casa.
roya:cho	Dentro de la casa.
roya:di	Casa pequeña.
ro'bał	Estar tapado(a), por ejemplo una persona.
ru:du	Vapor.
ruja:jas	Mal tiempo, tiempo con amenaza de lluvia.
rujałkay	Me preocupa.
rujałni:wa	Estar preocupado.
rujałni:ra	De preocuparse.
rujapanłe	Perjudicar, molestar.
ruja:ra	Fregar, embromar.
rujińna	Fallar un tiro.
rujkabaycho	Estar triste.
rujkapa:na	Truncar, estorbar a alguien.
rujlo:maj	Fracasar, sufrir un percance.
rujra	Estar fregado(a).
rujsi:kwa	Mal sueño.
rujwil	Hacer daño.
rulrul	Tigre.
rułkwa	Lengua (separada del cuerpo).
rul'i	Lengua.
rumba	Fruta casi podrida.
rumlo	Palo santo, palo diablo.
rumlo:jeł	Hormiga de palo diablo.
rum'i	Parásito.
ruḿchimpa	Bautizar.
ruḿna	Regar, rociar algo.
sabaycho	Estar loco.
sabaycho:jeł	Hormiga loca.
sabaychonana'ni	Hacerse el loco.
sabaychowa:nas	Locura.
sa:doy	Liviano.
sadoyni	Estar liviano.
saka'la	Cosorió (árbol).
salakwe:ya	Buscar mujer.
sala'mo	Ya vuelvo.
sale:łe	Estar buscando.
salkacho	Torcido.
salmo	Regresar, volver.
salmołe:na	Traer de vuelta.
salna	Buscar algo.
sama:di	Simbar lazo.
samadinłew	Simbar, trenzar el pelo.
sama:ris	Techar la casa con paja.
sama:to	Tejer sombrero.
samato:va	Acomodar en fila.
samayra	Mareo, estar mareado.
samdinłew	Trenzado. Simbado.
sandinłewmo	Jasayé.
samna	Tejer.
samresmo	Canasta de asiento tejido.
samto:ba	Estar en fila.
samtova:cheł	Ponerse en fila.
sani:ya	Sandia.
sankabaycho	Estar distraído.
sankapa:na	Turbarse.
sankawa:ni	Equivocarse al hablar.
sanka:ye	Victima.
sanuyni	Zaraso.
sańlo	Peroquí (ave).
sapa'mo	Tutuma.
sapa'monana	Tutumillo.
sapilcho:ni	Darse la vuelta con todo el cuerpo.
sara:dal	Estar mareado.
sa:ray	Orina.
sari:di	Paraba barba azul.
sa:vaw	Corriente de agua.
savawti'	Formando corriente.
savu:di	Tacuara para flauta.
sa:waro	Sábado.
sawa:way	Ponerse loco de amor.
sawa'bo	Mate (fruto).
sawe:łe	Sacar, alzar.
sawi:pa	Machete, trazado.
sawipanto	Machete pequeño.
sawła	Cuchara.
saya:ve	Remar.
sayłaye:do	Remo batidor de madera.
sayna	Sacar algo.
sayra:ma	Sairama (apellido).
se:den	Estar torrado.
sedenni	Torrarse, estar torrado.
sejawni	Estar recuperado.
sejdi	Bagre.
sejka:ye	Estar asutado(a).
sejni	Pintoneado el sembradío.
seka:ru	Cigarrillo.
sekaru:pa	Fumador.
sekayni	Oler a quemado.
se:kem	Jacuú.
sekemna	Comer con jacuú.
sela:di	Zelady (apellido).
selcheł	Montar a caballo.
se:le	Hamaca.
sele:maj	Estar en hamaca.
selna	Hacer subir a alguien.
senna	Sentir, oler.
se:rej	Amarillo.
serejawa:di	Amarillento, pálido.
serejmo	Tábano amarillo.
serejni	Amarillear, estar amarillo.
sere:ra	Arisco.
se:se	Amargo.
sese:ni	Estar o volverse amargo.
se:wo	Cebo.
se:ya	Ventón (pez).
seya:mo	Parabachi.
se'lo:na	Ahogarse con algo espeso.
se'mina	Ahogarse con agua.
se'na	Pitar, pitar un cigarrillo.
se'ru:na	Ahogarse con humo.
si:ba	Rana.
sibo'ni	Blandito, mallugado.
si:doj	Mono (mono silbador).
sidojłew	Cola de mono.
sidojra	Carne de mono.
sijilcheł	Sonar fino como cristal.
siki:cheł	Sonar.
siko:ya	Lagartija chupacoto.
sikwi:li	Lorito cotorrita.
si:lim	Bibosi (árbol).
sili:ni	Tener cicatrices.
silna	Adornar.
siłkwa	Cueva.
siłkwammaj	Puerco de la cueva.
siḿła	Silbar.
sinełkwa	Palabra.
sin'i	Puchíchi, furúnculo.
sińbi:ye	Atragantado.
sińchi	Con la nariz tapada.
sińcho:cho	Lleno, apretado.
sińchochołni	Estar apretado.
sińdi	Saltamonte o tucura.
si'lo:to	Sordo(a).
sińna	Coser, costurar.
si:siwa:di	Sayubú.
sita'oj	Costurar ropa.
sita'o:jeł	Costurarle la ropa a alguien.
site'ni	Oler a rancio.
si:vil	Pintado.
si:wa	Araña, sama.
siwaloto:to	Grillo.
si:ya	Silla.
siyełna	Acariciar a alguien.
si'way	Bueno, cortés, decente, amable.
sojolwampa	Chonono de cascabel.
so:kate	Algunos; una u otra persona.
soka'te	Solo, sólito; una sola persona.
soko:koń	Clara de huevo.
solopa:yi	Gracias.
solopayi:na	Agradecer a alguien.
soma:cho	Aplastar, por ejemplo un objeto metálico.
sondo	Hígado.
so:no	Tortuga, peta del agua.
sono:ba	Huevo de peta.
sonolba:ba	Ronchearse.
sońlo:ba	Amontonado.
sońlo:maj	Otra vez.
sońlo:wes	De otra forma.
sońne:mes	Otro día.
sońra	Otro, otra cosa.
sońte'	Desmayarse, perder el conocimiento.
sońtijna	Tener otra cosa que hacer.
so:riń	Ligero, veloz.
so:roy	Delgado, por ejemplo una tela.
soroyni	Ser delgado.
so:taj	Aparte, otra cosa.
sotajna	Apartar, guardar aparte.
sota'lo:ba	Un montón.
sota'loba:na	Hacer un montón, amontonar.
sota'lo:maj	Una vez.
sota'ra	Uno; una cosa.
so:te	Otra persona.
so:tełe	De otra persona; ajena.
so:wasłe	Arrastrarse.
soyła	Diente.
so'la	Tierra greda especial para alfarería.
su:ba	Mariposa nocturna.
sula:des	Snacadilla, hacerle caer.
sula:łe	Enredar algo con otra cosa.
sulłe	Estar enrredado en algo.
sulu:lu	Sapito chico.
sulu:ni	Arrugarse.
suḿchi	Sacudirse la nariz.
sumesni	Ser grasoso.
su*mamani	Estar entumido.
sumsum	Fruncirse.
suḿka:piń	Cinturón.
suḿna	Atar, amarrar.
suḿpi:łe	Amarrar su jase.
suḿsuḿpi	Jase.
supa:ba	Manea, amarrar bien.
supa:łe	Amarrar con soga o huasca.
sur'suru'	Caracoré.
situ:ka	Estar enojado.
sutulra	Tatú.
su:vuj	Azul.
su:we	Estar cerca.
suwuwunta	Lechuza.
suyna	Quitarle algo a alguien.
su'mes	Grasoso.
su'mesni	Ser nutritivo, grasoso.
su'pay	Aguacil (libélula).
tachołni	Duro (de carne).
tachołpa	Duro (de yuca).
ta:doy	Dulce.
tadoycho	Chive dulce.
tadoyna	Endulzar algo.
tadoyni	Estar dulce.
tajabeń	Estacar cuero.
taja:cho	Golpear algo.
tajachoba:kwa	Hacer una herida en la cabeza.
taja:poy	Atajar o parar a alguien.
tajchoba:kwa	Golpearse en la cabeza.
tajła	Dientes limados.
tajłacheł	Limarse los dientes.
tajna	Moler, estacar, moles.
tajpo	Atajarse, pararse, calmarse.
taka:ka	Garganta (el interior).
taka'ya	Bandurria.
talama:ni	Talamani (apellido).
tale:les	Estar ardiendo.
talota:lo	Cóndor.
talumba	Cayú.
talummo	Guineo.
talumni	Pichiró (sabor a fruta por madura).
talumre:mo	Guineal.
tama:ye	Despertarle a alguien.
tambojsi	Francuca; chuto, algo que no tiene cola.
tami:ba	Criatura, bebé.
tami:łe	Nacido, haber nacido.
tami:poy	Hembra parida.
tami:ti'	Dar a luz o parir.
tamolna	Extenderlo, desparramarlo.
tampiń	Cortado por medio.
tamu:mun	Regarse, esparcirse.
tamunles	Chispa de fuego.
tamunmi:na	Regar agua.
tana:di	Cortar granos, por ejemplo arroz.
tanadiwa:wa	Tiempo de cosecha.
tana:piń	Cortar por lamitad.
tanaro:so	Coger arroz.
tane:łe	Cortar.
tani:lo	Arco de flecha.
tanka:ba	Todo cortado.
tanka:piń	Estar cortado en varias partes.
tanloto:veł	Tener la oreja cortada.
tanna	Cortar.
tanusni	Estar húmedo.
tańba:łe	Bajarse.
tańchoł	Espacio abierto.
tańcho:łe	Alejarse dos personas que ya no se quieren.
tańkaba:na	Rebatir algo.
tańpa	Safarse, por ejemplo un canasto de un gancho.
tańvo:seł	Caerse de arriba.
tapela'ni	Relampaguear.
tapel cheł	Relampaguear.
ta:ra	Despertar.
tarałna	Sanar a alguien.
tarałni	Sanar.
tarawamba:ni	Despertador.
tarawanno	Cuando tocan las dos de la tarde.
tarawni	Taraune (apellido).
taro:ba	Tarro.
taru:ba	Carcaña (ave).
tasra	Tres.
tatabalkwa:na	Perdonárselo. Bajarle el precio.
tata:choł	Abrir espacio, dar campo.
tatapanłe	Escapar de la mano una cosa.
tava:kwa	Espuma.
tava:lo	Tuétano. Médula.
tabvaloba:kwa	Seso.
tavojveń	Piel blanca.
ta:voj	Blanco.
tavojba:kwa	Cabeza de pelo blanco.
tavojchodinła	Melero.
tawake:ni	Amanecer.
tawasdi	Patujusillo.
tawawa:ri	Tababari (apellido).
tawa'ni	Al día siguiente.
tawa'tovałni	Amanecerse en otra cosa.
tawla	Tabla.
tawna	Batir.
ta:wuł	Tajibo.
tawułmo:lo	Laguna del tajibo.
tawułmo:ri	Flor del tajibo.
taya:ko	Quemar.
tayawlo	Sudor.
tayko	Que está carbonizado.
tayla'a	Leque (ave).
tayo:ka	Estar sudando, caluroso.
ta'as	Anguila eléctrica.
ta'cho	Apertura.
ta'ka:ba	Estar rebatido.
ta'kaba:na	Rebatir.
ta'ka:pa	Soltarse, varias cosas.
ta'tuwanra	Anzuelo.
te:des	Bajo de estatura.
tedo:woj	Huatoco.
tedowojye	Persona de baja estatura.
tejna	Colar.
takasba	Churuno, fruto del mate.
tela	Casi.
telaka'ni	Que llegue.
telayka:ka	Algún día.
telayni	Venidero, que está por llegar.
telemsineł	Con voz vibrante.
te:lo	Bailar.
telo:pa	Bailador.
telo'imna	Que baila toda la noche.
tanapanłe	Poder hacerlo.
tenapanłe:pa	El que tiene poder para hacerlo.
tenaymo	Tábano.
teńcheł	Asustarse.
teńka:ba	Barquinear.
te:ra	Corto.
tera:ni	Estar enfermo.
teranini:ye	Persona enfermisa.
terani:poy	Animal enfermo.
terescho	Al medio, al centro.
te:ridi	Varilla cortita.
terescho:ma	Estar al medio, centro.
terescho:ma	Del medio de la madera incorruptible.
tereslo:los	El centro del pueblo.
teres'im	Media noche.
tescheł	Cojear.
te:si	Poco profundo.
tesi:loł	En lo pando del agua.
teskadi:wa	Cojeando.
te:teka	Recién.
teteykwa	Cogollo.
tey'i	Pene.
ti:chol	Lúcumo (árbol).
tichołdi	Semilla de lúcumo.
tijakwe:ya	Molestar a una mujer.
tija:łe	Persistir hasta lograr lo que uno quiere.
tija:si	Mentira.
tijasi:pa	Mentiroso.
ti:je	Adorno.
tije:na	Adornarlo.
tijeto:na	Adornar sombrero.
tijka:choł	Mentira.
tijkachołna	Mentirle a una persona.
tijkaka:ra	Pertenecías, utensilios, herramientas, trastes.
tijka:rim	Trabajar.
tijkarimpa	Trabajador.
tijkarimwa:nas	Trabajo, pega.
tijkarimwanra	Instrumento para trabajar.
tijna	Molestar.
tikoycheł	Matarse, suicidarse.
tikoyna	Matarlo.
ti:łoy	Liso.
tiłoyni	Suave.
tinno	Sol.
tino:ka	Tener miedo.
tino:na'	Año, tiempo.
tinno:ti'	Soleado.
tino'	Algo que infunde miedo.
tino'ba:na	Temer.
tino'ni	Que da miedo.
tino'si	Miedoso, cobarde.
ti:poł	Alcornoqui (árbol).
tipołbeń	Casra del alcornoqui.
tipołbeńti'	Sacar cascar de alcornoque.
tipołmo:ri	Flor de alcornoque.
tirinra	Trinidad.
tintimba	Chonono, cascabel.
titi:ti	Tiluchi.
ti:vij	Dolencia enfermedad.
tivijni	Doler.
tivijpojkay	Sentir algún pesar.
tivijsoyła:ni	Estar dolorido del diente.
ti'lis	Especie de loritos.
to'ba	Garza blanca.
to'baycho	Acordarse.
tobeńkwa	Piel, cascara del árbol, cascara de la fruta.
tochi:chi	Esquina.
tochinkwa	Retoño.
tochinti'	Retoñar.
tochi'	Pequeño.
tochi'cho	Angosto.
tochi'mo	Pollito.
todankwa	Pedacito de astilla, vidrio, madera.
tojeł	Mucho, muy, sumamente, ¡caramba!
toje:łe	Pasar.
tojełna	Pasar por un lugar donde siempre se pasa.
tojełpojna	Hacer pasar por alto.
tojełpojnakwa:na	Perdonarle.
tojtey	Totachi.
to'way	Tapacaré.
tokacho:ra	Horadar, perforar algo.
toka:da	Cepe.
toka:ve	Singuear.
tokavewanra	Singa.
toka'yaj	Salvar de un peligro.
tokela'ni	Aparecer de repente.
tokwandi	Sirari.
tokwi:kwi	Puerto.
tola:cho	Tunar, vistar a una mujer.
tolacho:pa	Tunante, darse la mano.
tolejdi	Escalera.
tolejkwa	Gajo, rama, palito.
tolkara:na	Robarle a alguien.
tolkarana:pa	Ladrón.
tolkosmo	Gallina jóven.
tolkosya	Muchacha, mujer joven.
tolo:do	Chaicita.
tolwsi	Perdiz.
to:mi	Agua.
tomi:maj	Estar en el agua.
tomimajye	Gente del agua.
tomina:kwa	Hay agua.
tomi:na'	Tiempo de agua.
tomo:re	Olla grande de barro cocido.
tompoye:łe	Ensillar caballo.
tona:bał	Envolver.
tonamo:si	Ensillarlo.
tona'oj	Remendar la ropa.
tonna	Remendar.
tono:ko	Mamuri. Carcoma.
to:piń	Corredor o acera.
to:ra	Sentido.
torada'	Pato roncador.
tordeta	Mosquitero.
tore:na	Golpearlo con algo.
to:ri	Lugares marginales.
tori:di	Orilla.
tori:ka	Loro medio verde.
tori:na	Baño. Ir al baño.
torindi	Riñón.
torojka'waj	Sacudir la cama.
toronja	Sacudir con trapo para quitar el polvo o tierra.
toromna	Beber algo líquido.
toro:poy	Animal macho.
torowa:re	Gallo.
to:ro'	Interior.
toro'chimpa	Corona.
toro'maj	Estar debajo.
tosba	Pene pelado.
tosba:kwa	Calvo.
toschoł	Desprendido, por ejemplo una calucha de su cascara.
tosna	Pelar.
tosworo'di	Piroco.
toti'	Pequeñito.
toto:kwa	Adobe.
toto:mo	Chaparral.
tova'cho	Chive simple.
tova'loł	Alimento fresco hecho de masa de yuca.
tova'ni	Estar recién enfuertado.
tovaykwa	Ala, paleta.
to'yaj	Haberse salvado de un peligro.
to'ya	Salvarse.
tuka:boj	Pilotear una embarcación.
tuka:ve	Singuear.
tuku:ku	Sumurucucu.
tululu:si	Jarajorechi.
tu'ła'a	Su punta.
tułna	Rallar con la punta del cuchillo.
tuł'i	Estar rallado.
tumvuń	Mosquito grande.
tuncho	Chive negro.
tu:ne	Persona morena.
tunni	Negro.
tuntunsi:ni	Orificio o hueco negro.
tun'oj	Tela negra.
tun'ojeł	Estar vestido(a) de negro.
turil	Turril.
turu:chi	Punta de la nariz.
tuspa'	Sucha.
tusulna	Golpear sobre la tierra.
tute:kwa	Cañería.
tuvusmo	Ave de color ceniza.
tu:we	Hormiga chotota, tucandera.
tuya:wa	Borochi.
tu'chołwanri:di	Varilla del mosquitero.
tu'ła	Pico de la ave.
tu'łe	Estar encerrado bajo llave.
tu'na	Cerrar con llaves.
ukaḿ	Sábalo.
ukwampa	Brujo.
ukwanna	Hechizar a alguien.
ulchał	Suegro, se usa para nuera y yerno.
u:liḿ	Mauri del chico.
ulkwań	Tu, usted.
ulu'tey	Sapo escuerzo.
uma:beń	Enviar una carta.
uma:ra	Enviar algo.
umcheł	Entregarse.
umcho:łe	Allegarse, amistarse.
ura*be	Prohibido, no sirve.
uḿna	Prohibir.
uńcho:łe	Esquivarse, alejarse dos personas que ya no se quieren.
upa:vos	Trepar a un árbol o palo.
upavaswanra:ni	Palo encebado.
u:ru	Este (aquí cerca).
uru'ła	Reñir.
usamo:mo	Empujé.
uscheł	Apartarse.
use:łe	Empujar, dar ánimo.
usko	El (ausente).
usna	Apartar algo.
uso'	Estaba el.
uta:be	Prohibir.
uya:kwa	Meterle en la boca.
uycho:pa	Recibir en propias manos.
uye:na	Mezquinar.
uykwa	Tener en la boca.
u'ko	El (presente).
vabaskwa	Harina.
vaḿvaḿ	Aparecer de la nada.
vanuyni	Machinarse.
va'kalowiń	Ensayar el vuelo.
vańkapa	Estudiar.
vańkapanasna	Estudiar.
vańkapawanne	Estudiante, alumno.
vańkato:łe	Alabarse.
vańna	Crear, inventar.
vatalo:maj	Dar instrucciones.
vatolo:wes	Indicar la modalidad.
vata:pa	Enseñar a alguien.
vatapancha:ye	Enseñar.
vatapanchaye:pa	El que enseña; profesor.
vata:poy	Amansar un animal.
vatasi:pa	Alguien que se inventa cosas.
vata:wa	Enseñar sonidos.
va:vayiń	Aleteo de las aves.
vaye:łe	Mirar.
va'kwa	Caer de bruce.
vebeskwa	Costilla.
velaye:pa	Niñera, enfermera.
velna	Ver, contemplar, cuidar.
velti	¡Mira!
veyo'ni	Estar tibio.
veba:kwa	Tizón.
ve'e	Fuego.
ve'e:piń	Vela.
ve'e:ti'	Arder fuego.
ve'e:vus	Ceniza.
vi'chi	Clavícula.
vi'cho	Cerco cerrado.
vi'cho:łe	Encerrarse en un canchón.
voboskwa	Majlo; lo que queda del maíz.
vokocho:na	Enjuagarlo por dentro.
vokolołna	Enjuagar.
vokomi:na	Entreverar agua lentamente.
vola:kwa	Voltear el cuerpo, cambiar de dirección.
vola:to	Cambiarlo de base.
volbaycho	Cambiar de idea; no querer volver.
volkato:choł	Volcarse de un lado para otro.
volkwa	Dar media vuelta.
volrada	Volverse en; cambiar apariencia, hacer de nuevo.
volto	Estar volcado, cambiado de lado.
volye	Mirar hacia atrás.
vo:sim	Paquió (árbol).
vosimbeń	Cascara de paquió.
vosimdo	Fruto del paquió.
voslo:łe	Ampolla.
vobijkwa	Chala de maíz.
vubujna	Rociart.
vubujti'	Lloviznar.
vubuj'ojna	Rociar ropa.
vuku:cho	Chive fino.
vuku:ni	Fino harinoso.
vulni	Pitón.
vusa:łim	Quemar chaqueado.
vusayjeł	Orevaré.
vuskwa	Polvo de la tierra.
vusłe	Quemarse, chamuscarse.
vusna	Chamuscar.
vusuńna	Hacerlo picante.
vusu'	Picante.
vusu'dul	Ingibre.
vusu'ni	Estar picante.
vuwa:ni	Olor a fruta madura.
wa:cho	Estar mojado.
wachołra	Avansarle en una visita imprevista.
wa:choye	Mojarse.
wada:ka	Huaracachi.
wadakamuń	Pluma de huaracachi.
wadi'	No importa.
wadu:dul	Agazapado.
wadulpiń	Estar agachado.
waja:mo	Carpir un pajonal.
waje:łe	Carpir.
wajle	Cusi.
wajle:di	Cala de cusi.
wajle:mo	Cusisal.
wajna	Carpir, deshierbar.
wa:ka	Vaca.
wa:ka:di	Correa, huasca.
wa:ka:ni	Carnearse.
wa:ka:ti'	Carnear.
wa:kato:da	Carne, pedazo de carne.
wa:kawandi	Corral, estancia.
wa:kawandimmajye	Ganadero.
kaki:ya	Vaquilla.
wala:cho	Arroyo.
wala:si	Cueva.
walaychi	Con la cabeza agachada.
walaychidus	Bizquear.
walaydi	Sarso.
waldupiń	Agacharse.
wali:ma	Gualima (apellido).
walu:sa	Camote.
wałna	Rascar.
wanayle	Guanaile (apellido).
wapayto'	Cigüeña.
wara:day	Gritar. Labrar.
wara:po	Refresco.
waryasna	Gritar de dolor.
waraylos	Llorar agrito.
wara'tey	Sapo.
wa:rey	Aún cuando.
wa:ris	Joco, zapallo.
warisdi	Semilla de joco.
rarismo	Jocal.
wasa:cho	Abrir a la fuerza algo que no es para abrir.
wascho	Estar vacío.
wase:łe	Servir comida.
wa:se:na	Mapajo.
wasina:we	Guasinave (apellido).
wasna	Batir o mermar.
wa:so	Vaso.
wasojmo	Bofe.
watayka	Guataica (apellido).
wa:wa	Caracol.
wawalo:maj	Verdadero; vale la pena.
wawankwa	Bejuco.
wawankwammo	Bejucal.
wawanlo	Lago misterioso que se dice era una ciudad.
wawasi:na	Decir la verdad.
wawasinapojna	Creerle, darle crédito.
wa:watoł	Mejor.
wa:wos	Pavi.
waya'cho	Surcir algo.
waya:łe	Mancornar.
wayape:ra	Manguarí.
wayasłe	Callarse.
waybuswa	Boyé.
wa:yes	Honrado, de conducta intachable.
wayesna	Respetar a alguien.
wayeswa:nas	Respeto.
wayewaye	Oso hormiga.
wayiń	Espeso.
waykaba:ba	Encogerse, fruncirse.
wayna	Alzar, sacar con la mano.
wa:yo	Choco, rubio.
waypa	Estar agarrado.
way'cho	Remendado de apenas.
way'kachocho	Tener calambre.
wa'o'o	Guajojó.
wa'waj	Carpir.
wa'way	Ardilla.
wa'wa	Zorrino.
welayni	Me anda.
welcho	Gatear.
welełba:łe	Subir al barranco.
wele:łe	Trepar, subir arriba.
welełka'asna	Subir a la nada.
welełpa	Trepador(a).
werelni	Secar.
wereycho	Tiesto.
wescho	Abierto a la fuerza.
wesmo:łe	Abrir el monte (buscando salida).
wesna	Abrir a la fuerza.
we:wes	Jueves.
we:wew	Ardor.
wewewni	Me arde.
we:ye	Buey.
we'rel	Seco.
wi'lili	Pato putirí.
wilna	Atropellarlo.
wi:sisi	Pato vichichí.
wisna	Afilar. Blanquear.
wi'wis	Arena.
wi'wisti'	Ir por arena.
wo:chi	Gusano.
wo:ja	Mosquito medio morito.
woje:łe	Hace picar.
wojwoj	Sabañón.
woloto:to	Oreja de palo, hongo.
wonowo'	Tucán.
wońna	Cavar.
woro:keł	Cuello de una prenda de estir.
woro'	Garganta.
woro'ba	Coto, bocio.
worsi:ko	Bolsillo.
wo:sana	Gusano de donde provienen las moscas.
wosba	Renacuajo.
woscho	Hueco.
woslo:łe	Ampollarse.
wote:łe	Cavar.
woto:ne	Botón.
wo:tos	Estar hinchado.
wotosni	Hincharse, inflamarse.
wo'le	Hacer bulla.
wo'na	Excavarlo.
wo'ray	Vampiro.
wo'wo	Ambaibo.
wo'wojeł	Hormiga de ambaibo.
wo'wovos	Madera de ambaibo.
wula:ko	Enterrar, sepultar a un muerto.
wulakochaye	Ir a un entierro.
wulka:rim	Sembrar.
wulko	Enterrado, sepultado.
wulna	Sembrar.
wulwanra	Sembradío.
wulwanra:ni	El sembradío que se va sembrar.
wuru:du	Técnicamente.
wurulcheł	Tronar.
wurultu	Voz gruesa.
wuru:na	Novelear.
wusayjeł	Hormiga orebaré.
wusu'duł	Ingiere.
wusu:wu'	Bato.
wutuscheł	Sonar brevemente.
wutusna	Hacerlo sonar.
wuychuskwa	Pico cerrado.
wuykwa	Estar errado.
wu'tu	Olla.
wu'tuba	Ollita.
ya:ba:kwa	Sumergirse, hundirse.
ya:baycho	Estar desanimado(a) quedar conforme.
ya:bajel	Hasta el tronco.
ya:desna	De este tamaño.
yaja:loł	Materlo al agua.
ya:koma	Yacuma.
yaku:kuń	Encogerse.
yaku'na	Pasarlo en agua herviente.
yalawma	Yalawma (apellido).
ya:loma:maj	Dejar de existir.
ya:loł	Inundado.
ya:lo:we	Tomar beber.
ya:lowe:pa	Bebedor.
ya:lowesicha'kwa	Tener sed.
ya:lowewamba:ni	Vaso, taza.
yamba	Estar doblado.
yampa	Rayo.
yampiń	Doblado(a), arqueado(a).
yamu:muj	Cansado(a), fallando la respiración.
yana:ba	Doblar.
yana:we	Sicurí, anaconda.
yandu'	Encorvado.
ya:ni:kay	Sobrino.
yańlo	Abajo.
yańna	Apretar una masa.
yańsi:łe	Hundimiento de la tierra.
ya:pa:na	Llegar al destino.
yariya:ri	Cuco o cigarra.
yasba:kwa	Hacer la venia.
yascho	Estar desinflado.
ya:sina'	Alcanzar algo.
yata:buń	Amasar una masa.
yata:mi	Sacar agua de una vasija.
yate:tej	Sentir cansancio.
ya:ya'	Tío.
ya:yu'	Estar bien.
ya'ko	Estar atrasado, llegar tarde, el último.
ya'lo	Abajo; lo que no es el cielo.
ya'łe	Inmediatamente.
ya'łeka	Inmediatamente.
ya'muj	Desayuno; comer después de estar hambriento.
ya'ya:ma	Pájaro carpintero.
yejcho	Luna; mes.
yeła:loł	Espesar un alimento echándole algo.
yeła:mi	Echar agua.
yełamimilu'	Lluvia torrencial.
yełna	Alojamiento. Echar en algo, por ejemplo hielo al agua.
yełyełwanra:ni	Aliciado.
