A'gi	<font color=ForestGreen><b>bot.s.:</b></font> Árbol de guapomó, que crece en los llanos orientales de Bolivia.
A'i	<font color=ForestGreen><b>bot.s.:</b></font> Guapomó. Fruto del árbol del guapomó.
Ajachpa	<font color=ForestGreen><b>vtr.imper.:</b></font> ¡Reciban! ¡Recíbanlo! Orden que da una persona a un grupo para que reciba a personas, animales o cosas.
Ajakaragi	<font color=ForestGreen><b>n.f.pl.:</b></font> Muela/molares. Dientes de otras personas. 
Ajañoka	<font color=ForestGreen><b>vtr.imper.:</b></font> ¡Cuiden! Orden de cuidar.
Ajañokagnenajicha	<font color=ForestGreen><b>vtr.imper.pl.:</b></font> ¡Cuídenmelo muy bien! Cuidar personas, animales o cosas.
Ajañokajno	<font color=ForestGreen><b>interj.:</b></font> Advertir a alguien de cualquier tipo de peligro.
Ajañokajnotsero	<font color=ForestGreen><b>vtr.imper.pl.:</b></font> ¡No se descuiden! No descuidar a personas, animales o cosas. Atento en el cuidado.
Ajañokripo	<font color=ForestGreen><b>vtr.interrog.:</b></font> ¿Ya lo cuidaron? Persona que pregunta si cuidaron a alguna cosa de mucho valor.
Ajañoriko	<font color=ForestGreen><b>vtr.ger.interrog.:</b></font> ¿Están cuidando? 1.- Persona que pregunta a un grupo si están cuidando animales o cosas. 2.- <font color=ForestGreen><b>Coloq.:</b></font> Velar a un difunto.
Ajañosnanu	<font color=ForestGreen><b>vtr.imper.pl.:</b></font> ¡Cuídenmelo! Orden de una persona a otras de cuidar a personas, animales o cosas.
Ajatka	<font color=ForestGreen><b>vtr.:</b></font> Rebanar. Hacer rebanadas de alimentos sólidos u otros objetos.
Ajatpaka	<font color=ForestGreen><b>vtr.:</b></font> Picar. Picar hoja de tabaco, como también la yuca asada.
Ajátaka	<font color=ForestGreen><b>vtr.imper.:</b></font> ¡Enganchen! Acción de sujetar, enganchar y unir.
Ajawonra	<font color=ForestGreen><b>n.m.ind.:</b></font> El jabón de ustedes. Jabón que pertenece a otras personas.
Ajeppono	<font color=ForestGreen><b>vtr.interrog.:</b></font> ¿Traen? Acción de traer algo. Pregunta que hace una persona en traer productos agrícolas del chaco.
Ajeppueko	<font color=ForestGreen><b>n.m.:</b></font> Gases intestinales. Residuo gaseoso de la digestión que se acumula en el intestino y causa molestias.
Ajichrokwoo'i	<font color=ForestGreen><b>vtr.:</b></font> Saludar. ¿Cómo están ustedes?
Ajiimone	<font color=ForestGreen><b>vtr.pron.demos.:</b></font> Señalar la costilla de una persona.
Achimroka	<font color=ForestGreen><b>vtr.imper.:</b></font> ¡Sorpréndanlo ustedes! Sorprender a otras personas, animales.
Achmonsi	<font color=ForestGreen><b>n.f.:</b></font> Simba de hamaca, que sirve de soporte para colgar una hamaca.
Achpi	<font color=ForestGreen><b>n.m.:</b></font> Hilado. Material de algodón para elaborar hamaca.
Achpiji	<font color=ForestGreen><b>n.m.:</b></font> Tejido de algodón para confeccionar hamacas.
Achu	<font color=ForestGreen><b>n.f.:</b></font> Hamaca: Tejido de hilo de algodón fabricada a mano, de acuerdo al contexto de cada pueblo originario.
Achuksipewo	<font color=ForestGreen><b>n.m.indic.pl.:</b></font> El talón de ustedes. Manera de señalar a los demás la parte posterior del pie humano.
Achúmora	<font color=ForestGreen><b>n.m.coloq.indic.:</b></font> Su Toco. Mueble o taburete rústico.
Achuti	<font color=ForestGreen><b>n.f.mod.indic.:</b></font> La cabeza de ustedes. Parte superior del cuerpo del hombre dicho de manera indicativa a un grupo de personas.
Ajat-sigia	<font color=ForestGreen><b>vtr.imper.:</b></font> ¡Rebánenlo! Orden de una persona a otras para que rebanen o corten frutas o maderas.
Ajipño	<font color=ForestGreen><b>n.f.mod.indic.:</b></font> La uña de ustedes. Placa córnea y dura que cubre y protege la parte superior de la punta de los dedos del hombre y otros vertebrados.
Ajira	<font color=ForestGreen><b>vtr.imper.pl.:</b></font> ¡Lean! ¡Canten! Mandato de leer a un grupo.
Aaku	<font color=ForestGreen><b>adj.:</b></font> Arqueado. Que está curvado en forma de arco.
Aakucho	<font color=ForestGreen><b>adj.:</b></font> Exclusivo para objetos: Tabla, pared o muro. Con simetría arqueada por fenómeno natural.
Aakuj'e	<font color=ForestGreen><b>adj.coloq.:</b></font> Torcido o “simbrado”. Canoa torcida por efecto de la naturaleza. Persona que camina agachada por alguna enfermedad o edad.
Aakuno	<font color=ForestGreen><b>adj.:</b></font> Arqueado. Exclusivo para plantas o árboles. Planta de palmera, tacuara o bambú, chuchió, caña que tiene el tallo arqueado. 
Aakupi	<font color=ForestGreen><b>adj.coloq.:</b></font> Torcido.  <font color=purple>Ej.</font> Cable, bejuco o rama, liñada, soga, que por su uso llega a torcerse.  <font color=purple>Ej.</font> Expresión que se da a la forma del arcoíris.  <font color=purple>Ej.</font> Camino o senda que tiene curva.
Aami	<font color=ForestGreen><b>n.m.:</b></font> Temor. Miedo que se siente al considerar que algo perjudicial o negativo ocurra. Sobresalto o sensación de alarma. Respuesta de la mente y del cuerpo de un estímulo repentino o inesperado (A la luz, sonido, ruido, movimiento, oscuridad).
Aamonka	<font color=ForestGreen><b>n.f.:</b></font> Albóndiga - almóndiga. Alimento elaborado de carne molida con mezcla de varios ingredientes.
Aamutu	<font color=ForestGreen><b>vtr.imper.:</b></font> ¡Reúnanse! Acto de reunirse por orden de una persona.
Aapájore	<font color=ForestGreen><b>n.f.:</b></font> Decoración, colocación y combinación de alimentos elaborados que se exhiben para las fiestas religiosas.  <font color=purple>Ej.:</font> Pan de arroz, jalea, chancaca, bizcocho de maíz, chima de maíz, etc.
Aatattaji	<font color=ForestGreen><b>n.m.adj.:</b></font> Peyorativo. Actitud negativa, frente a una persona que pone en duda su capacidad e integridad moral.
Ajiragienenajicha	<font color=ForestGreen><b>vtr.imper.pl.:</b></font> Orden de una persona a un grupo. ¡Lean bien o lean de verdad!
Ajirajnotsero	<font color=ForestGreen><b>n.f.:</b></font> Recomendación. Acción de recomendar de una persona a un grupo para que no se olviden de leer.
Ajochegia	<font color=ForestGreen><b>vtr.:</b></font> Quitar la piel, la cáscara, la corteza o la envoltura de algo. Pelen la cáscara de la yuca o de alguna fruta.
Ajoono	<font color=ForestGreen><b>n.m.pron.poses.:</b></font> El horno de ustedes. Bloque elaborado de barro para la cocina. Se utiliza para hornear, cocer, asar: pan, pan de arroz, bizcocho, carnes, etc.
Ájosi	<font color=ForestGreen><b>n.m.:</b></font> Planta de ajo - Cabeza de ajo. Fruto en cápsula que encierra unas semillas arriñonadas; el bulbo, de olor y sabor intenso, también se usa como medicina tradicional.
Ajpe	<font color=ForestGreen><b>n.m.zoo.:</b></font> Pez llamado belea. Pez de agua dulce y de cordillera.
Ajunopoo'o - Ajumpoo'o	<font color=ForestGreen><b>adj.n.f.m.pl.:</b></font> Corredor. Ustedes son corredores. Grupo de personas rápidas para correr.
Ajunopopuiko - Ajumpopuiko	<font color=ForestGreen><b>vtr.ger.coloq.:</b></font> “Correteando” Niños que corren sin ningún orden.
Ajúnopa	<font color=ForestGreen><b>vtr.imper.pl.:</b></font> ¡Corran! Orden de una persona a un grupo de personas para que corran.
Ákaesi	<font color=ForestGreen><b>zool.n.m.:</b></font> Ejene: Insecto de color negro o gris muy pequeño, no más grande que la cabeza de un alfiler. Al picar sobre la piel, produce alergias, escozor y ardor intenso.
Ákaji	<font color=ForestGreen><b>vtr.imper.:</b></font> ¡Invítenle! Pedir a una persona que participe en una celebración o un acontecimiento organizado por uno mismo.
Akaji	<font color=ForestGreen><b>vtr.interrog.:</b></font> ¿Le invitaron? Pregunta de una persona a otra si compartieron lo que tenían.
Akajkoko	<font color=ForestGreen><b>vtr.imper.pl.:</b></font> ¡Repártanse! Dar a cada una de las personas que forman un grupo la parte que les corresponde de determinada cosa.
¿Akajkoko?	<font color=ForestGreen><b>vtr.interrog.pl.:</b></font> ¿Se repartieron? Pregunta de una persona a otros si se repartieron de lo que tenían.
Aktikko	<font color=ForestGreen><b>vtr.:</b></font> Compartir. Dar a una persona parte de lo que tiene en partes iguales: alimentos, objetos, espacios.
¿Akámisa?	<font color=ForestGreen><b>deter.poses.interrog.:</b></font> ¿La camisa de ustedes? Se dice para saber si la camisa es de ustedes.
Akamisa	<font color=ForestGreen><b>n.f.pron.demos.:</b></font> Su camisa. Prenda de vestir de otra persona.
Akamasi	<font color=ForestGreen><b>vtr.prnl.imper.:</b></font> ¡Acéitense el cabello! Orden a un grupo para que se aceiten el cabello.
¿Akámasi?	<font color=ForestGreen><b>vtr.prnl.interrog.:</b></font> ¿Se aceitaron? Se dice para saber si las personas se aceitaron el cabello.
Akarawo'u	<font color=ForestGreen><b>vtr.imper.pl.:</b></font> ¡Estudien! Se usa para ordenar que estudien o como también para preguntar si están estudiando.
Akatajigia	<font color=ForestGreen><b>vtr.:</b></font> Hagan el favor. Aconsejar a alguien sobre lo que puede o lo que debe hacer para el bien o beneficio de otro.
Akayawini – Akeywini	<font color=ForestGreen><b>interj.coloq.:</b></font> Expresión de sentir dolor momentáneo.  <font color=purple>Ej.:</font> ¡Por Dios que me duele! ¡Los ayes! <font color=purple>/</font> <font color=blue>¡Ayayai!</font>
Akchimra	<font color=ForestGreen><b>adj.:</b></font> Visitante. Tengan visita. Llevarle visitas.
Akchina	s.dem.m.coloq.: “Tengan yerno”. Exclusivo para exponer un pariente que pueda ser visto por todos.
Akchimro'u	<font color=ForestGreen><b>vtr.imper.:</b></font> ¡Déjense sorprender! Dejarse sorprender por personas.
Akchineno	<font color=ForestGreen><b>demos.f.coloq.:</b></font> “Tengan nuera”. Exclusivo para exponer una pariente que pueda ser vista por todos.
Ákeeresi	<font color=ForestGreen><b>pron.demos.coloq.:</b></font> “Tengan vaso”. Exclusivo para exponer un objeto que pueda ser visto por todos.
¿Akeeresi?	<font color=ForestGreen><b>vtr.interrog.:</b></font> ¿Tienen Vaso? Se utiliza para preguntar si tienen
Akemnaksare	<font color=ForestGreen><b>vtr.imper.:</b></font> ¡Tengan amigo(a)! Especialmente de posesión, pertenencia o inclusión, con la persona designada por el sujeto.
Akemnaksi	<font color=ForestGreen><b>vtr.indic.imper.:</b></font> ¡Háganse querer! Ganarse la amistad, el aprecio o la admiración de una persona.
Akemtone	<font color=ForestGreen><b>vtr.imper.pl.:</b></font> ¡Trabajen! Someter a personas a una acción continua y ordenada.
Akepchi	<font color=ForestGreen><b>vtr.indic.imper.:</b></font> ¡Háganse apalear! Advertir de una posible paliza a alguien, en especial con un palo o con otro objeto contundente.
Akepsa'o	<font color=ForestGreen><b>vtr.indic.imper.:</b></font> ¡Háganse mojar! Advertir castigo si llegara a quedarse impregnado de agua.
Akepsi'o	<font color=ForestGreen><b>vtr.imper.prnl.:</b></font> ¡Ahúmense! Persona que ordena desinfectar una cosa por medio de humo o vapores apropiados.
Ákesaviipe	<font color=ForestGreen><b>vtr.imper.pl.:</b></font> ¡Tengan machete! Que ordena hacer posesión, pertenencia, exclusivo de un machete.
Akesaviipeji	<font color=ForestGreen><b>vtr.interrog.pl.:</b></font> ¿Trajeron machete? Se usa para preguntar si han traído machete.
Akesta	<font color=ForestGreen><b>vtr.imper.pl.:</b></font> ¡Hagan chicotear! Imponer un castigo a quienes ha cometido un delito o una falta.
Akestano	<font color=ForestGreen><b>vtr. interrog.pl.:</b></font> ¿Los chicotearon? Castigar con el chicote u otro objeto semejante a un animal o una persona.
Akewis'a – Akosku'a	<font color=ForestGreen><b>vtr.imper.pl.:</b></font> ¡Apártense! Poner a una persona o una cosa lejos o más lejos de otra o de un lugar determinado.
Akagieji	<font color=ForestGreen><b>n.f.:</b></font> Advertencia. 1.- <font color=ForestGreen><b>n.m.:</b></font> Acción de advertir una situación peligrosa. 2.- <font color=ForestGreen><b>vtr.neg.:</b></font> Rehusar a recibir a una persona(s).
¿Akíjare?	<font color=ForestGreen><b>vtr.interrog.pl.:</b></font> ¿Tienen nombre? Preguntar una persona a otras sobre sus nombres.
Akikchosi	<font color=ForestGreen><b>vtr.imper.pl.:</b></font> ¡Háganse bautizar! Administrar a una persona el sacramento del bautismo.
Akitekpa	<font color=ForestGreen><b>vintr.imper.pl.:</b></font> ¡Háganlo llegar! Pasar a estar [una persona o en el fin o el término de un desplazamiento.
Akitemra'i	<font color=ForestGreen><b>adj.pl.:</b></font> ¡Molestosos! Personas que causan molestia continua.
Akjaasamre	<font color=ForestGreen><b>vtr.imper.pl.:</b></font> ¡Preocúpense! Persona que manda ocupar insistentemente el pensamiento de muchas personas a algo que puede ser perjudicial.
Akmesa	vrt.imper.pl.: ¡Insistan! Hacer hincapié en algo, para destacar su importancia, repitiéndolo.
Akmet-si	<font color=ForestGreen><b>vtr.imper.pl.:</b></font> ¡Cocinen! Ordenar preparar un alimento para que quede listo para ser comido.
Akmetoriru	<font color=ForestGreen><b>vtr.:</b></font> Anunciar. 1.- Ordenar para que se anuncie un mensaje, aviso, noticias, etc. 2.- Hacer saber una cosa o darla a conocer públicamente.
Akmopra	<font color=ForestGreen><b>vtr.:</b></font> Aprovechar. 1.- Ordenar a un grupo de personas aprovechar el tiempo a consultar algo a alguien en el momento oportuno. 2.- Utilizar cierta circunstancia para obtener provecho o conseguir algo en beneficio propio.
Aknoopeji	<font color=ForestGreen><b>vtr.imper.pl.:</b></font> ¡Lleven su remo! Ordenar exclusivamente a un grupo de personas para que lleven su remo.
Aknorogi	<font color=ForestGreen><b>vtr.imper.pl.:</b></font> ¡Lleven su carga en naracuraqui! Orden de una persona a un grupo para que lleven la carga del lugar en naracuraqui.
Akojmoru	<font color=ForestGreen><b>vtr.imper.pl.:</b></font> ¡Asen! Ordenar preparar un alimento mediante la acción directa del fuego o del calor. Asar: pescado, carne, pollo, etc.
Akojtoru	<font color=ForestGreen><b>coloq.imper.vtr.pl.:</b></font> ¡Chapapeen! Forma de asar diferentes variedades de carne en chapapa (Parrilla de madera rústica).
Akokrujo	<font color=ForestGreen><b>vtr.interrog.pl.:</b></font> ¿Tienen plato? Pregunta de una persona a un grupo si tienen el utensilio de cocina.
Akomeriko	<font color=ForestGreen><b>adv.imper.pl.:</b></font> ¡No roben! Advertencia de no quitar a una persona algo que le pertenece.
Akomeripo	<font color=ForestGreen><b>vtr.coloq.pl.:</b></font> Sorprender o pillar a alguien desprevenido haciendo una falta. ¡Ya son castellano hablante! Personas originarias que por el tiempo dejan de hablar su idioma y hablan el castellano.
Akomeririkporo	<font color=ForestGreen><b>n.f.pl.:</b></font> Aculturar. ¡Mucho hablan castellano! Grupo de personas originaria que tienen su propio idioma pero que utilizan Más el castellano adapatándose a ella para comunicarse en diferentes contextos y van perdiendo la propia.
Akowa	<font color=ForestGreen><b>vtr.pron.imper.pl.:</b></font> ¡Báñense! Ordenar de una persona a un grupo a bañarse.
Akowrosi	<font color=ForestGreen><b>n.m.deter.poses.:</b></font> ¿Es su recipiente? Objeto o utensilio cóncavo que se utiliza para bañarse.
Akoy'e – Akoy'eripo	<font color=ForestGreen><b>vtr.pres.indic.pl.:</b></font> ¿Ya tienen? Preguntan de una persona a un grupo si tienen o poseen algunas pertenencias
Akoyeno – Akoyenoripo	<font color=ForestGreen><b>n.f.pl.interrog.:</b></font> ¿Tuvieron relaciones sexuales? Preguntar si tuvieron trato amoroso o sexual a un grupo de personas.
Akoyenoji	<font color=ForestGreen><b>vtr.prep.interrog.pl.:</b></font> ¿Están con sus mujeres? Pregunta de una persona a otras si están acompañados de sus mujeres.
Akimaji	<font color=ForestGreen><b>vtr.prep.interrog.pl.:</b></font> ¿Están con sus esposos? Pregunta de una persona a otras mujeres si están con sus esposos.
Akoyenora'i	<font color=ForestGreen><b>adj.n.f.pl.:</b></font> Adictos al sexo. Necesidad incontrolable por sexo de todo tipo. Compulsión incontrolable.
Aksukrereko	<font color=ForestGreen><b>vtr.imper.pl.:</b></font> ¡Tienen que sembrar! Orden de una persona a un grupo esparcir semillas en un terreno preparado para que germinen.
Aksukre	3ª per.pres.imper.pl.: ¡Siembren! Orden de una persona a un grupo para que siembren.
Aktemo	<font color=ForestGreen><b>vintr.imper.pl.:</b></font> ¡Moléstenlo! Hacer que algunas personas hagan algo a otra y resulte incómodo.
Aktumraji	<font color=ForestGreen><b>vtr.imper.pl.:</b></font> ¡Lleven cuchillo! Orden a un grupo para que dispongan un cuchillo.
¿Akuchara?	<font color=ForestGreen><b>pron.poses.interrog.pl.:</b></font> 1.- ¿Ésta cuchara de ustedes? Pregunta de una persona a un grupo si ese objeto es propiedad de alguno.
Akuchara	<font color=ForestGreen><b>pron.poses.dem.pl.:</b></font> 1.- La cuchara es de ustedes. Afirmación de una persona de que la cuchara pertenece a alguien del grupo.
Akuchka	<font color=ForestGreen><b>vtr.imper.pl.:</b></font> ¡Sáquenlo! Orden de una persona a un grupo para que expulse a alguien o algo.
Akuchkoyre	<font color=ForestGreen><b>vtr.imper.cond.:</b></font> ¡Lo tienen que sacar! 1.- Orden de una persona a otras para desalojar a alguien de un lugar determinado. 2.- Orden de una persona a un grupo para que saquen a un animal u objeto del lugar.
¿Akuchkoyre?	<font color=ForestGreen><b>vtr.interrog.condic.pl.:</b></font> ¿Lo van sacar? Pregunta de una persona a un grupo si van a desalojar a alguien de un lugar.
Akukinajiru	<font color=ForestGreen><b>vtr.imper.pl.:</b></font> ¡Persistan! Ordenar a grupo mantenerse firme y constante en una manera de ser o de obrar.
Akusnayre	<font color=ForestGreen><b>pron.poses.sing.:</b></font> Será su cuarto de cocina. Indica que la sala de cocina será de alguien o algunos.
Akuujo	<font color=ForestGreen><b>pron.poses.sing.:</b></font> Es su plato. Afirmación de una persona sobre el utensilio de otro.
¿Akuujo?	<font color=ForestGreen><b>pron.poses.sing.interrog.:</b></font> ¿Es su plato? Pregunta de una persona a un grupo si el plato les pertenece.
Akwonra	<font color=ForestGreen><b>mod.subj.imper.pl.:</b></font> ¡Dénle oficio! Que sean mandados a realizar una actividad productiva.
Akyeno	<font color=ForestGreen><b>vtr.imper.:</b></font> Declarar a una persona apta y madura para tener relaciones sexuales.
Akyine	<font color=ForestGreen><b>vtr.imper.pl.:</b></font> ¡Hagan quisa! Orden de una persona a un grupo para que pongan a secar el plátano maduro al sol y éste dure más tiempo.
Akyupuiigi	<font color=ForestGreen><b>vtr.imper.pl.:</b></font> ¡Lleven singa! 1.- Orden de una persona para que lleven singa. 2.- Lo usamos para referirnos al bastón de apoyo.
Amaane	<font color=ForestGreen><b>adj.poses.sing.:</b></font> ¡Su piedra! Señala una relación de posesión entre el objeto poseído. Su piedra de afilar cuchillos.
¿Amaane?	<font color=ForestGreen><b>Adj.poses.interrog.:</b></font> ¿Es su piedra? Pregunta una relación de posesión entre el objeto poseído.
Amanteresi	<font color=ForestGreen><b>adj.afirm.poses.:</b></font> Es su mantel. Afirma posesión de objeto.
¿Amanteresi?	<font color=ForestGreen><b>Adj.poses.interrog.:</b></font> ¿Es su mantel? Pregunta una relación de posesión entre el objeto poseído.
Amasrucha	<font color=ForestGreen><b>vtr.imper.pl.:</b></font> ¡Pónganle enema! Aplicar un tratamiento para hacer desaparecer un malestar intestinal con fines laxantes.
Amatnare	<font color=ForestGreen><b>v.cop.pres.ind.:</b></font> Son consuegros. Atribuir al sujeto de la oración una cualidad o condición intrínseca familiar.
Amatnare	<font color=ForestGreen><b>v.cop.interrog.:</b></font> ¿Son sus consuegros? Pregunta al sujeto condición familiar.
Amétaka	<font color=ForestGreen><b>vtr.imper.pl.:</b></font> ¡Avísenle! Manera de informar un recado, Mensaje o aviso para actuar con precaución.
Ametokoripo	<font color=ForestGreen><b>vtr.interrog.afirm.:</b></font> ¿Ya le avisaron?
Amet-si	<font color=ForestGreen><b>pron.poses.pl.afirm.:</b></font> La olla de ustedes. Afirmación de posesión grupal de un objeto.
¿Amet-si?	<font color=ForestGreen><b>pron.poses.interrog.pl.:</b></font> ¿Es la olla de ustedes? Pregunta una relación de posesión grupal con el objeto.
Ametuchapo	<font color=ForestGreen><b>v.prnl.imper.pl.:</b></font> ¡Discúlpense! Pedir perdón en grupo o justificarse por haber cometido una falta.
Ametura'i	<font color=ForestGreen><b>adj.nf.nm.sing.:</b></font> Cuentero, chismoso. Que es aficionado a contar chismes.
Amikucha	<font color=ForestGreen><b>vtr.imper.pl.:</b></font> ¡Alúmbrenle! Ayudar a una persona iluminando el lugar.
Amimro	<font color=ForestGreen><b>adj.poses.pl.afirm.:</b></font> Sus máscaras. Afirma que las máscaras les son pertenecientes.
¿Amimro?	<font color=ForestGreen><b>adj.poses.pl.interrog.:</b></font> ¿Son sus mascaras? Pregunta de posesión una persona a un grupo de las máscaras.
Amiro	<font color=ForestGreen><b>adj.dem.pl.:</b></font> Sus rostros. Indicar, mostrar dirigiendo el dedo, hacia los rostros.
Amiro'u	<font color=ForestGreen><b>adj.afirm.poses.pl.:</b></font> Sus patios. Afirmación de una persona que el patio delantero de una casa les pertenece.
Amirogisi	<font color=ForestGreen><b>zool.n.f.:</b></font> Polilla. Mariposa nocturna y destruye la materia donde anida: maderas, telas y papeles.
Ammam'i	<font color=ForestGreen><b>adj.colq.:</b></font> Día de los difuntos. Celebración de una fiesta religiosa dedicada a los fieles difuntos.
Amotsipa	<font color=ForestGreen><b>adj.dem.pl.:</b></font> Sus pestañas. Indicar, mostrar dirigiendo el dedo, las pestañas de los demás.
Amopruji	<font color=ForestGreen><b>v.prnl.pl.:</b></font> Se echaron a perder. Comienzo de realizar una actividad con resultados negativos.
Anáraka	<font color=ForestGreen><b>vintr.imper.pl.:</b></font> ¡Descansen! Ordenar a un grupo hacer una pausa en el trabajo para recuperar fuerzas.
Anariya	<font color=ForestGreen><b>bot.n.m.:</b></font> Pachío. Fruto comestible de la selva de color amarillo, y que también es cultivado.
Anekcha	<font color=ForestGreen><b>vtr.imper.pl.:</b></font> ¡Empiecen! Persona que ordena a un grupo para empezar una actividad.
Aneregie'a	<font color=ForestGreen><b>vtr.imper.pl.:</b></font> ¡Escojan! Orden de separar las semillas buenas de las defectuosas.
Anerejigia	<font color=ForestGreen><b>vtr.inf.:</b></font> Escoger. Elegir o tomar los primeros frutos que están maduros de los que no sirven.
Anéreku	<font color=ForestGreen><b>n.m.:</b></font> Cruce. Puerto donde se atraviesa un río, arroyo <font color=purple>/</font> Acto de cruzar animales.
Anereku'a	<font color=ForestGreen><b>vtr.imper.pl.:</b></font> ¡Saquen lo que estorba! Orden a un grupo de sacar lo que estorba en la sanja o rio para poder pasar.
Aneremegia	<font color=ForestGreen><b>vtr.imper.pl.:</b></font> ¡Escojan! Ordena seleccionar o preferir a una de las mejores telas, calaminas, plásticos, papel, cuero.
Anerepigia	<font color=ForestGreen><b>vtr.imper.sing.:</b></font> ¡Escójanlo! Ordena a grupo de seleccionar algo exclusivo soga, pita, alambre, bejuco, cable, de acuerdo al grosor.
Anerepókocha	<font color=ForestGreen><b>vtr.imper.pl.:</b></font> ¡Seleccionen! Ordena un grupo de personas para que seleccionen las mejores hojas de plantas.
Anerigia	<font color=ForestGreen><b>vtr.imper.pl.:</b></font> ¡Vayan a leñear! Orden de una persona a un grupo que vayan a traer leña.
¿Anerikripo?	<font color=ForestGreen><b>vtr.interrog.afirm.pl.:</b></font> ¿Ya leñearon? Pregunta que se hace a un grupo para saber si realizaron el trabajo recolectar leña.
Anerikyore	<font color=ForestGreen><b>vtr.imper.pl.:</b></font> ¡Tienen que leñear! Se utiliza para dar orden a un grupo de personas para que ejecuten la acción.
Anerioka	<font color=ForestGreen><b>vtr.imper.pl.:</b></font> ¡Escojan! Ordena seleccionar o preferir lo que mejor le parezca a un grupo.
Aneriokapgienenajicha	<font color=ForestGreen><b>vtr.imper.pl.:</b></font> ¡Escojan bien! Orden de una persona a un grupo para que se elijan bien a personas, alimentos, animales y cosas.
Aneriokwoka	<font color=ForestGreen><b>vtr.imper.sing.:</b></font> ¡Escójanlo! Orden de una persona a un grupo para que se escojan personas, animales, plantas, y cosas, muy exclusivamente.
Anigia	<font color=ForestGreen><b>vtr. imper.pl.:</b></font> ¡Coman! Invitación u orden de una persona a un grupo para comer.
Aniksare	<font color=ForestGreen><b>n.m.:</b></font> Es lo que le gusta. Forma propia que tiene cada persona de apreciar o valorar para que le sirvan su comida preferida.
Anikyore	<font color=ForestGreen><b>vtr.imper.interrog.pl.:</b></font> ¡Van a comer! <font color=purple>/</font> ¿Van a comer? Orden de una persona a un grupo que coman <font color=purple>/</font> También se utiliza para preguntar.
Anipachoka	<font color=ForestGreen><b>vtr.imper.pl.:</b></font> ¡Muérdalo! Ordena para que le saquen una tajada con una mordida (queso, pan de arroz, empanizado, etc)
Avesyayajigia	<font color=ForestGreen><b>vtr.imper.pl.:</b></font> ¡Desmenucen! Trocear algo en partes muy pequeñas carne, pollo, charque.
Aniparegia	<font color=ForestGreen><b>vtr.imper.pl.:</b></font> ¡Coman! Orden de una persona a un grupo para que coman chivé o harina de Pescado.
Anistuka	<font color=ForestGreen><b>vtr.imper.pl.:</b></font> ¡Muerdan el piojo! Ordena clavar los dientes al insecto parásito, causando su eliminación del cabello.
Anitapoka	<font color=ForestGreen><b>vtr.imper.pl.:</b></font> ¡Muérdanlo! Orden de una persona a otras para que muerdan la parte.de un objeto queso, empanizado, pan, frutas.
Anipchachajigia / aniwawa'igia	<font color=ForestGreen><b>vtr.imper.pl.:</b></font> ¡Mastiquen! Ordena plastar o triturar algo en la boca con los dientes (chicle, carne).
Ano'o	<font color=ForestGreen><b>n.m.adj.:</b></font> De color verde. Alimento o fruta no madura.
Ano'ogi	<font color=ForestGreen><b>n.m.adj.:</b></font> Lápiz o marcador de color verde. Tronco de árbol cortado que está verde.
Ano'opi	<font color=ForestGreen><b>n.m.adj.:</b></font> Forma alagarda exclusiva de alimentos y cosas color verde: Fruta de Pacay, vaina del fréjol, liñada de color verde, gusano, víbora, cable, soga, trenza, cinta, hilo.
Ano'o'i	<font color=ForestGreen><b>n.m.adj.:</b></font> Exclusivo para frutas de color verde o que no están maduras. También para referirse a cosas: cisterna, balón, galón, turril, casa que son de color verde.
Ano'o'ugi	<font color=ForestGreen><b>n.m.adj.:</b></font> Exclusivo para ojos de color verde. Personas, animales que tienen el ojo de color verde.
Anogji	<font color=ForestGreen><b>n.m.adj.:</b></font> No está maduro. Que todavía no ha alcanzado su desarrollo completo y no está en la Sazón debida para ser recolectado o consumido Semillas de arroz, maíz.
Ano'ogiope	<font color=ForestGreen><b>n.f.adj.:</b></font> Patas de color verde. Exclusivo para muebles: silla, mesa, cama, banco, taburete.
Ano'ojipño	<font color=ForestGreen><b>n.f.adj.pl.:</b></font> Exclusivo para personas con uñas pintadas de color verde.
Ano'okapo	<font color=ForestGreen><b>vtr.imper.pl.:</b></font> ¡Empiecen! Ordena a un grupo para que empiecen una actividad o trabajo.
Ano'omo	<font color=ForestGreen><b>n.m.adj.:</b></font> Exclusivo para objetos de color verde: Tela, papel, hule, polera, camisa, agua, calamina pintado de color verde.
Ano'opa'i	<font color=ForestGreen><b>n.m.adj.:</b></font> Exclusivo para espacios de color verde: Terrenos, pastizales, potreros, bajios, canchas, de color verde.
Ano'opore	<font color=ForestGreen><b>n.f.adj.:</b></font> Exclusivo para la raíz verde: Raíz del árbol que no está seco o marchito.
Ano'otawo	<font color=ForestGreen><b>n.f.adj.:</b></font> Exclusivo para rama o gajo del árbol que no está seco y presenta color verde.
Ano'osi	<font color=ForestGreen><b>adj.:</b></font> Exclusivo para forma geométrica redonda pintada de color verde.
Anocheyoroku	<font color=ForestGreen><b>n.f.adj.:</b></font> Exclusivo para orilleras de color verde como ser: lagunas, pozos.
Anocheyoropi	<font color=ForestGreen><b>n.f.adj.:</b></font> Exclusivo para objetos con bordes de color verde.
Anocho	<font color=ForestGreen><b>n.f.adj.:</b></font> Tabla o madera pintada de color verde.
Ano'ocho	<font color=ForestGreen><b>n.f.adj.:</b></font> Madera o tabla que no esta seca.
Anochpe	<font color=ForestGreen><b>n.f.adj.pl.:</b></font> Espigas de arroz con el tronco aún verde.
Anokigia	<font color=ForestGreen><b>vtr.imper.sing.:</b></font> ¡Pónganlo! <font color=purple>/</font> ¡Déjenlo! Ordena hacer que una persona poner una cosa en un lugar determinado.
Anokapopo	<font color=ForestGreen><b>vtr.imper.sing.:</b></font> ¡Pónganse en acción! Ordena a una persona ponerse en acción en el lugar de trabajo.
Anokrogi / ¿Anokrogi?	<font color=ForestGreen><b>adj.poses.pl.:</b></font> Sus telares <font color=purple>/</font> ¿Son sus telares?
Anoksa / ¿Anoksa?	<font color=ForestGreen><b>adj. poses. afirm. interrog.pl.:</b></font> Sus tejidos <font color=purple>/</font> ¿Son sus tejidos? Afirmación de una persona que los tejidos son de ellos <font color=purple>/</font> También se lo utiliza como pregunta.
Anomro	<font color=ForestGreen><b>n.m.adj.:</b></font> Cara pintada de color verde, o una máscara de color verde.
Anoope / ¿Anoope?	<font color=ForestGreen><b>n.m.pron. poses.afirm.interrog.:</b></font> ¿El remo de ustedes? <font color=purple>/</font> ¿Es su remo? Afirmación de una persona de que el remo es de ellos <font color=purple>/</font> También se lo utiliza como pregunta.
Anorojiiku	<font color=ForestGreen><b>n.f.:</b></font> Su cutibi. Línea en la superficie del cuero cabelludo que divide un peinado.
Anospo	<font color=ForestGreen><b>vtr.interrog.pl.:</b></font> ¿Se quedaron? Pregunta a un grupo de personas que por cierta circunstancia se quedaron en un lugar.
Anosra'i	<font color=ForestGreen><b>vtr.prnl.afirm.:</b></font> Siempre se quedan. Afirmación de una persona a otras que se siempre quedan en un lugar.
Anosyore / ¿Anosyore?	<font color=ForestGreen><b>vtr.afirm. interrog.pl.:</b></font> Se tienen que quedar. <font color=purple>/</font> ¿Se van a quedar? Orden de una persona a un grupo de que tienen que quedarse en un lugar <font color=purple>/</font> También se utiliza como pregunta.
Anu'sare	<font color=ForestGreen><b>vtr.pl.:</b></font> Siempre patacan. Acción de masticar el maíz, yuca, arroz, para la mezcla de la elaboración de chicha.
Anu'yo / ¿Anu'yo?	<font color=ForestGreen><b>vtr.imper. interrog.pl.:</b></font> Tienen que patacar <font color=purple>/</font> ¿Lo van a patacar? Orden de una persona a un grupo para que pataquen <font color=purple>/</font> también se utiliza para preguntar.
Anumo	<font color=ForestGreen><b>n.m.:</b></font> Cielo. Firmamento infinito. <font color=purple>/</font> Parte de la atmósfera y del espacio exterior vistos desde la tierra, en la que están las nubes y en donde se ve el sol, la luna, y las estrellas.
Anúmoku	<font color=ForestGreen><b>adv.l.:</b></font> Bajo el firmamento del cielo.
Anumokurunano	<font color=ForestGreen><b>n.m.:</b></font> Fieles arcángeles divinos del cielo. Ser celestial encargado de anunciar los misterios de Dios con categoría superior a la de los ángeles.
Anuneji	<font color=ForestGreen><b>adj.poses.pl.:</b></font> Su patacado de ustedes.
Anunejiyre	<font color=ForestGreen><b>v.cop.pl.:</b></font> Va ser su patacado de ustedes. Persona que afirma que el patacado será de ellos.
Añiri	<font color=ForestGreen><b>n.m. adj.bot.:</b></font> De color lila. Árbol cuya hoja tiñe color lila.
Año'e	<font color=ForestGreen><b>mod.ind.:</b></font> Su cintura. Persona que indica parte de la cintura de otra.
Añu	<font color=ForestGreen><b>n.m.:</b></font> Año. Periodo de 365 días, dividido en doce meses; que empieza el 1 de enero y termina el 31 de diciembre.
Apa'eji	<font color=ForestGreen><b>mod.ind.:</b></font> Sus muslos. Persona que indica parte del muslo de otro.
Apajmiro	<font color=ForestGreen><b>n.f.mod.ind.:</b></font> La cara limpia de ustedes.
Apajrogi	<font color=ForestGreen><b>n.m.adj.poses.ind.:</b></font> El marco de su puerta.
Apajromo	<font color=ForestGreen><b>n.m.adj.poses.ind.pl.:</b></font> La puerta de ustedes.
Apatsacha	<font color=ForestGreen><b>vtr.imper.pl.:</b></font> ¡Píntenlo! Orden de una persona a otras para darle color a un dibujo, pared y otros objetos.
Apatsaregia	<font color=ForestGreen><b>vtr.imper.pl.:</b></font> ¡Pinten! Ordenar cubrir con pintura una superficie.
Apeereku	<font color=ForestGreen><b>n.m.:</b></font> Apere. Nombre de un río del Beni.
Apékusi	<font color=ForestGreen><b>n.f.:</b></font> Calva oscura. Tipo de calva en la corona de un grupo de personas.
Apeveji	<font color=ForestGreen><b>adj.:</b></font> Están livianos. Grupo de personas que están de poco peso.
Apichpu	<font color=ForestGreen><b>n.f.:</b></font> Dos plantas de sembradíos o de arboledas.
Apigi	<font color=ForestGreen><b>n.:</b></font> Dos árboles maderables. <font color=purple>/</font> También se utiliza para referirse a un par de lápiz, bolígrafo, pescado.
Apigiatsero	<font color=ForestGreen><b>n.m.:</b></font> Pero téngan miedo. Acción de advertir un susto.
Apigienu	<font color=ForestGreen><b>mod.ind.:</b></font> Sus cuellos. Indica parte del cuerpo que une a la cabeza con el cuerpo.
Api'a	<font color=ForestGreen><b>n.f.:</b></font> Dos huevos. Forma de contar por la figura: su forma exterior.
Api'agi	<font color=ForestGreen><b>n.m.:</b></font> Dos testículos. Glándula sexual masculina de forma redondeada que produce los espermatozoides en hombres y animales.
Api'e	<font color=ForestGreen><b>adv.num.:</b></font> Dos veces. Actué dos veces en la danza del gracioso.
Api'i	<font color=ForestGreen><b>adj.num.:</b></font> Forma de contar por la figura: Dos naranjas, balones de forma redonda.
Api'ikwo	<font color=ForestGreen><b>vtr.interrog.pl.:</b></font> ¿Están barriendo?
¿Api'ikwoyre?	<font color=ForestGreen><b>vtr.interrog.pl.:</b></font> ¿Van a barrer? Pregunta a un grupo en tiempo futuro.
Api'o	<font color=ForestGreen><b>n.m.:</b></font> Dos cosas pegadas. También sirve para referirse en el conteo de par en par (tamal, jase de jatata, jase de leña).
Apiko	<font color=ForestGreen><b>n.f.pl.interrog.:</b></font> ¿Tienen miedo? Pregunta a un grupo que si tienen miedo de lo que puede ocurrir.
Apikucha	<font color=ForestGreen><b>vtr.imper.pl.:</b></font> ¡Respétenlo! Ordena de tener respeto hacia alguna persona.
Apinararaji	<font color=ForestGreen><b>adv.num.:</b></font> De par en par. Se refiere a personas, animales o aves que caminan de a dos.
Apípeku	<font color=ForestGreen><b>adv.num.:</b></font> Dos espacios. Medio físico fragmentado en dos.
Apipewo	<font color=ForestGreen><b>adv.num.:</b></font> Bípedos: De dos patas. Aves que se sostienen sobre dos pies o patas para caminar.
Apisri'e	<font color=ForestGreen><b>adv.num.:</b></font> Dos tizones. Dos partes de una leña quemadas por el fuego.
Apisrune	<font color=ForestGreen><b>vtr.adv.num.:</b></font> Freír dos veces algún alimento.
Apona	<font color=ForestGreen><b>vintr.imper.pl.:</b></font> ¡Vayan con él! Persona que ordena ir con alguien de viaje, caminata, cacería, trabajo, pesca.
Apo'cha	<font color=ForestGreen><b>v.imper.pl.:</b></font> ¡Guíense! Dejarse llevar por un sonido hasta llegar al lugar.
Apowgi	<font color=ForestGreen><b>adj.dem.:</b></font> Sus brazos. Demostrar la extremidad superior del cuerpo humano de otro.
Apu	<font color=ForestGreen><b>bot.n.m.:</b></font> Guineo. Fruto del platanero, comestible, de forma alargada.
Apucha	<font color=ForestGreen><b>vtr.pron.imper.pl.:</b></font> ¡Acérquense! Orden de una persona a otras para reunirse y escuchar a alguien dar un discurso.
¿Apuchripo?	<font color=ForestGreen><b>vtr.prnl.interrog.pl.:</b></font> ¿Ya se acercaron?
Apuege	<font color=ForestGreen><b>adj.dem.:</b></font> Sus piernas. Señala las piernas de otra persona. 
Apuegene'a	<font color=ForestGreen><b>adj.dem.:</b></font> Sus riñones. Señala los riñones de otra persona. 
Apuegne'a	<font color=ForestGreen><b>vtr.imper.pl.:</b></font> ¡Síganlo! Seguir a una persona, después o detrás de otra.
Apuegiecha	<font color=ForestGreen><b>vtr.imper.sing.:</b></font> ¡Pónganle pata! Aplicar a una cosa un objeto para que no se caiga mesa, silla, banco, taburete.
Ajúgie'a	<font color=ForestGreen><b>vtr.prnl.imper.pl.:</b></font> ¡Empápense! <font color=purple>/</font> ¡Huélanlo! Quedarse empapado de agua. Forma de ordenar ciertas semillas o granos: arroz, maíz, mediante el olfato.
Ajuka	<font color=ForestGreen><b>vtr.imper.pl.:</b></font> ¡Huelan! Ordena aspirar por la nariz para percibir un olor.
Apuigia	<font color=ForestGreen><b>vintr.imper.pl.:</b></font> ¡Caminen! Trasladarse o moverse [una persona o un animal] de un lugar a otro mediante su propio medio de locomoción.
Apuiirigia	<font color=ForestGreen><b>vtr.imper.pl.:</b></font> ¡Campeen! Ordena buscar o perseguir animales (en especial, los de tierra o aire) para atraparlos o matarlos.
Apumore	<font color=ForestGreen><b>vintr.afirm.:</b></font> Le gusta el guineo. Persona que siente agrado o afición por comer guineo.
Apunne	<font color=ForestGreen><b>adj.dem.pl.:</b></font> Sus instrumentos. Indica el objeto de alguien que se usa para producir música.
Apunnerecho	<font color=ForestGreen><b>adj.dem.pl.:</b></font> Sus platillos. Indica la pertenencia del objeto de alguien.
Apunóji	<font color=ForestGreen><b>adj.:</b></font> Guineal. Sembradío de guineo.
Apupóko	<font color=ForestGreen><b>bot.n.f.:</b></font> Hoja de guineo. Órgano de la planta de guineo que crece sobre el tallo, de color verde.
Apúyusi	<font color=ForestGreen><b>adj.dem.:</b></font> Sus rodillas. Indica las rodillas de otra persona.
Aramre	<font color=ForestGreen><b>n.m.:</b></font> Alambre. Hilo de metal que sirve para amarrar.
Arestáwocha	<font color=ForestGreen><b>vtr.afirm.:</b></font> Que sea para todos. Dar a muchas personas una cosa como muestra de afecto o consideración.
Arusji	<font color=ForestGreen><b>n.m.:</b></font> Arrozal. Terreno donde se realiza la ricicultura o cultivo de arroz.
Aruchu	<font color=ForestGreen><b>n.m.:</b></font> Personaje de una danza. Danza navideña donde participa dos personajes que entonan coros celestiales.
Aruchurupi	<font color=ForestGreen><b>n.f.:</b></font> Música. Música de la danza navideña donde bailan los aruchus sostenido por cuatro personas que alzan a los danzarines, haciéndole dar vueltas al son de la música.
Arusaa'o	<font color=ForestGreen><b>adj.dem.:</b></font> Sus rosarios. Afirmación de pertenencia de objeto religioso.
Arusjeku	<font color=ForestGreen><b>adv.l.:</b></font> Bajo el arrozal.
¿Arusrupayacho?	<font color=ForestGreen><b>vtr.interrog.pl.:</b></font> ¿Le agradecieron? Pregunta si se dieron las gracias por un beneficio recibido.
Arusrupayacha	<font color=ForestGreen><b>vtr.imper.pl.:</b></font> ¡Agradézcanle! Ordena dar las gracias por un beneficio recibido.
Asachera	<font color=ForestGreen><b>vtr.afirm.interrog.dem.:</b></font> Su cumpleaños <font color=purple>/</font> ¿Es su cumpleaños? 
Asachokapo	<font color=ForestGreen><b>vtr.imper.pl.:</b></font> Tienen que hacerlo de día. Orden de una persona a otras para que realicen una actividad diurna.
Asama	<font color=ForestGreen><b>vtr.imper.pl.:</b></font> ¡Escuchen! Ordena percibir una cosa por medio del sentido del oído.
¿Asamripo?	<font color=ForestGreen><b>vtr.interrog.pl.:</b></font> ¿Ya lo escucharon? Pregunta a un grupo si escucharon el sonido, bulla, etc.
¿Asamripo?	<font color=ForestGreen><b>vtr.interrog.pl.:</b></font> ¿Ya lo probaron? Persona que ordena tomar una pequeña cantidad de comida o bebida para conocer su sabor, su calidad u otra característica.
Asamuekripo	<font color=ForestGreen><b>vtr.interrog.pl.:</b></font> ¿Ya lo probaron? Pregunta de una persona a otras que si ya probó el dulce o salado (refresco, sopa, chicha).
Asamo'cha	<font color=ForestGreen><b>vtr.imper.pl.:</b></font> ¡Escúchenlo! Exclusivo para que escuchen el sonido o melodía que produce una persona.
Asammorigia	<font color=ForestGreen><b>vtr.pl.:</b></font> Escuchen consejo <font color=purple>/</font> Vayan a misa. Aconseja una persona a un grupo escuchar la opinión positiva y espiritual que alguien da.
Asammuerigia	<font color=ForestGreen><b>vintr.imper.pl.:</b></font> ¡Participen! Orden de una persona a otras participar en una reunión o asamblea.
Asamnako 	<font color=ForestGreen><b>vintr.pl.imper.:</b></font> ¡Negocien! Tratar un asunto para llegar a un acuerdo o solución.
¿Asamnareko?	<font color=ForestGreen><b>vintr.interrog.pl.:</b></font> ¿Están negociando? Pregunta de una persona a otras, si están negociando.
Asamuchapo	<font color=ForestGreen><b>n.f.imper.pl.:</b></font> ¡Tengan precaución! persona que alerta a otros(as) de algún peligro.
Asamuiigia	<font color=ForestGreen><b>vtr.pron.imper.pl.:</b></font> ¡Entérense! Orden de una persona para que se informen de algún mensaje, aviso, chisme.
¿Asamuiiko?	<font color=ForestGreen><b>vtr.prnl.interrog.pl.:</b></font> ¿Ya lo supieron? Pregunta de una persona si ya enteraron de la noticia.
Asawo	<font color=ForestGreen><b>n.m.:</b></font> Asado. Carne bovina y de pescado cocinada sobre brasas.
Asawomore	<font color=ForestGreen><b>adj.:</b></font> Persona que le gusta comer asado.
Asegia	<font color=ForestGreen><b>vtr.imper.pl.:</b></font> ¡Cávenlo! Hacer un hoyo, galería o zanja en la tierra.
Ásera	<font color=ForestGreen><b>n.m.:</b></font> Azuela. Herramienta que sirve para la elaboración de canoa, rueda de carretón, gaveta, cazuela, tací, yugo.
Asete	<font color=ForestGreen><b>n.m.:</b></font> Aceite. Sustancia grasa de origen mineral, vegetal o animal, líquida, insoluble en agua: de motacú, majo, coco, cusi, almendra, tembe, pata. <font color=purple>/</font> Aceite de motor, aceite para cocinar.
Asiivi	<font color=ForestGreen><b>adj.dem.pl.:</b></font> Sus flautas. 
Asiri	<font color=ForestGreen><b>adj.dem.:</b></font> La nariz de ustedes. 
Asoka	<font color=ForestGreen><b>vintr.imper.pl.:</b></font> ¡Defequen! Evacuar.
¿Asokponripo?	<font color=ForestGreen><b>vintr.interrog.pl.:</b></font> ¿Ya defecaron?
Asokra'i	<font color=ForestGreen><b>n.f.afirm.pl.:</b></font> Están con disentería. Alteración intestinal que se caracteriza por la mayor frecuencia, fluidez y, a menudo, volumen de las deposiciones.
Asópe'i	<font color=ForestGreen><b>adj.n.f.m.:</b></font> Son suertudos. Personas que tienen fortuna o buena suerte.
Aspe'i	<font color=ForestGreen><b>vtr.prnl.pl.:</b></font> Por ahí se aprovechan. Aprovecharse del momento o situación de algo que no le corresponde como ser: alimentos, objeto, personas, animales, dinero, moto, auto, etc.
Aspeegi	<font color=ForestGreen><b>adj.n.f.:</b></font> Música introductoria, que se utiliza ante de una celebración religiosa.
¿Asu'o?	<font color=ForestGreen><b>vtr.pron.interrog.pl.:</b></font> ¿Se atoraron? Preguntar a un grupo si. Se atragantaron con alguna espina de pescado.
Asuka	<font color=ForestGreen><b>n.:</b></font> Azúcar. Sustancia orgánica sólida, blanca y soluble en agua proveniente de la caña.
Asukapa	<font color=ForestGreen><b>n.:</b></font> Azúcar granulada, elaborado y procesado de la caña de azúcar.
¿Asukcho?	<font color=ForestGreen><b>vtr.interrog.pl.:</b></font> ¿Lo sembraron? Pregunta si sembraron plantas con raíz.
Asukre	<font color=ForestGreen><b>adj.dem.:</b></font> Su sembradío.
Asumracha	<font color=ForestGreen><b>n.m.:</b></font> Estaca. Palo que se usa en un espacio determinado para marcar un limite de un territorio.
Asuru	<font color=ForestGreen><b>adj.n.m.:</b></font> Color azul.
Asuru'a	<font color=ForestGreen><b>adj. n.m.:</b></font> Huevo de color azul. Huevos de perdiz, y otras aves.
Asusu	<font color=ForestGreen><b>n.m.adj.dem.:</b></font> Su espinilla. Grano que aparece en la piel por obstrucción de los folículos pilosos debida a la acumulación de grasa.
Atsujkacha	<font color=ForestGreen><b>vtr.imper.:</b></font> ¡Bésenlo en la boca! Orden de una persona de besar a otra.
Asuu'a	<font color=ForestGreen><b>vtr.imper.:</b></font> ¡Frítenlo! Freir algún alimento.
Asuuneresi	<font color=ForestGreen><b>adj.dem.:</b></font> Su sartén.
Ata	<font color=ForestGreen><b>adj.:</b></font> Sucio. Lugar que tiene polvo, basura, manchas o impurezas.
Atanka	<font color=ForestGreen><b>vtr.imper.pl.:</b></font> ¡Búsquenlo! Hacer lo necesario para encontrar o hallar a una persona.
Atete	<font color=ForestGreen><b>n.anat.pron.dem.:</b></font> Sus glúteos. Señala parte carnosa y redondeada del cuerpo humano que forman esos músculos.
Ati	<font color=ForestGreen><b>n.m.f.:</b></font> Hermano(a) menor. Consanguíneo que es el último de los hermanos.
Atpemo	<font color=ForestGreen><b>vintr.imper.pl.:</b></font> ¡Hablen sin rodeo! Mantener una conversación con otra u otras personas acerca de un asunto sin divagación.
Atsánogi	<font color=ForestGreen><b>adj.dem.:</b></font> Sus canillas. 
Átsaru	<font color=ForestGreen><b>vintr.imper.pl.:</b></font> ¡Jueguen! Realizar una actividad ejercitando alguna capacidad o destreza, con el fin de divertirse o entretenerse.
Atsarugnenajicha	<font color=ForestGreen><b>v.imper.:</b></font> ¡Jueguen bien!
Atsarupo	<font color=ForestGreen><b>vtr.imper.pl.:</b></font> ¡Jueguen de una vez!
Atsarusi	<font color=ForestGreen><b>adj.pl.imper.:</b></font> ¡Sean juguetones! Que juguetean.
Atsaruwre	<font color=ForestGreen><b>v.imper.pl.:</b></font> ¡Jueguen de nuevo!
Atsuka	<font color=ForestGreen><b>vtr.imper.:</b></font> ¡Dénle beso! Orden de besar a otra persona.
Atsukka	<font color=ForestGreen><b>vtr.imper.:</b></font> ¡Bésense!
Attaji	<font color=ForestGreen><b>n.f.:</b></font> Tela. Tejido hecho con fibras textiles, fabricado en un telar o a máquina, que se utiliza para confeccionar ropa, hacer labores, forrar diversos objetos, etc.
¿Atuk'o?	<font color=ForestGreen><b>n.m.interrog.pl.:</b></font> ¿Están con hipo? Preguntar si están afectados ante el movimiento convulsivo e involuntario del diafragma que se va repitiendo a intérvalos.
Atukroo'o	<font color=ForestGreen><b>adj.n.f.m.:</b></font> Forzudo/a. Persona que tiene gran fuerza física.
Atúmewo	<font color=ForestGreen><b>n.f.:</b></font> Fuerza. Capacidad física para realizar un trabajo o un movimiento.
Atúmewina	<font color=ForestGreen><b>vtr.:</b></font> Reforzarse. Añadir nuevas fuerzas físicas mediante el alimento o bebida.
¿Atumra? / atumra	<font color=ForestGreen><b>adj.dem.:</b></font> Sus cuchillos.
Atup'egia	<font color=ForestGreen><b>vtr.imper.pl.:</b></font> ¡Pónganse de pie!
Atup'o	<font color=ForestGreen><b>adj.:</b></font> Sus dones. Cualidad o habilidad que alguien posee.
Atúpacha	<font color=ForestGreen><b>vtr.imper.pl.:</b></font> ¡Cuenten! Numerar uno por uno los objetos o los grupos de objetos de un conjunto para determinar su cantidad.
¿Atupachopka?	<font color=ForestGreen><b>vtr.interrog.pl.:</b></font> ¿Ya contaron?
Atupara'o	<font color=ForestGreen><b>n.m.adj.dem.:</b></font> Su cargo. Función de la cual una persona(s) tiene la responsabilidad en una organización, un organismo o una empresa.
Atupchegia	<font color=ForestGreen><b>vintr.imper.:</b></font> ¡Chóquenlo!
Atupo	<font color=ForestGreen><b>adj.dem.n.f.:</b></font> Sus pechos. Zona externa y delantera correspondiente a una parte del cuerpo.
Atuppuegia	<font color=ForestGreen><b>vtr.:</b></font> Ir al rumbo. Ir por un camino o dirección.
Atupsigia	<font color=ForestGreen><b>vtr.pl.imper.:</b></font> ¡Arrojen! Lanzar con fuerza una cosa con la mano hacia una determinada dirección.
Ave'a	<font color=ForestGreen><b>vtr.imper.:</b></font> ¡Sáquenlo! Persona que da orden de sacar un objeto o cosas.
Ave'ajno	<font color=ForestGreen><b>vtr.imper.pl.:</b></font> ¡Tienen que sacarlo! Orden a un grupo sacar animales u objetos
Ave'po	<font color=ForestGreen><b>vtr.interrog.:</b></font> ¿Lo sacaron?
Avechjusgia	<font color=ForestGreen><b>vtr.:</b></font> Zafar la soga de la cabeza de un animal.
Avejcho'igia	<font color=ForestGreen><b>vtr.imper.:</b></font> ¡Pelen la fruta! Quitar la piel, la cáscara, la corteza o la envoltura de una fruta.
Avejchogie'a	<font color=ForestGreen><b>vtr.imper.pl.:</b></font> ¡Descascaren el palo! Quitar la cáscara a una cosa, en especial la de un árbol.
Avejchu'a	<font color=ForestGreen><b>vintr.pron.imper.:</b></font> ¡Záfenlo! Ayudar a liberarse de algo desagradable o de alguien molesto.
Avejna	<font color=ForestGreen><b>vtr.imper.:</b></font> ¡Tráiganlo! Orden de una persona a otras de traer una cosa u objeto.
Avejnaa'ini	<font color=ForestGreen><b>vtr.imper.:</b></font> ¡Deberían traerlo! Suposición o posibilidad de que tienen que traer algún objeto.
¿Avejnoripo?	<font color=ForestGreen><b>vtr.interrog.:</b></font> ¿Ya lo trajeron?
Avejtaka	<font color=ForestGreen><b>vtr.imper.pl.:</b></font> ¡Cosechen! Orden de cosechar frutas de la planta.
Avechtawocha	<font color=ForestGreen><b>vtr.imper.pl.:</b></font> ¡Québrenlo el gajo! Desgajar una rama del árbol.
Avek'a	<font color=ForestGreen><b>vtr.imper.pl.:</b></font> ¡Vaciénlo! Ordenar sacar el contenido de un recipiente o lugar, o verterlo en otra parte.
Avekgiecha	<font color=ForestGreen><b>vtr.imper.:</b></font> ¡Desensíllenlo! Ordenar quitar la silla de montar a un caballo u otra caballería.
Avettaka	<font color=ForestGreen><b>vtr.imper.:</b></font> ¡Desháganlo! Orden de una persona a un grupo de deshacer, un lugar, como vivienda o pascana.
Awaresa	<font color=ForestGreen><b>n.f.:</b></font> Abadesa. Mujer adulta y viuda que se encarga de la limpieza de la iglesia.
Awonigia	<font color=ForestGreen><b>vtr.imper.sing.:</b></font> ¡Mandenlo! Persona que ordena a otra persona para un mandado.
Awosto	<font color=ForestGreen><b>n.m.:</b></font> Agosto. Octavo mes del año.
Awoyora'i	<font color=ForestGreen><b>adj.n.f.m.pl.:</b></font> Son conversadores. Personas que tienen la facultad de hablar bien con fluidez.
Awoyuchpo	<font color=ForestGreen><b>v.prnl.pl.imper.:</b></font> ¡Se pasaron! Excederse al hacer algo.
Ayana	<font color=ForestGreen><b>vtr.imper.pl.:</b></font> ¡Vayan! Orden a un grupo de que tienen que ir a algún lugar.
Ayópapo	<font color=ForestGreen><b>vintr.imper.pl.:</b></font> ¡Descansen! Orden de hacer una pausa en el trabajo o en otra actividad para recuperar fuerzas.
Ayoyuchapo	<font color=ForestGreen><b>vtr.imper.pl.:</b></font> ¡Apúrense! Meter prisa a un grupo de personas en ejecutar algo con urgencia.
Ayuchchegia	<font color=ForestGreen><b>vtr.imper.:</b></font> ¡Súnchenlo! Ordenar clavar un objeto puntiagudo o punzante en una superficie o persona.
Ayuchmo	<font color=ForestGreen><b>pron.dem.:</b></font> Su cerco.
Ayúka	<font color=ForestGreen><b>vtr.imper.pl.:</b></font> ¡Dispárenle! Orden de una persona a un grupo disparar a un animal o persona.
Ayukjoka	<font color=ForestGreen><b>vtr.imper.pl.:</b></font> ¡Ensarten! Atravesar una cosa con un objeto acabado en punta: ensartar pescado, chaquira, semilla u otro objeto.
Ayumruka	<font color=ForestGreen><b>vtr.imper.sing.:</b></font> ¡Escóndanlo! Poner una cosa o a una persona en un lugar en el que no pueda ser vista.
Ayupcha	<font color=ForestGreen><b>vtr.imper.:</b></font> ¡Pónganle soporte! Orden de colocar soporte a un objeto, árbol, cerco que se está por caerse.
Ayupi	<font color=ForestGreen><b>adj.poses.:</b></font> Su cántaro. 
Ayuprora	<font color=ForestGreen><b>adj.poses.:</b></font> Su batidora.
Ayupuiigi	<font color=ForestGreen><b>adj.poses.:</b></font> Su singa.
Ayutawaka	<font color=ForestGreen><b>vtr.:</b></font> Clavar algo con punta en alguna cosa colgada.
Ayutspegia	<font color=ForestGreen><b>vtr.imper.:</b></font> ¡Zunchar!
Ayuutigia 	<font color=ForestGreen><b>vtr.imper.pl.:</b></font> ¡Complétenlo! Orden de completar el trabajo, medida, peso, o volcar una canoa.
Aatattaji	<font color=ForestGreen><b>adj.:</b></font> Que transmite una connotación negativa de desprecio o poco respeto.
Etaka	<font color=ForestGreen><b>vtr.imper.:</b></font> ¡Tóquenle! Orden de tocar una puerta o ventana.
Echa	<font color=ForestGreen><b>vtr.afirm.pl.:</b></font> Tienen que saberlo. Afirmación de saber sobre un determinado mensaje o acontecimiento y decir a otras.
Echaarijgia	<font color=ForestGreen><b>vtr.imper.pl.:</b></font> ¡Repitan! Orden a un grupo de repetir acciones como lectura y aprendizaje.
Écheji	<font color=ForestGreen><b>adj.poses.:</b></font> Sus carnes.
Echka	<font color=ForestGreen><b>vtr.imper.:</b></font> ¡Córtenlo! Orden a un grupo de cortar un árbol.
Echo	<font color=ForestGreen><b>vtr.afirm.:</b></font> Lo saben. Afirmación de saber un mensaje, comunicado <font color=purple>/</font> Puede funcionar como pregunta.
Échosi	<font color=ForestGreen><b>adj.:</b></font> Objeto especial preparado para personas en un acontecimiento especial.
Echpojrigia	<font color=ForestGreen><b>vtr.imper.:</b></font> ¡Cuídenlo! Orden un grupo para que cuiden una persona, objeto o animal.
Echpojrigiapo	<font color=ForestGreen><b>vtr.imper.pl.:</b></font> ¡Cuídense!
Echpuka	<font color=ForestGreen><b>vtr.imper.pl.:</b></font> ¡Levántense!
Eesaka	<font color=ForestGreen><b>vtr.imper.:</b></font> ¡Enlácenlo! Persona que ordena aprisionar a un animal con un lazo: vaca, buey, caballo.
Eetaka	<font color=ForestGreen><b>vtr.imper.pl.:</b></font> ¡Peguen la puerta! Accionar el cerrojo o seguro de una puerta.
Eeye	<font color=ForestGreen><b>n.f.:</b></font> Pesadilla. Sueño desagradable que produce angustia, ansiedad, miedo o terror.
Ejaka	<font color=ForestGreen><b>vtr.prnl.imper.:</b></font> ¡Sientense!
Ejakagnenajicha	<font color=ForestGreen><b>vtr.imper.adj.pl.:</b></font> ¡Siéntense bien! Orden de sentarse adecuadamente.
Ejamigiawne	<font color=ForestGreen><b>vtr.imper.pl.adv.:</b></font> ¡Despierten temprano! Orden de despertar a temprana hora.
Ejamikpo	<font color=ForestGreen><b>n.m.:</b></font> ¡Buenos días! Saludo por la mañana.
Ejasgia	<font color=ForestGreen><b>vtr.prnl.:</b></font> ¡Siéntense en la cabeza! Orden de una persona a otras de sentarse encima de la cabeza de un animal como toro, caballo. etc.
¿Ejepono?	<font color=ForestGreen><b>vtr.interrog.:</b></font> ¿Lo extrañan? Pregunta a un grupo de personas si extrañan a otras personas del lugar.
Ejiiwo	<font color=ForestGreen><b>adj.dem.n.:</b></font> Sus delitos. Acción contraria de una persona hacia la ley.
Ejkojwo	<font color=ForestGreen><b>adj.dem.n.:</b></font> Sus errores. Afirmación de una persona a otras que sus acciones, ideas, opiniones, expresiones no están correctas.
Ejteeyeregi	<font color=ForestGreen><b>bot.n.m.:</b></font> Ubillo. Árbol que nace en región montañosa y que sirve para correas de amarre.
Ejvemeko	<font color=ForestGreen><b>vtr.afirm.pl.:</b></font> Se huelen. Afirmación de percibir el olor que emana de una cosa o persona a través del olfato.
Ejwako	<font color=ForestGreen><b>n.m.:</b></font> Ventosidad.
Ema	<font color=ForestGreen><b>pron.pers.:</b></font> Él. Es la forma del pronombre personal en tercera persona, en género masculino.
Emoti	<font color=ForestGreen><b>vtr.imper.pl.:</b></font> ¡Conozcan!
Eno	<font color=ForestGreen><b>pron.pers.:</b></font> Ellos/ellas. Forma del pronombre personal en tercera persona del plural, en género masculino o femenino.
Epraka	<font color=ForestGreen><b>vtr.imper.:</b></font> ¡Échenlo! orden de derramar tierra en un lugar determinado.
Eprasgia	<font color=ForestGreen><b>vtr.imper.:</b></font> ¡Échenle confite, arroz, serpentina! Exclusivo de una boda.
Epre	<font color=ForestGreen><b>bot.n.m.:</b></font> Bejuco. Nombre genérico con que se designa a diversas especies de plantas tropicales de tallos largos, delgados y flexibles que se utilizan en la elaboración de tejidos de cestería y fabricación de muebles y cuerdas.
Epreji	<font color=ForestGreen><b>adj.n.:</b></font> Bejucal. Terreno lleno de bejucos.
Epremo	<font color=ForestGreen><b>bot.n.:</b></font> Bejucal que se cría por encima de una chapapa.
Epru	<font color=ForestGreen><b>n.m.pl.afirm.:</b></font> Tienen asco. Sensación de desagrado que produce alguien o algo y que impulsa a rechazarlo.
Era	<font color=ForestGreen><b>vintr.imper.pl.:</b></font> ¡Beban! Orden de una persona a otras beber agua, cerveza, chicha, refresco, etc.
Esamijrigia	<font color=ForestGreen><b>n.m.neg.:</b></font> No lo molesten.
Ésane	<font color=ForestGreen><b>adj.dem.:</b></font> Su chaco.
Eskaera	<font color=ForestGreen><b>n.f.:</b></font> Escuela/colegio. Institución destinada a la enseñanza, en especial la primaria, que proporciona conocimientos que se consideran básicos en la alfabetización.
Eskarera	<font color=ForestGreen><b>n.m.:</b></font> Escalera. Estructura constituida por una sucesión de escalones que sirve para subir y bajar o para poner en comunicación dos superficies a distinto nivel.
Esmuka	<font color=ForestGreen><b>vtr.prnl.pl.:</b></font> ¡Zambúllanse! Orden de una persona a otras de que se metan al agua.
Estaka	<font color=ForestGreen><b>vtr.imper.pl.:</b></font> ¡Guasquéenlo! Orden de dar uno o varios golpes a personas.
Estas'io	<font color=ForestGreen><b>n.f.:</b></font> Estancia. Establecimiento rural destinado a la producción agrícola o ganadera; suele componerse de una vivienda y una extensión de tierra.
Estasgia	<font color=ForestGreen><b>vtr.imper.pl.:</b></font> ¡Azoten! Orden de una persona a otras de ahuyentar a ciertos insectos como ser moscas, mosquitos, etc.
Estatéko	<font color=ForestGreen><b>vtr.:</b></font> Salpicar. Acción de lanzar la vara de pescar repetitivamente al agua para atraer a los peces.
Estera	<font color=ForestGreen><b>n.f.:</b></font> Estera. Tejido de cogollo de motacú, hoja de chuchío, junquillo, etc.
Estigia	<font color=ForestGreen><b>vtr.imper.:</b></font> ¡Corten! Orden de una persona a otras de talar árbol, cortar carne.
Estirigia	<font color=ForestGreen><b>vtr.imper.:</b></font> ¡Corten palo o trocen! Orden de una persona a otras de trozar un árbol, picar y hueso.
Esu	<font color=ForestGreen><b>pron.pers.f.:</b></font> Ella. Forma del pronombre personal en tercera persona del singular en género femenino.
Etamu'egia	<font color=ForestGreen><b>vtr.imper.pl.:</b></font> ¡Remojen! Orden de una persona a otras para que remojen cuero, bolsa o ropa.
Etasgia	<font color=ForestGreen><b>vtr.imper.:</b></font> ¡Dénle en la cabeza! Orden de una persona a otras golpear en la cabeza a un animal con el fin de matarlo.
Eteregia	<font color=ForestGreen><b>vintr.imper.pl.:</b></font> ¡Salten! orden de una persona a otras de saltar.
Eti	<font color=ForestGreen><b>pron.pers.pl.:</b></font> Ustedes. Pronombre personal en plural en segunda persona.
Etna	det.indef.m.f.: Un, una. Indica indeterminación al referirse a personas o cosas.
Eto	<font color=ForestGreen><b>pron.dem.:</b></font> Éso, Ésa. Indica una cosa no determinada que está cerca de la persona a la que se habla o en un lugar no muy alejado de la persona que habla o escribe.  <font color=purple>Ej1:</font> Dame eso que está sobre la mesa. <font color=purple>/</font> <font color=blue>Pyoma eto tyow'o te mesa.</font>  <font color=purple>Ej2:</font> Trae esa silla. <font color=purple>/</font> <font color=blue>Pyoma eto siya.</font>
Etochujcha	<font color=ForestGreen><b>interj.:</b></font> ¡Eso nomás! Equivalen a oraciones que expresan un sentimiento vivo.
Etona	<font color=ForestGreen><b>adv.num.:</b></font> Uno. Es el primer número natural y también es el número entero que sigue al cero y precede al 2.
Etonarichu	<font color=ForestGreen><b>interj.:</b></font> ¡Uno nomás! Frase exhortativa coloquial de dar mayor énfasis algo.
Etopa	<font color=ForestGreen><b>adv.cant.:</b></font> Enumerar: un, uno, una: un fierro, un clavo, una flecha, aguja, anzuelo.  <font color=purple>Ej1.</font> Una aguja <font color=purple>/</font> <font color=blue>etopa priipa.</font>  <font color=purple>Ej2.</font> Un clavo <font color=purple>/</font> <font color=blue>etopa krawo.</font>
Etori'ini	<font color=ForestGreen><b>vtr.cond.:</b></font> Debería ser eso/esa. Se utiliza cuando no esta satisfecho en alguna compra o negocio.  <font color=purple>Ej.</font> Debería ser esta vaca que hubieras comprado. <font color=purple>/</font> <font color=blue>Etori'ini pjoka waka jwachrigiari'ini.</font>
Etoyumja	<font color=ForestGreen><b>interj.:</b></font> ¡Eso nomás quiere! Se utiliza para referirse a un animal que solo quiere comer, estar en un solo lugar, ya sea por gusto o por dañino.  <font color=purple>Ej.</font> El caballo eso nomas quiere comer. <font color=purple>/</font> <font color=blue>Etoyumja tawoo'o tanigia to kwoyu.</font>
Etpuegia	<font color=ForestGreen><b>vtr.imper.pl.:</b></font> ¡Agáchense! Orden de una persona a otras de que se agachen.
Ewka	<font color=ForestGreen><b>vtr.imper.pl.:</b></font> ¡Siembren! Orden de una persona a otras de que siembren en su chaco.
Ewko	<font color=ForestGreen><b>vtr.imper.pl.:</b></font> ¡Mezan! Orden de una persona a otra de mecer la hamaca.
Krujo	<font color=ForestGreen><b>n.m.:</b></font> Plato. Utensilio para servir alimento comestible.
Mantéresi	<font color=ForestGreen><b>n.m.:</b></font> Mantel. Pieza de tela, papel o plástico con que se cubre la mesa para comer.
Muemmo	<font color=ForestGreen><b>adj.:</b></font> Sagrado. Que merece un respeto excepcional y no puede ser ofendido.
Myujto	<font color=ForestGreen><b>n.m.:</b></font> Monte virgen. Monte, bosque, laguna, pampa, que no ha sido alcanzado por el hombre.
Mjoore, myutta	<font color=ForestGreen><b>n.f.:</b></font> Virginidad. Estado de la persona que es virgen, que no ha tenido nunca relaciones sexuales.
Napikucha	<font color=ForestGreen><b>n.f.:</b></font> Violación. Delito que consiste en tener relaciones sexuales con una persona sin su consentimiento o con un consentimiento obtenido mediante la violencia o la amenaza.
Nápikucha	<font color=ForestGreen><b>n.f.imper.pl.:</b></font> ¡Alineen! Orden de sembrar, alambrar, postear en línea recta.
Taemnarapi	<font color=ForestGreen><b>n.m.:</b></font> Amor. Sentimiento de vivo afecto e inclinación hacia una persona o cosa a la que se le desea todo lo bueno.
Takomjírawo	<font color=ForestGreen><b>n.m.:</b></font> Asilo. Lugar de acogida de ancianos.
Tapikúra'i	<font color=ForestGreen><b>adj.m.:</b></font> Violador. Persona que comete una violación sexual, física y psicológica.
Tkiijaja'okre	<font color=ForestGreen><b>n.m.:</b></font> Apodo. Nombre que se da a una persona en vez del suyo propio y que, generalmente, hace referencia a algún defecto, cualidad o característica particular que lo distingue.
Une	<font color=ForestGreen><b>n.f.:</b></font> Agua. Elemento líquido que es indispensable para la vida.
Wkugi	<font color=ForestGreen><b>n.m.:</b></font> Árbol o Planta de tronco leñoso, grueso y elevado que se ramifica a cierta altura del suelo formando la copa.
Eywoti	<font color=ForestGreen><b>n.f.:</b></font> Hacha. Herramienta para cortar madera, en especial árboles y ramas, que consiste en una pieza de metal.
Im'a	<font color=ForestGreen><b>vtr.imper.pl.:</b></font> ¡Miren, observen! Mirar algo o alguien con atención y detenimiento para adquirir conocimiento.
Imojna	<font color=ForestGreen><b>vtr.imper.pl.:</b></font> ¡Vayan a verlo! Orden de una persona a otras que vayan a ver.  <font color=purple>Ej.</font> Vayan ver la canoa. 
Imerigia	<font color=ForestGreen><b>vtr.imper.:</b></font> ¡Muéstrenlo! Exponer una cosa de manera que pueda ser vista.
Imechanu	<font color=ForestGreen><b>vtr.imper.:</b></font> ¡Muéstrenme!
Imerígiapo	<font color=ForestGreen><b>vtr.imper.pl.:</b></font> ¡Muéstrense! Orden de una persona a otras para que se muestren en un lugar determinado.
Ich'anu	<font color=ForestGreen><b>vtr.imper.:</b></font> ¡Llámenme! Orden de una persona a otras de que tienen que comunicarse con él o ella.
Ich'a	<font color=ForestGreen><b>vtr.imper.:</b></font> ¡Llámalo! Persona que ordena a otra a que convoque a cierta persona.
Ichigia	<font color=ForestGreen><b>vtr.prnl.imper.:</b></font> ¡Deténganse! Orden de una persona a un grupo para que paren la actividad que están realizando.
Ichígiapo	<font color=ForestGreen><b>vtr.prnl.imper.:</b></font> ¡Deténganse inmediatamente! Persona que ordena a otras que se detengan de inmediato.
Itorigiapo	<font color=ForestGreen><b>vintr.imper.:</b></font> ¡Tienen que revivir!
Itekpa	<font color=ForestGreen><b>vintr.imper.pl.:</b></font> ¡Lleguen! Persona que sugiere a otras a que lleguen al lugar.  <font color=purple>Ej.</font> Lleguen a pescar a la laguna. <font color=purple>/</font> <font color=blue>Itekpa engia te kogiure.</font> 
Itekpajnotse	<font color=ForestGreen><b>cond.imper.pl.:</b></font> ¡Tienen que llegar! Orden de una persona a otras que tienen que llegar si o si al lugar.
¿Imoti?	<font color=ForestGreen><b>vtr.interrog.pl.:</b></font> ¿Conocen? Pregunta de la acción de conocer.  <font color=purple>Ej.</font> ¿Conocen el Instituto? <font color=purple>/</font> <font color=blue>¿Imoti to takarawo'irare?</font>
Ito'aka	<font color=ForestGreen><b>vtr.imper.pl.:</b></font> ¡Gánenlo! Ordenar ganar un concurso, juego, competencia, etc.
¿Íto'a?	<font color=ForestGreen><b>vtr.interrog.pl.:</b></font> ¿Perdieron? Dejar de poseer determinada cosa a causa de alguna circunstancia.
Iti	<font color=ForestGreen><b>n.f.:</b></font> Sangre. Líquido, de color rojo en los vertebrados, que, impulsado por el corazón.
Ítipa	<font color=ForestGreen><b>n.f.:</b></font> Comida exótica elaborada con sangre de la vaca.
Itipaka	<font color=ForestGreen><b>vtr.imper.:</b></font> ¡Amárrenlo! Atar o asegurar una cosa o persona por medio de cuerdas, cadenas, etc.
Ítisi	<font color=ForestGreen><b>adj.:</b></font> Cabeza ensangrentado. Persona, animal que tiene la cabeza con sangre ya sea por alguna herida.
Itiripo	<font color=ForestGreen><b>adj.:</b></font> Ensangrentado. Exclusivo para persona, animal manchado de sangre.
Ityomo	<font color=ForestGreen><b>adj.:</b></font> Exclusivo para agua ensangrentada.
Ichchoropa'i	<font color=ForestGreen><b>adj.:</b></font> Exclusivo para un espacio o piso manchado de sangre.
Ichi	<font color=ForestGreen><b>zool.n.m.:</b></font> Manechi. Nombre genérico con que se designa a cualquiera de los primates oriundos del Beni.
Ichijiyo'o	<font color=ForestGreen><b>zool.n.m.:</b></font> Gusano burro. Gusano venenoso que es peludo de diferentes colores.
Ita	<font color=ForestGreen><b>vtr.imper.pl.:</b></font> ¡Terminen! Orden de terminar un trabajo o actividad.
Itapo	<font color=ForestGreen><b>vtr.imper.pl.:</b></font> ¡Termínenlo ya! Orden de terminar de inmediato la actividad o trabajo.
Iyo	<font color=ForestGreen><b>zool.n.m.:</b></font> Mono Martín. Mamífero que habita en las selvas del oriente, Chaco y Amazonía.
Imorigia	<font color=ForestGreen><b>vtr.imper.pl.:</b></font> ¡Visiten! Persona que ordena a otras que vayan a visitar.
Imooroka	<font color=ForestGreen><b>adv.neg.imper.pl.:</b></font> ¡No dejen de mirar!
IImoti	<font color=ForestGreen><b>vtr.interrog.pl.:</b></font> ¿Conocen?
Im'o	<font color=ForestGreen><b>vtr.interrog.:</b></font> ¿Lo vieron? 
Im'oripo	<font color=ForestGreen><b>vtr.interrog.:</b></font> ¿Ya lo vieron?
Im'ajnotsero	<font color=ForestGreen><b>vtr.interrog.:</b></font> ¿Tienen que cuidarlo?
In'oka	<font color=ForestGreen><b>vtr.imper.:</b></font> ¡Envuélvanlo! Cubrir completamente una cosa o a una persona rodeándola o ciñéndola con algo.
Imnekpa	<font color=ForestGreen><b>vtr.imper.:</b></font> ¡Háganle entender!
In'origia	<font color=ForestGreen><b>vtr.imper.:</b></font> ¡Pónganse a envolver! Orden para que se pongan a envolver como ser: encomienda, alimento, etc.
In'okripo	<font color=ForestGreen><b>vtr.interrog.:</b></font> ¿Ya lo envolvieron?
In'okajnotsero	<font color=ForestGreen><b>vtr.cond.:</b></font> No se olviden de envolverlo. Encargo por otra persona de que tienen que envolver algo.
In'okpo	<font color=ForestGreen><b>vtr.interrog.:</b></font> ¿Lo enrollaron?
Ikchanu	<font color=ForestGreen><b>vtr.prnl.imper.:</b></font> ¡Báñenme! Persona que solicita que lo bañen.
Ikcha	<font color=ForestGreen><b>vtr.imper.:</b></font> ¡Báñenlo! Orden de una persona a otra para bañen a una persona o animal.
Ikcho'oka	<font color=ForestGreen><b>vtr.imper.:</b></font> ¡Échenle agua a su cuerpo!
Itempo	<font color=ForestGreen><b>vtr.interrog.pl.:</b></font> ¿Terminaron de hablar?
Itemripo	<font color=ForestGreen><b>vtr.interrog.pl.:</b></font> ¿Ya dejaron de hablar?
Itemchoripo	<font color=ForestGreen><b>vtr.interrog.pl.:</b></font> ¿Entendieron?
Iso'o	<font color=ForestGreen><b>vtr.interrog.pl.:</b></font> ¿Están carpiendo? Limpiar o sacar hierba inútil o perjudicial.
Iso'oripo	<font color=ForestGreen><b>vtr.interrog.pl.:</b></font> ¿Ya están carpiendo?
Ikchosi	<font color=ForestGreen><b>adj.:</b></font> Certificado de Bautismo. Documento o escrito en el que se certifica o da por verdadera una cosa. Bautizado en una religión.
Ikchoriko	<font color=ForestGreen><b>vtr.interrog.pl.:</b></font> ¿Están regando?
Iimuigia	<font color=ForestGreen><b>vtr.imper.pl.:</b></font> ¡Bailen! Orden de que tienen que bailar o danzar.
Iijajakwo	<font color=ForestGreen><b>vtr.afirm.:</b></font> Ponerse apodos. Poner un nombre o un apodo a una persona, animal o cosa.
Imitka	<font color=ForestGreen><b>vtr.imper.:</b></font> ¡Enseñenlo!
Imka	<font color=ForestGreen><b>vtr.imper.:</b></font> ¡Duerman! Orden para que reposar.
Imchuko	<font color=ForestGreen><b>adj.dem.pl.m.:</b></font> Sus suegros.
Imse	<font color=ForestGreen><b>adj.dem.pl.f.:</b></font> Sus suegras.
Itka	<font color=ForestGreen><b>vtr.imper.pl.:</b></font> ¡Aprendan! Orden de que tienen que aprender.
Itkoka	<font color=ForestGreen><b>vtr.imper.pl.:</b></font> ¡Entiéndase! Orden que tienen que llegar a un acuerdo o solución entre ellos.
Itsmeriko / ¿Itsmeriko?	<font color=ForestGreen><b>vtr.interrog.afirm.pl.:</b></font> ¿Están tejiendo? <font color=purple>/</font> Están tejiendo. Afirmación de que están tejiendo <font color=purple>/</font> Pregunta si están tejiendo.
Itswowojigia	<font color=ForestGreen><b>vtr.imper.:</b></font> Cambiar frecuentemente. Orden de cambiar algo, como ser música, vestimenta, objeto.
Itswowojiko	<font color=ForestGreen><b>vtr.adv.:</b></font> Cada rato cambian. Persona que afirma que cada vez o momento cambian como ser: vestimenta, comida, música.
Itinukcha / itnukcha	<font color=ForestGreen><b>vtr.imper.pl.:</b></font> ¡Amarren! Atar o asegurar una cosa por medio de cuerdas.
Ittoo'oyre	<font color=ForestGreen><b>vtr.interrog.pl.:</b></font> ¿Van a terminar? Interrogativo para saber si lo acabaran alguna actividad.
Itpapajgiapo	<font color=ForestGreen><b>vtr.imper.pl.:</b></font> ¡Consigan algo! Mandato de obtener algo que se pretende.
Itpapajkowyore	<font color=ForestGreen><b>vtr.cond.:</b></font> Tienen que conseguir algo.
Itrukyore	<font color=ForestGreen><b>vtr.cond.afirm.pl.:</b></font> Lo tienen que poder <font color=purple>/</font> ¿Lo van a poder?
Itswocha	<font color=ForestGreen><b>vtr.imper.pl.:</b></font> ¡Cambien! Entregar o cambiar algo al vendedor. 
Imecha	<font color=ForestGreen><b>vtr.imper.:</b></font> ¡Muéstrenlo!
Imechripo	<font color=ForestGreen><b>vtr.interrog.:</b></font> ¿Ya lo mostraron?
Itswojgia	<font color=ForestGreen><b>vtr.:</b></font> Cambiar. Poner una cosa o una persona en el lugar o puesto de otra.
O'e	<font color=ForestGreen><b>n.m.:</b></font> Arcoíris. Banda luminosa con forma de arco que presenta los colores del espectro solar y aparece a veces en el cielo, debido a la refracción y reflexión de la luz del sol en las gotas de lluvia.
Ona	<font color=ForestGreen><b>zool.:</b></font> Urina. Animal silvestre de las pampas y selvas.
Onogi	<font color=ForestGreen><b>adv.l.:</b></font> Allá, allí. Indica de forma poco precisa un lugar alejado de la persona que habla y de la que ecucha.
Ótino	<font color=ForestGreen><b>bot.:</b></font> Pica, pica. Planta. Existen dos tipos de plantas, que se encuentra en la Amazonia como también en la serranía y que sirve de medicina natural.
Ososori	<font color=ForestGreen><b>zool.n.f.:</b></font> Hormigas negras. Insecto de color negro, tienen mal olor y caminan en grupo. Su aparición anuncia mal tiempo (lluvia).
Oni	<font color=ForestGreen><b>adv.l.:</b></font> Aquí. Indica el lugar en el que está la persona que habla o escribe, o un lugar próximo a él.
Okromo	<font color=ForestGreen><b>zool.:</b></font> Borochi. Animal silvestre de pampas.
Oyna	determ.num.interrog.: ¿Cuánto? Introduce una pregunta sobre la cantidad, el tamaño, el número, etc.
Oyvi	<font color=ForestGreen><b>adv.l.interrog.:</b></font> ¿Dónde estás? Introduce una pregunta de lugar.
Oniye'e	<font color=ForestGreen><b>adv.l.:</b></font> Más acá. Indica de forma poco precisa el lugar donde se encuentra una persona.
Oypuka	<font color=ForestGreen><b>adv.l.interrog.:</b></font> ¿Dónde es? Persona que pregunta donde queda la dirección, ruta o lugar de una persona, objeto o cosas.
Oytataji	<font color=ForestGreen><b>n.m.:</b></font> Desprecio. Falta de aprecio hacia una persona o algún animal.
U'ari	<font color=ForestGreen><b>mit.:</b></font> Jucumari. Personaje mítico de la selva. Similar a un hombre salvaje.
Uchu	<font color=ForestGreen><b>zool.n.m.:</b></font> Capibara. Mamífero roedor. Animal silvestre de las pampas y ríos de mojos.
Une	<font color=ForestGreen><b>n.f.:</b></font> Agua. Elemento líquido y esencial para la supervivencia de toda la humanidad.
Úkoji	<font color=ForestGreen><b>n.f.:</b></font> Nube. Masa visible suspendida en la atmósfera, de color y densidad variable, formada por la acumulación de partículas diminutas de agua.
Úsepi	<font color=ForestGreen><b>zool.n.f.:</b></font> Yoperojobobo. Serpiente, vibora muy venenosa que vive en las bajuras, pampas y selvas.
Unekure	<font color=ForestGreen><b>n.f.pl.:</b></font> Pozas de agua. Espacio de agua detenida en los bajios, montes, cerros y pampas.
Unechkore	<font color=ForestGreen><b>n.f.:</b></font> Diarrea. Alteración intestinal que se caracteriza por alguna enfermedad malestar estomacal que se da con mayor frecuencia, en las personas o animales. 
Upa	<font color=ForestGreen><b>adj. n.f.m.:</b></font> Mudo. Persona que tiene discapacidad física en las cuerdas vocales. No habla.
Chawre	<font color=ForestGreen><b>mit.:</b></font> Personaje mítico que tenía poderes en el pueblo trinitario.
Chaku	<font color=ForestGreen><b>n.m.:</b></font> Mosquitero. Ropaje. Cortina de tejido fino casi transparente, como gasa, que cuelga sobre una cama cubriéndola por completo para impedir el ingreso de insectos.
Cháragi	<font color=ForestGreen><b>n.m.:</b></font> Charque. Carne salada que se ha dejado secar al aire o al sol para que pierda humedad y se conserve más tiempo.
Charuji	<font color=ForestGreen><b>n.f.:</b></font> Comida. Sustancia sólida que se come y sirve de alimento
'Chavesi	<font color=ForestGreen><b>zool.n.m.:</b></font> Serere. Ave silvestre de la orilla de las lagunas.
'Cheti	<font color=ForestGreen><b>bot.n.m.:</b></font> Ají. Planta herbácea americana con diferentes sabores de picante.
'Chátrope	<font color=ForestGreen><b>n.m.:</b></font> Cuchillo. Utensilio para cortar que consiste en una hoja de metal generalmente alargada y afilada por un solo lado, a veces puntiagudo, con un mango de metal, madera u otro material.
'Chugiesi	<font color=ForestGreen><b>zool.:</b></font> General. Pez comestible de los ríos de la Amazonía.
'Cheve	<font color=ForestGreen><b>n.f.:</b></font> Sal. Sustancia blanca, cristalina que le da sabor a la comida.
Chuni	<font color=ForestGreen><b>zool.:</b></font> Mutún. Ave de color negro o gris, de montes y pampas.
Chuye	<font color=ForestGreen><b>zool.n.m.f.:</b></font> Zorro. Animal silvestre de las pampas y ríos.
Chupi	<font color=ForestGreen><b>zool.:</b></font> Pugilla (mosquito). Insecto punsante mayormente que habitan en las pampas.
'Chope	<font color=ForestGreen><b>adj.:</b></font> Grande.
Chepi	<font color=ForestGreen><b>zool.n.f.:</b></font> Sabayón. Insecto lombríz de tierra que se utiliza para carnada en la pesca.
Chora	<font color=ForestGreen><b>n.m.adj.:</b></font> Color verde lechuga.
Chororo	<font color=ForestGreen><b>zool.:</b></font> Sabalina. Pez de río con escamas muy menudas.
Chumo	<font color=ForestGreen><b>n.m.:</b></font> Toco <font color=purple>/</font> taburete.
'Chuve	<font color=ForestGreen><b>zool.:</b></font> Mosca. Insecto de cuerpo negro de unos 6 mm de largo, con dos alas transparentes cruzadas de nervios. Ojos grandes y salientes, y un aparato bucal para chupar las sustancias de las que se alimenta.
Churu	<font color=ForestGreen><b>zool.:</b></font> Sicurí (anaconda). Boa semi-acuática que mayormente vive en el agua de los ríos profundos.
Chiimoya	<font color=ForestGreen><b>bot.:</b></font> Chirimoya. Fruto del chirimoyo, del tamaño aproximado de una manzana, de color verde.
Chukrate	<font color=ForestGreen><b>bot.:</b></font> Mazorca. Espiga grande, formada por granos gruesos y apretados: fruta del árbol de chocolate.
Chukrategie	<font color=ForestGreen><b>bot.:</b></font> Árbol. Planta de tronco leñoso, grueso y elevado que se ramifica a cierta altura del suelo formando la copa: árbol del chocolate
Chutmoko	<font color=ForestGreen><b>n.m.:</b></font> Cabello. Pelo de la cabeza de una persona.
Chtimkore	<font color=ForestGreen><b>n.m.:</b></font> Cabello. Pelo que se encuentra en un lugar o depósito.
'Chtire	<font color=ForestGreen><b>n.f.anat.:</b></font> Cabeza. Puede ser de animal o persona encontrada en un lugar.
'Cheprisi	<font color=ForestGreen><b>adj.n.f.:</b></font> Sabayonera o criadero de lombrices.
'Chene	<font color=ForestGreen><b>n.m.:</b></font> Camino franja de terreno donde se puede transitar.
Chene / cheñono	<font color=ForestGreen><b>n.f.anat.pl.sing.:</b></font> Seno, pecho/senos, pechos. Órgano glandular de las hembras de los mamíferos que produce la leche que sirve para alimentar a las crías.
'Choyoro	<font color=ForestGreen><b>adj.:</b></font> Redondo. Objeto que tiene forma circular o esférica.
Chipyomo	<font color=ForestGreen><b>adj.:</b></font> Turbio. Agua de ríos, lagunas que están alterado por una cosa que le quita la transparencia o la claridad. También se utiliza para referirse a otros líquidos.
Chípeji	<font color=ForestGreen><b>adj.:</b></font> Sucio. Que no cuida su higiene personal, o descuida la limpieza de su ropa o de sus cosas.
Chípe'o	<font color=ForestGreen><b>adj.:</b></font> Persona sucia. Personas que están sucias por trabajo, borrachera, etc.
'Chevyomo	<font color=ForestGreen><b>n.f.:</b></font> Salmuera. Agua saturada de sal.
'Cheveji	<font color=ForestGreen><b>bot.:</b></font> Tarope. Planta acuática que tiene forma deslumbrante.
'Chevejikre	<font color=ForestGreen><b>bot.:</b></font> Taropal. Lugar de taropes, en lagunas o en ríos.
'Chichchu	<font color=ForestGreen><b>adj.n.f.m.:</b></font> Enano <font color=purple>/</font> pequeño. Persona o animal de baja estatura.
'Chigi	<font color=ForestGreen><b>n.m.:</b></font> Excremento. Materia compuesta de residuos de alimento que el organismo elimina por el ano tras haber hecho la digestión.
'Chini	<font color=ForestGreen><b>zool.:</b></font> Tigre/jaguar. Mamífero felino feroz, temible; que viven en los bosques amazónicos.
Chriperu	<font color=ForestGreen><b>n.m.:</b></font> Machetero. Persona que baila la danza típica del machetero, baile propio del Beni.
Chrisi	<font color=ForestGreen><b>zool.n.f.:</b></font> Carachupa. Animal mamífero marsupial, omnívoro y nocturno del monte que ataca a los gallineros.
Chmoro	<font color=ForestGreen><b>n.f.:</b></font> Morral, mochila, bolsón. Sirve para llevar alimento, material, etc.
Chrumere	<font color=ForestGreen><b>zool.:</b></font> Pez Raya. Similar a la raya de tamaño gigante que vive en aguas profundas.
Chorapi	<font color=ForestGreen><b>adj.:</b></font> Verde retoño. Color verde retoño: liñada, soga, cable, etc
Jane	<font color=ForestGreen><b>zool.:</b></font> Peto o avispa. Insecto que segrega liquido que causa dolor fuerte al picar.
Jarina	<font color=ForestGreen><b>n.f.:</b></font> Fécula de chivé. Alimento elaborado de la yuca, propio de la Amazonia. Harina de yuca.
Je'chu	<font color=ForestGreen><b>n.f.:</b></font> Afirmación <font color=purple>/</font> verdad.
Jimo	<font color=ForestGreen><b>zool.:</b></font> Pez. Animal vertebrado acuático provisto de aletas, con el cuerpo generalmente cubierto de escamas, respira por branquias y se reproduce por huevos.
Jimueche	<font color=ForestGreen><b>n.f.:</b></font> Pescado preparado para el consumo humano.
Jimtsugi	<font color=ForestGreen><b>zool.:</b></font> Culebra <font color=purple>/</font> chicotillo. Reptil que tiene la forma de un chicotillo que ataca con su cola como chicoteando.
'Jínomo	<font color=ForestGreen><b>zool.:</b></font> Raya. Familia de los peces, es acuático, tiene forma redondeada.
Jmú'i	<font color=ForestGreen><b>n.m.:</b></font> Vestido. Prenda de vestir de una dama que encuentra en un lugar especifico.
Jimomore	<font color=ForestGreen><b>adj.zool.:</b></font> Ictiófago(a). Persona, animal o ave que le gusta comer carne de pescado.
Jipño	<font color=ForestGreen><b>n.f.:</b></font> Uña. Placa cornea dura que protege la parte superior de la punta de los dedos del hombre y de otros vertebrados.
Jisgi	<font color=ForestGreen><b>zool.:</b></font> Chiriguano. Tipo de peto o avispa que pica y posee un aguijón que provoca picaduras muy dolorosas.
Joyno	<font color=ForestGreen><b>bot.:</b></font> Ambaibo. Árbol que crece cerca de los ríos y bosques de la región amazónica.
Joono	<font color=ForestGreen><b>n.m.:</b></font> Horno. Aparato elaborado de barro o ladrillo para la cocción de pan de arroz, pan, carne, etc.
Ju'e	<font color=ForestGreen><b>anat.n.f.:</b></font> Barriga. Vientre, cavidad abdominal de los vertebrados que contiene diversos órganos del cuerpo.
Juve	<font color=ForestGreen><b>adj.:</b></font> Baboso. Persona o animal que echan baba por la boca.
Juvi	<font color=ForestGreen><b>zool.:</b></font> Pava campanilla. Ave que vive en las selvas y pampas que se alimenta de frutas e insectos.
Juiti	<font color=ForestGreen><b>adv.t.:</b></font> Ahora. Indica el momento mismo en el que se habla, está o escribe.  <font color=purple>Ej.</font> Ahora, llegamos a Trinidad. <font color=purple>/</font> <font color=blue>Juiti vitekpoyre te trinra.</font>
Juitney'e	<font color=ForestGreen><b>loc.adv.:</b></font> Más un rato.  <font color=purple>Ej.</font> Voy mas rato a la casa. <font color=purple>/</font> <font color=blue>Juitney'e nñonño te peti.</font>
Juitrichu	<font color=ForestGreen><b>adv.t.:</b></font> Ahorita. Indica un momento muy próximo al presente, inmediatamente antes o después del momento que se habla, está o escribe.  <font color=purple>Ej.</font> Ahorita voy. <font color=purple>/</font> <font color=blue>Juitrichu nutekyo.</font>
Juévesi	<font color=ForestGreen><b>n.m.:</b></font> Jueves. Cuarto día de la semana.
Jvejna	<font color=ForestGreen><b>vtr.imper.:</b></font> ¡Andá traé! Orden de una persona a otra de que tiene que traer algún objeto.
Jremo	<font color=ForestGreen><b>n.m.:</b></font> Urupé. Cernidor que sirve para apartar del grano más grande a los más menudos.
Jraeegi	<font color=ForestGreen><b>n.f.:</b></font> Estrella. Astro o cuerpo celeste que brilla con luz propia en el firmamento.
Jre'i	<font color=ForestGreen><b>n.f.:</b></font> Canastilla. Cesta pequeña de mimbre utilizada por las señoras para sacudir el algodón para que salga la suciedad.
Kaasonsiyu	<font color=ForestGreen><b>n.m.:</b></font> Calzonsillo <font color=purple>/</font> calzón. Ropa interior. En idioma trinitario la misma palabra es usada para los dos géneros de ropa.
Kaere	<font color=ForestGreen><b>bot.:</b></font> Camote. Planta trepadora comestible dulce de color amarillo, blanco y morado.
Kamisa	<font color=ForestGreen><b>n.f.:</b></font> Camisa. Prenda de vestir.
Katarina	<font color=ForestGreen><b>n.:</b></font> Catalina. Nombre de persona de sexo femenino.
Kareta	<font color=ForestGreen><b>n.m.:</b></font> Carretón. Medio de transporte elaborado de madera que es jalado por bueyes.
Katsa	<font color=ForestGreen><b>zool.:</b></font> Tucura. Grillo. Insecto que vive en los montes, pampa y yomomo.
Kajve	<font color=ForestGreen><b>bot.n.m.:</b></font> Café. Semilla del cafeto. <font color=purple>/</font> También se utiliza para referirse al color café.
Keeno	<font color=ForestGreen><b>bot.n.m.:</b></font> Plátano. Fruto del platanero. Comestible.
Keenochowa	<font color=ForestGreen><b>n.m.:</b></font> Penga del plátano. Conjunto de frutos que están sostenidos por un mismo tallo.
Keenochpu	<font color=ForestGreen><b>bot.n.m.:</b></font> Raíz del plátano. Órgano de la planta, desprovisto de hojas y generalmente introducido en la tierra.
Keenopoko	<font color=ForestGreen><b>bot.n.f.:</b></font> Hoja de plátano.
Kaeiji	<font color=ForestGreen><b>zool.:</b></font> Conejo silvestre. Animal mamífero de la selva y monte.
Kaeicha (kicha)	<font color=ForestGreen><b>n.f.:</b></font> Pala. Herramienta utilizada para carpir, cavar.
Kirosena	<font color=ForestGreen><b>n.m.:</b></font> Querosén. Líquido inflamable. Combustible.
Krino	<font color=ForestGreen><b>bot.:</b></font> Chuchió. Planta gramínea perenne, cuyo tallo puede alcanzar hasta 10 m de altura. Crece en las orillas de algunos ríos.
Koyre	<font color=ForestGreen><b>zool.:</b></font> Clase formada por aves.
Koje	<font color=ForestGreen><b>n.f.:</b></font> Luna <font color=purple>/</font> Mes. Astro, satélite natural de la Tierra, que gira alrededor de ella y refleja la luz del Sol.
Kojegie	<font color=ForestGreen><b>bot.:</b></font> Guayabochi. Árbol maderable.
Kjoregie	<font color=ForestGreen><b>bot.:</b></font> Algodón. Planta. Fibra natural que se obtiene del algodón y se utiliza en industria textil.
Kochigira	<font color=ForestGreen><b>bot.:</b></font> Motacusillo. Variedad de la planta del guineo comestible.
Kópopi	<font color=ForestGreen><b>bot.:</b></font> Pacai. Fruta propia de América del Sur. Fruto dulce.
'Kuteno	<font color=ForestGreen><b>bot.:</b></font> Caña. Caña de tallo leñoso que está lleno de un tejido esponjoso y dulce del que se extrae el azúcar.
Kujpa	<font color=ForestGreen><b>bot.:</b></font> Yuca. Tubérculo comestible.
Kchiru	<font color=ForestGreen><b>zool.:</b></font> Hormiga. Variedad exclusiva de hormiga.
Kchicheru	<font color=ForestGreen><b>bot.:</b></font> Achachairú. Planta y fruto exótico de la Amazonia.
Ktsire	<font color=ForestGreen><b>bot.:</b></font> Cusiré. Tubérculo de color morado y blaco comestible.
Krawo	<font color=ForestGreen><b>n.m.:</b></font> Clavo. Material de acero exclusivo para clavar cosas.
Knore	<font color=ForestGreen><b>zool.:</b></font> Tucán. Ave pico grande de las pampas de mojos.
Ktino	<font color=ForestGreen><b>zool.:</b></font> Cuervo. Ave solitaria, omnívora, monógama de río.
Kjiure	<font color=ForestGreen><b>zool.:</b></font> Lagarto. Reptil que vive en los ríos y lagunas.
Ktírepi	<font color=ForestGreen><b>zool.:</b></font> Anguila. Pez con cuerpo de serpiente. Vive en los ríos y lagunas de la Amazonía.
Ktoru	<font color=ForestGreen><b>zool.:</b></font> Bagre. Pez del río muy común del Mamoré y otros ríos.
Kricheji	<font color=ForestGreen><b>n.m.coloq.:</b></font> Curichi. Espacios de acumulados de agua donde especies de plantas como el junco viven.
Kyúrare	<font color=ForestGreen><b>zool.:</b></font> Bagre. Especie de Bagres o pez de color cristalino, pardusco dependiendo del color de agua.
Krinopoko	<font color=ForestGreen><b>bot.:</b></font> Hoja de chuchió. Especie de hierba que sirve para elaborar artesanía y techos de casa.
Kyara	<font color=ForestGreen><b>bot.:</b></font> Totaí. Árbol de palmera que crece en las pampas de la Amazonía.
Kpeji	<font color=ForestGreen><b>zool.:</b></font> Tejón. Mamífero, carnívoro, silvestre de las selvas.
ktso'i	<font color=ForestGreen><b>zool.:</b></font> Tucancillo. Ave mediana de las pampas y selvas de la Amazonía.
Kjowo	<font color=ForestGreen><b>zool.:</b></font> Ciervo. Mamífero rumiante, silvestre que vive en los pantanos. Yom omales de la Amazonía.
Kyagi	<font color=ForestGreen><b>bot.:</b></font> Marayaú. Plantas con espinas que crecen en las selvas y montes.
Kyowre	<font color=ForestGreen><b>zool.:</b></font> Pájaro Carpintero. Ave silvestre de las selvas y pampas.
Króyono	<font color=ForestGreen><b>adj.coloq.:</b></font> Carayana. Seudónimo o apodo a los grupos de poder no considerados indígenas. Descendientes de los españoles.
Krujo	<font color=ForestGreen><b>n.m.:</b></font> Plato. Utensilio de cocina útil para servir los alimentos.
Krujpangi	<font color=ForestGreen><b>zool.:</b></font> Doradillo. Pez que habita mayormente en las cachuelas de los ríos.
Kwooku	<font color=ForestGreen><b>n.m.:</b></font> Puerto. Lugar de desembarco de barcos, canoas, pontones o también se utiliza para referirnos a un cruzadero.
Kwoyu	<font color=ForestGreen><b>zool.:</b></font> Caballo. Mamífero herbívoro doméstico útil para transporte y la ganadería.
Kwoysumu	<font color=ForestGreen><b>zool.:</b></font> Buey caballo. Buey que es utilizado como caballo que es útil para transporte y carga.
Kwoyette	<font color=ForestGreen><b>zool.:</b></font> Mata caballo. Insecto casi parecido a la tucura, que vive en las pampas, bajío.
Kchara	<font color=ForestGreen><b>n.f.:</b></font> Cuchara. Utensilio que sirve para llevar los alimentos a la boca.
Mami	<font color=ForestGreen><b>adj.dem.:</b></font> Su estómago. Meme: <font color=ForestGreen><b>n.f.coloq.:</b></font> Mamá <font color=purple>/</font> señora.
Mamuire	<font color=ForestGreen><b>adv.afirm.:</b></font> También. persona que participó en algún hecho, trabajo o acontecimiento.  <font color=purple>Ej.</font> <font color=blue>Mamuire emjaa'i te t-semkokompo.</font> <font color=purple>/</font> También él estaba presente en la discusión.
Mamyore	<font color=ForestGreen><b>vtr.:</b></font> Lo llevará. Persona que se encargara de llevar o traer a una persona, animal o cosa.  <font color=purple>Ej.</font> <font color=blue>Mamyore ma napyaru to pkure.</font> <font color=purple>/</font> Mi tío va a llevar/traer la canoa. 
Maroto	<font color=ForestGreen><b>vtr.excl.:</b></font> ¡Lo encontró! Persona que encuentra a otra persona, animal o cosa.
Máchosi	<font color=ForestGreen><b>zool.:</b></font> Chuturubí. Peto avispa de color rojizo negro que su picada es dolorida.
Machicha	<font color=ForestGreen><b>adj.dem.:</b></font> Su hijo. Se utiliza para referirse al hijo de un hombre.
Mateka	<font color=ForestGreen><b>n.f.:</b></font> Manteca. Grasa extraía de animal o de pescado grasoso.
Maatesi	<font color=ForestGreen><b>n.m.:</b></font> Martes. Segundo día de la semana.
Manoko	<font color=ForestGreen><b>vtr.prnl.:</b></font> Poner. Acción de vestirse.
Muiriore	<font color=ForestGreen><b>n.m.:</b></font> Camijeta. Vestimenta típica, elaborado de hilo de algodón. Ancestralmente era utilizado a diario por nuestros antepasados.
Muitji / muitjipo	<font color=ForestGreen><b>interj.:</b></font> ¡Imposible <font color=purple>/</font> Ni modo! Actividad que no se puede realizar o continuar por alguna situación.
Mayo	<font color=ForestGreen><b>n.m.:</b></font> Mayo. Quinto mes del año.
'Moyo	<font color=ForestGreen><b>n.f.m.:</b></font> Niño/niña. Niñez. Se utiliza para referirnos al primer período de la vida de una persona, comprendido entre el nacimiento y el principio de la adolescencia.
'Mitreko	<font color=ForestGreen><b>n.f.m.:</b></font> Estudiante <font color=purple>/</font> alumno. Persona que recibe formación y cursa estudios en un centro educativo.
Myeekúresi	<font color=ForestGreen><b>n.m.:</b></font> Miércoles. Tercer Día de la semana.
Ma'e	<font color=ForestGreen><b>adj.dem.:</b></font> Diente de otra persona. Persona que señala el diente de otro.
Maye'e	<font color=ForestGreen><b>adj.dem.:</b></font> Es de él. Afirmación de una persona de que el animal, objeto es de él.
Mantarina	<font color=ForestGreen><b>bot.:</b></font> Mandarina. Fruta cítrica del mandarino que es comestible.
'Moroji	<font color=ForestGreen><b>n.f.:</b></font> Tipoi. Vestido elaborado de tela para el sexo femenino. (Vestimenta típica originaria de los pueblos indígenas del oriente boliviano).
Muipuere	<font color=ForestGreen><b>n.m.:</b></font> Pantalón. Prenda de vestir elaborado de tela para ambos sexos.
Moche	<font color=ForestGreen><b>n.m.:</b></font> Mocheó. Enfermedad que proviene de los difuntos y ataca a los niños causándoles sudoración.
Matse	<font color=ForestGreen><b>zool.:</b></font> Ardilla. Animal silvestre que se alimenta con la semilla o calucha del motacú.
Muiji	<font color=ForestGreen><b>n.f.:</b></font> Paja <font color=purple>/</font> pasto. Hierba que crece en el campo que sirve de alimento para el ganado y otros animales herbívoros.
Mraru	<font color=ForestGreen><b>n.m.f.adj.:</b></font> Color morado. Color violeta oscuro, como la remolacha.
Muena	<font color=ForestGreen><b>interj.coloq.:</b></font> ¡Oí <font color=purple>/</font> oye! Expresión propia del pueblo Mojeño Trinitario que se utiliza para llamar la atención de otra persona.  <font color=purple>Ej.</font> ¡Oye!, ¿Qué está haciendo? <font color=purple>/</font> <font color=blue>¡Muena!, ¿taa pemtone?</font>
Maka	det.pron.dem.: Éste. Indica una persona que esta cerca de la persona que habla o escribe.
Machu	<font color=ForestGreen><b>adj.dem.:</b></font> Su hamaca. Afirmación de propiedad de una hamaca.
Machu	<font color=ForestGreen><b>n.m.:</b></font> Animal macho. Animal de sexo masculino.
'Moperu	<font color=ForestGreen><b>adj.:</b></font> Adolescente.
Movéra	<font color=ForestGreen><b>n.f.:</b></font> Cantidad. Número de unidades, personas, tamaño o porción de una cosa.
Mopona	<font color=ForestGreen><b>n.:</b></font> Tres. El número o cantidad de tres en Mojeño Trinitario.
Machre	<font color=ForestGreen><b>vintr.:</b></font> Nace/sale. Salir [una persona o un animal vivíparo] del vientre de la madre.
Mapa'e	<font color=ForestGreen><b>adj.dem.:</b></font> Su muslo. 
Mapuegie	<font color=ForestGreen><b>adj.dem.:</b></font> Su pierna.
Mapeno	<font color=ForestGreen><b>adj.dem.:</b></font> Su casa. Afirmación de hombre a otro de ser dueño de una casa.
Mítugi	<font color=ForestGreen><b>bot.:</b></font> Tarumá. Árbol que crece en las pampas y las selvas amazónica.
Muitokóresi	<font color=ForestGreen><b>adj.:</b></font> Inacabable. Que no tiene fin o término en el tiempo o en el espacio.
Muitrawre / muitreko	<font color=ForestGreen><b>adj.:</b></font> Infinito. Sin fin, que no tiene ni puede tener fin ni limite.
Mamgiene	<font color=ForestGreen><b>adj.dem.:</b></font> Su carga. Afirmación de una persona a otra que el objeto o cosa que carga durante el viaje es de él (dicho de hombre a hombre).
Matsánogi	<font color=ForestGreen><b>n.f.anat.:</b></font> Canilla. Hueso largo de la pierna o el brazo, en especial la tibia.
Mawri'i	<font color=ForestGreen><b>adv.t.:</b></font> Fue el primero. Afirmación de una persona a otra que el llegó primero.
Moto	<font color=ForestGreen><b>zool.:</b></font> Tatú. Animal silvestre que habita en las pampas y selvas amazónicas.
Motosumu	<font color=ForestGreen><b>n.f.:</b></font> Trompa de tatú. Nombre originario en Mojeño trinitario que se da a una variedad de planta de yuca.
'Motneko	<font color=ForestGreen><b>n.m.:</b></font> Trabajo. Actividad o trabajo que la persona realiza.
Muestako	<font color=ForestGreen><b>vtr.:</b></font> Azotar. Persona que da azotes a otra persona como castigo. (chicotear o guasquear).
'Muirijinve	<font color=ForestGreen><b>adv.t.:</b></font> Siempre. En todas las ocasiones en que es posible o se dan las circunstancias apropiadas, o con mucha frecuencia pasa lo mismo.
Muemoti	<font color=ForestGreen><b>vtr.:</b></font> Identifica. Persona que reconoce a otra persona o cosa.
Muechemrekko	<font color=ForestGreen><b>adj.:</b></font> Desentendido. Persona que no entiende o escucha consejo o enseñanza de alguien.
Matse	<font color=ForestGreen><b>adj.dem.:</b></font> Su abuela.
Matiku	<font color=ForestGreen><b>zool.:</b></font> Matico. Nombre de ave silvestre de las pampas.
Máchuko	<font color=ForestGreen><b>vtr.:</b></font> Soplar. Persona que sopla un instrumento musical como ser flauta, trompeta, fifano, etc.  <font color=purple>Ej.</font> <font color=blue>Machuko to yuku.</font> <font color=purple>/</font> Sopló el fuego.
Machuti	<font color=ForestGreen><b>adj.dem.:</b></font> Su cabeza
Machuchko	<font color=ForestGreen><b>vtr.:</b></font> Chupar. Persona que extrae líquido con la boca  <font color=purple>Ej.</font> Un lactante.
Machuksipewo	<font color=ForestGreen><b>adj.dem.:</b></font> Su talón.
Mueperáji	<font color=ForestGreen><b>adj.:</b></font> Atrevido. Que se comporta con descaro, insolencia, falta de respeto.
Mamuepesirawo	<font color=ForestGreen><b>adj.n.m.:</b></font> Ambicioso. Persona que tiene ambición.
Mano'si	<font color=ForestGreen><b>adj.dem.:</b></font> Su frente.
¡Manosi!	<font color=ForestGreen><b>vtr.imper.:</b></font> ¡Se quedó! Persona que no pudo continuar.
Mánosi	<font color=ForestGreen><b>vtr.imper.:</b></font> ¡Que se quede! Persona que ordena a otra a que se quede.  <font color=purple>Ej.</font> Que se quede cuidando la casa. <font color=purple>/</font> <font color=blue>Mánosi majañoka to peti.</font>
¿manosí?	<font color=ForestGreen><b>vtr.interrog.:</b></font> ¿Se quedó? Integorración a otra persona si se quedo alguien.
Manoko	<font color=ForestGreen><b>vtr.interrog.:</b></font> ¿Lo colocó? Pregunta a una persona colocó o puso en su lugar a alguien u objeto.
Mueto'ako	<font color=ForestGreen><b>vtr.afirm.:</b></font> Ganó. Persona que gana alguna competencia, apuesta o pelea <font color=purple>/</font> acción de ganar.
Mayeno	<font color=ForestGreen><b>adj.dem.:</b></font> Su esposa. afirmación que es su mujer.
Makangiecho	<font color=ForestGreen><b>vtr.:</b></font> Lo suspendió. Acción de levantar, colgar una cosa en algo o en el aire.
Mawgiecho	<font color=ForestGreen><b>vintr.:</b></font> Montar. Persona que se sube al lomo de un caballo, buey, toro, etc. <font color=purple>/</font> Acción de montar.
Makajagicho	<font color=ForestGreen><b>vtr.:</b></font> Lo abrió. Persona que en cierta circunstancia realiza la acción de abrir las piernas (juego deportivo, sexo).
Makajapeko	<font color=ForestGreen><b>vtr.:</b></font> Enrectar. Enderezar algo que esta doblado o torcido.
Makoponreru	<font color=ForestGreen><b>n.f.:</b></font> Estado de preocupación. Intranquilidad.
Matnare	<font color=ForestGreen><b>n.m.:</b></font> Compadrerio. Reunión familiar de presentación de una unión de pareja hacia ambos familiares.
Makpojko	<font color=ForestGreen><b>vtr.:</b></font> Lo encontropersona. Que encuentra a otra persona o animal.
¿Makpojko?	<font color=ForestGreen><b>vtr.interrog.:</b></font> ¿Lo encontró?
Mano'okpo	<font color=ForestGreen><b>vtr.:</b></font> Aprovechar. Persona que en el momento oportuno aprovecha la oportunidad como ser en la cosecha, pesca, acoso.
Makootoko	<font color=ForestGreen><b>vtr.afirm.:</b></font> Lo atrapó. Afirmación de una persona a otra de coger fuertemente con la mano o, de cualquier modo.
Mano'oko	<font color=ForestGreen><b>vtr.prnl.:</b></font> Aprovecharse. Persona que en el momento oportuno aprovecha de lo que existe en esa ocasión.
Makompura	<font color=ForestGreen><b>n.f.:</b></font> Ocasión. persona que aprovecha en cierta ocasión de sacar provecho en su beneficio.
Makojcho	<font color=ForestGreen><b>vtr.:</b></font> Retear. Persona que regaña a otra persona o como también a un animal.
Mamotsipa	<font color=ForestGreen><b>adj.dem.:</b></font> Su pestaña.
Machupu'i	<font color=ForestGreen><b>adj.dem.:</b></font> Su tronco.
Makóyepe	<font color=ForestGreen><b>adj.dem.:</b></font> Su amante. persona afirma que aquella mujer es amante de otra.
Mawoo'o	art.deter.: Lo (la) quiere. Persona que estima a otra persona, objeto u animal por algún motivo o circunstancia.
Matsuko	<font color=ForestGreen><b>vtr.:</b></font> Lo besó. Persona que afirma que la otra persona acaricia a la mujer besándola.
Matsukpo	<font color=ForestGreen><b>vtr.afirm.interj.:</b></font> ¡Ya lo besó! Afirmación de una persona a otra persona que le dió un beso.
Masu	<font color=ForestGreen><b>adj.:</b></font> Manso. Animal que no ataca ni actúa con agresividad, sino que se muestra dócil en compañía de las personas y se deja tomar o acariciar.
Masuurupi	<font color=ForestGreen><b>n.m.:</b></font> Enema. Instrumento propio de los pueblos originarios hecho de tripa seca que sirve para introducir el liquido desinflamatorio a través del ano <font color=purple>/</font> liquido que se inyecta en el intestino por el ano con fines laxantes.
Masuu'o	<font color=ForestGreen><b>vtr.:</b></font> Lo frita/o. Afirmación de freír alimentos.
'Mu'i	<font color=ForestGreen><b>zool.:</b></font> Curubina. Nombre que se le da a un pez de los ríos y lagunas trinitarias.
Muito'a	<font color=ForestGreen><b>adj.:</b></font> Invencible. Que no se le puede ganar o vencer.
Masu'o	<font color=ForestGreen><b>vtr.:</b></font> Se atoró. Quedársele a alguien algo detenido o atravesado en la garganta, obstruyéndola e impidiendo que se pueda tragar.
Muitnerepe	<font color=ForestGreen><b>zool.:</b></font> Pez sin sangre. Pez de agua dulce, de la familia de la sardina.
Mneneru	<font color=ForestGreen><b>zool.:</b></font> Boca de vieja. Pez de agua dulce, que tiene la boca grande.
Mrarupe	<font color=ForestGreen><b>n.:</b></font> Utensilio de cocina plano de color morado.
Memenajriore	<font color=ForestGreen><b>n.f.:</b></font> Consejera. Persona adulta de sexo femenino que da consejo a otras personas.
Majmere	<font color=ForestGreen><b>adj.dem.:</b></font> Su papel higiénico.
Mapowgi	<font color=ForestGreen><b>adj.dem.:</b></font> Su brazo.
Ma'u	<font color=ForestGreen><b>adj.n.m.f.:</b></font> Ciego. Que no ve por estar privado del sentido de la vista.
Ma'u	<font color=ForestGreen><b>adj.dem.:</b></font> Su voz. 
Majre	<font color=ForestGreen><b>adj.dem.:</b></font> Su escrito. 
Majumeru	<font color=ForestGreen><b>vtr.:</b></font> Lo que se escribió. Escrituras ancestrales históricas.
Marusaa'o	<font color=ForestGreen><b>adj.dem.:</b></font> Su rosario. Afirmación de una persona que el material elaborado de madera fraganciosa llamado tijiyequi le pertenece.
Manisrare	<font color=ForestGreen><b>n.m.:</b></font> Comedor. Habitación de una vivienda o de un establecimiento que dispone de lo necesario para servir comidas.
Mani'o	<font color=ForestGreen><b>adj.dem.n.m.:</b></font> Su preferido. Comida favorita.
Myuku	<font color=ForestGreen><b>zool.:</b></font> Conejo. Animal silvestre que habita diferentes geografias. Comestible.
Myo'u	<font color=ForestGreen><b>adj.:</b></font> Color Café, marrón. Color para distinguir objetos cosas y animales.
Mag'e	<font color=ForestGreen><b>adj.dem.:</b></font> Su cuerpo. 
Mag'o	<font color=ForestGreen><b>vtr.afirm.:</b></font> Lo lanzó. 
Mag'a	<font color=ForestGreen><b>adj.dem.:</b></font> Su ojo. 
Magi	<font color=ForestGreen><b>adj.dem.:</b></font> Su testículo.
Magierepi	<font color=ForestGreen><b>n.m.:</b></font> Hilo de pescar. Prolongación de la tarrafa de pescar.
Mágire	<font color=ForestGreen><b>adj.:</b></font> Hombre o animal sin testículos.
Myupi	<font color=ForestGreen><b>zool.:</b></font> Paleta. Pez de agua dulce de la especie del surubí.
Mírore	<font color=ForestGreen><b>n.f.pl.:</b></font> Máscaras. Diferentes tipos de máscaras que usan en diferentes danzas.
Mitu'i	<font color=ForestGreen><b>bot.:</b></font> Fruta del tarumá. Fruta comestible para las aves y animales, tambien se utiliza como medicina tradicional.
Muitujegne	<font color=ForestGreen><b>adj.:</b></font> Inútil. Sinónimo de suteji.
Mitsi	<font color=ForestGreen><b>zool.n.m.f.:</b></font> Gato. Animal doméstico diurno y nocturno.
Meriope	<font color=ForestGreen><b>n.m.:</b></font> Dinero. Plata que se utiliza para la compra o venta de cosas.
Meriope	<font color=ForestGreen><b>adj.:</b></font> Retrasado mental.
Merómero	<font color=ForestGreen><b>zool.:</b></font> Caimán. Reptil acuático. Muy similar al cocodrilo en forma y color, pero de hocico más corto
Met-si	<font color=ForestGreen><b>n.f.:</b></font> Olla. Utensilio de la cocina para la cocción de los alimentos.
Metemitsgi	<font color=ForestGreen><b>adj.:</b></font> Silleta. Persona, animal que tiene el espinaso simbrado.
Muekyechpo	<font color=ForestGreen><b>vtr.:</b></font> Lo transformó. Objeto cambiado de forma por otra.
Mapuisra	<font color=ForestGreen><b>n.f.:</b></font> Su caminar. Forma particular de caminar de la persona.
Meriowkure	<font color=ForestGreen><b>n.m.:</b></font> Entidad financiera. Banco.  <font color=purple>Ej.</font> El banco Unión.
Muepucho	<font color=ForestGreen><b>vtr.afirm.:</b></font> Lo salvó. Persona que salvó de morir a otra.
Mueprujcho	<font color=ForestGreen><b>vtr.afirm.:</b></font> Lo curó. Persona que hacer desaparecer una enfermedad, una herida o un daño físico a otra persona, un animal o un organismo.
Maatiyu	<font color=ForestGreen><b>n.m.:</b></font> Martillo. Herramienta fabricada de fierro que sirve para clavar y extraer clavos.
Maatina	<font color=ForestGreen><b>n.:</b></font> Martina. Nombre de mujer.
Mójomo	<font color=ForestGreen><b>adj.:</b></font> Sarnoso. Animal enfermo de sarna.
Majomo	<font color=ForestGreen><b>n.f.bot.:</b></font> Leche de majo. Palmera de la selva con frutos comestibles.
Myóromo	<font color=ForestGreen><b>n.m.:</b></font> Mayordomo. Autoridad que ocupa una cartera dentro del cabildo indígenal. <font color=purple>/</font> También se utiliza para nombrar a un encargado de una estancia.
Maasana	<font color=ForestGreen><b>n.f.bot.:</b></font> Manzana. Fruta dulce comestible.
Muchji	<font color=ForestGreen><b>n.m.:</b></font> Moco. Sustancia espesa y pegajosa segregada por una membrana mucosa, especialmente por la mucosa nasal.
'Muirisi	<font color=ForestGreen><b>adj.:</b></font> Entero. Cosa redonda completa.
Mraka	<font color=ForestGreen><b>adj.:</b></font> Resistente. Objeto que soporta peso y resistente al tiempo.
Mriji	<font color=ForestGreen><b>n.f.:</b></font> Colectividad. Conjunto de personas que tienen problemas e intereses comunes.
Muikchosiono	<font color=ForestGreen><b>adj.n.f.:</b></font> Bárbaro. Que no está en contacto con los pueblos organizados. Concepto que dieron los colonizadores españoles a los pueblos originarios.
Muikchosi	<font color=ForestGreen><b>prep.:</b></font> Sin bautizo. Persona que no ha sido bautizada.
Manka	<font color=ForestGreen><b>bot.:</b></font> Manga. Fruta del árbol del mango que es comestible y dulce.
Maskapa	<font color=ForestGreen><b>bot.n.m.:</b></font> Maíz tostado. Harina molina del maíz que sirve para elaborar chicha.
Makapripo	<font color=ForestGreen><b>adv.l.:</b></font> Esta aquí. Su utiliza para afirmar que una persona que ya llegó.
Matpiru	<font color=ForestGreen><b>vintr.prnl.:</b></font> Irse directo. Persona que indica que le diga a la otra persona que se vaya al lugar indicado.
Makpuiru	<font color=ForestGreen><b>vtr.:</b></font> Se bajó. Persona que recientemente acaba de bajar de un avión, barranco, canoa, auto, caballo o carretón.
Matúpiru	<font color=ForestGreen><b>vtr.prnl.:</b></font> Se fué directo. Persona que comenta a otra que alguien se fue directo a algún lugar.  <font color=purple>Ej.</font> El señor se fue directo a su casa <font color=purple>/</font> <font color=blue>Ma tata matupiru te mapeno.</font>
Matupiirichu	<font color=ForestGreen><b>vtr.prnl.:</b></font> Se pasó directo. Afirmación de una persona que alguien se pasó directo sin parar.
Matupo	<font color=ForestGreen><b>adj.dem.:</b></font> Su pecho.
Makje'e	<font color=ForestGreen><b>interj.:</b></font> ¡Oiga! Expresión propia originaria empleada para llamar la atención de alguien.
Muetpuegia	<font color=ForestGreen><b>vtr.imper.:</b></font> ¡Que se agache!
Mue'a	<font color=ForestGreen><b>vtr.imper.:</b></font> ¡Que le pegue! Orden de una persona a otra persona a que le de golpes.
Muemchuko	<font color=ForestGreen><b>adj.dem.:</b></font> Su suegro. Afirmación de una persona a otra de que es su suegro.
Mayogiomo	<font color=ForestGreen><b>deter.poses.:</b></font> Su semen.
Muemnaru	<font color=ForestGreen><b>deter.poses.:</b></font> Su adulado. Que solo estima y adula a una sola persona, que puede ser por cariño o interés.
Mkata	<font color=ForestGreen><b>n.m.:</b></font> Orador. Persona que utiliza la elocuencia oral en público.
Makósiña	<font color=ForestGreen><b>vtr.prnl.:</b></font> Se proteje. Persona que se resguarda de alguien, algo peligroso o daño.
Muemnanasko	<font color=ForestGreen><b>adj.:</b></font> Loco. Que tiene poco juicio o se comporta de forma disparatada, imprudente o temeraria, sin pensar en las consecuencias.
Muemsiigicho	<font color=ForestGreen><b>vtr.:</b></font> Lo mezclo. Acción de mesclar los alimentos con otros ingredientes.
Muemtone	detrer.poses.: Su trabajo.
Maye'eru	<font color=ForestGreen><b>deter.poses.:</b></font> Su juguete. 
Mayogi	<font color=ForestGreen><b>deter.poses.:</b></font> Su pene. 
Makaeicha	<font color=ForestGreen><b>deter.poses.:</b></font> Su pala. 
Mayowo	<font color=ForestGreen><b>deter.poses.:</b></font> Su acha. 
Muesaviipe	<font color=ForestGreen><b>deter.poses.:</b></font> Su machete.
Matumra	<font color=ForestGreen><b>deter.poses.:</b></font> Su cuchillo.
Matagrigi	<font color=ForestGreen><b>deter.poses.:</b></font> Su flecha. Arma de cacería que pertenece a alguien.
Muesane	<font color=ForestGreen><b>deter.poses.:</b></font> Su chaco. Chaco que le pertenece a una persona.
Muesanereji	<font color=ForestGreen><b>deter.poses.:</b></font> Su barbecho. Afirmación de que el barbecho es de una persona.
Muemtonere	<font color=ForestGreen><b>adj.:</b></font> Sin oficio. Persona que no trabaja. Es vago, flojo.
Muero	<font color=ForestGreen><b>pron.pers.:</b></font> Lo bebió. Persona que afirma que tomó un líquido, refresco, vino, etc.
Muerosare	<font color=ForestGreen><b>deter.poses.:</b></font> Su bebida favorita.
Mueropo	<font color=ForestGreen><b>vtr.:</b></font> Se lo tomó. Persona que se tomó una bebida, agua, etc.
Muechorekko	<font color=ForestGreen><b>adj.n.f.m.:</b></font> Testarudo. Que se mantiene firme en su actitud, aunque se le den razones en contra.
Muetne	<font color=ForestGreen><b>deter.poses.:</b></font> Su sangre.
Muechoroji	<font color=ForestGreen><b>adj.:</b></font> Invisible. Animal o cosa que no se puede percibir, notar o ver.
Mneji	<font color=ForestGreen><b>prep.:</b></font> Sin carne. Comida o alimento preparado sin carne.
Muijyere	<font color=ForestGreen><b>prep.:</b></font> Sin olor. Se utiliza para referirse a persona, animal o cosa que carece de olor.
Neroyo	<font color=ForestGreen><b>vintr.ind.:</b></font> Voy a tomar. Persona que afirma que va tomar o beber, refresco, agua, etc.
Neroripo	<font color=ForestGreen><b>vtr.afirm.:</b></font> Ya bebí. Afirmación de la persona que ya bebió agua, refresco, chicha, etc
Neeriko	<font color=ForestGreen><b>vtr.ger.:</b></font> Estoy bebiendo. Persona que afirma que está consumiendo bebida alcohólica.
Neesa	<font color=ForestGreen><b>deter.poses.:</b></font> Mi chicha. Persona que afirma que la bebida elaborada de maíz, yuca, plátano, camote y arroz es suya.
Neesa	<font color=ForestGreen><b>deter.poses.:</b></font> Su chicha. Afirmación que la chicha es de ellos.
Nemnakvi	<font color=ForestGreen><b>vtr.afirm.:</b></font> Te amo. Persona que afirma que ama, quiere, estima a otra persona.
Netarako	<font color=ForestGreen><b>vtr.imper.:</b></font> ¡Tengo sed! Expresión de tener sed.
Nettáka	<font color=ForestGreen><b>vtr.imper.:</b></font> ¡Que lo claven!
¿Nettáka?	<font color=ForestGreen><b>vtr.interrog.:</b></font> ¿Lo clavó?
Naemotyora	<font color=ForestGreen><b>deter.poses.:</b></font> Su señal. Elementos tangibles o intangibles que el hombre utiliza para guiarse.
Nechjikra'i	<font color=ForestGreen><b>adj.afirm.:</b></font> Soy chismoso. Persona que le gusta el chisme.
Nechoriko	<font color=ForestGreen><b>vintr.afirm.:</b></font> Doy discurso. Persona que ofrece su servicio de dar un discurso.
Nechoriko	<font color=ForestGreen><b>vintr.afirm.:</b></font> Hago rodar. Persona que afirma que hace rodar un objeto.
Nechoriko	<font color=ForestGreen><b>pron.pers.:</b></font> Lo llamaron. Afirmación de una persona a otra que ha sido invitada o convocado.
Nechpojrikwo	<font color=ForestGreen><b>vtr.:</b></font> Me cuido. Acción de cuidarse, protegerse y conservarse.
Nechpopokwo	<font color=ForestGreen><b>adj.:</b></font> Precavido. Persona cautelosa, que anda siempre con mucho cuidado.
Nemnanasko	<font color=ForestGreen><b>adj.:</b></font> Soy loco. Persona despistada, negligente, que no toma precaución.
Nemna'i	<font color=ForestGreen><b>adj.:</b></font> Soy bueno. Persona agradable, amable, que comparte y es cordial.
Netyora'i	<font color=ForestGreen><b>adj.:</b></font> Soy celoso. Persona que siente celos a algo o alguien.
Nechpukowne	<font color=ForestGreen><b>adj.:</b></font> Madrugador. Persona que se levanta muy temprano a realizar su actividad laboral.
Nepya'ra'i	<font color=ForestGreen><b>adj.:</b></font> Mentiroso. Persona que acostumbra mentir.
Nemechapi	<font color=ForestGreen><b>vtr.:</b></font> Te hago acuerdo. Persona que le hace acuerdo sobre algo para que no se olvide.
Nochko	<font color=ForestGreen><b>deter.poses.:</b></font> Mi abuelo.
Notse	<font color=ForestGreen><b>deter.poses.:</b></font> Mi abuela. 
Néropo	<font color=ForestGreen><b>vtr.:</b></font> Bebí. Persona que acaba de tomar alguna bebida.
Nomo	<font color=ForestGreen><b>pron.pers.:</b></font> Lo llevo. Persona que afirma que lleva a alguien o algo.
Nompo	<font color=ForestGreen><b>vtr.:</b></font> Lo llevaron.
Noniripo	<font color=ForestGreen><b>interj.:</b></font> ¡Ahí vienen! Persona que afirma que un grupo se aproxima.
Nocho'okpo	<font color=ForestGreen><b>vtr.:</b></font> Le eché agua. Acción de echar agua a alguien o a un animal.
Nomarine	<font color=ForestGreen><b>vtr.:</b></font> Yo lo llevaré. Persona que afirma que por algún motivo va llevar a alguien, animal o cosa.
Nomarine	<font color=ForestGreen><b>vtr.:</b></font> Que lo lleven. Afirmación de una persona de que ellos lo van a llevar a la persona, animal o cosa.
Nomyóre	<font color=ForestGreen><b>vtr.afirm.:</b></font> Lo voy a llevar/traer. Persona que afirma que lo va llevar o traer a alguien, animal o cosa.
Noñoppo	<font color=ForestGreen><b>vtr.interj.:</b></font> ¡Ya vienen por ahí! Persona que afirma que un grupo de persona se viene acercando.
Noniri'ojnopo	art.indef.: ¡Otra vez Están por aquí!
Noomiruchpo	<font color=ForestGreen><b>adj.:</b></font> Estorbo. Persona que pone un obstáculo a la ejecución de algo.
Nochoro'okpo	<font color=ForestGreen><b>adj.:</b></font> Lo Chamuscaron.
Nochukpo	<font color=ForestGreen><b>vtr.:</b></font> Soplé. Persona que sopló algo con la boca.
Nokpojkopo	<font color=ForestGreen><b>vtr.:</b></font> Lo encontré. Afirmación de encotrar a una persona o animal.
Nochuka	<font color=ForestGreen><b>vtr.imper.:</b></font> ¡Que lo soplen! Orden de una persona a otras de que tienen que soplar.
Nompookoyre	<font color=ForestGreen><b>vtr.imper.:</b></font> ¡Lo voy a cargar! Afirmación de una persona de llevar o cargar continuamente una cosa por necesidad.
Nokchu'i	<font color=ForestGreen><b>adj.:</b></font> Soy pateador. Persona que agrede físicamente a otro proporcionándole patadas.
Noma	<font color=ForestGreen><b>vtr.interrog.:</b></font> ¿Lo llevo? Pregunta que si puedo llevar a una persona, animal o cosa.
Nochopaka	<font color=ForestGreen><b>vtr.interrog.:</b></font> Remojar <font color=purple>/</font> ¿Lo puedo remojar? Remojar algo solido con un líquido.  <font color=purple>Ej.</font> Agua con chivé. <font color=purple>/</font> También se utiliza como pregunta.
Nim'a	<font color=ForestGreen><b>vtr.interrog.:</b></font> ¿Puedo verlo?
Nim'oyre	<font color=ForestGreen><b>vtr.afirm.:</b></font> Lo voy a ver. Persona que afirma que verá a alguien o algo.
Nimechviyre / nimekviyre	<font color=ForestGreen><b>vtr.afirm.:</b></font> Te mostraré. Persona que muestra algo a alguien.
Nínako	<font color=ForestGreen><b>vintr.ger.imper.:</b></font> ¡Estoy pariendo! Dicho de una mujer que está dando a luz.
Ninakoyre	<font color=ForestGreen><b>vtr.afirm.:</b></font> Voy a parir. Persona que afirma que dará a luz.
Nimijroko	<font color=ForestGreen><b>n.f.:</b></font> Suposición. Persona que considera una deducción de algo como cierto.  <font color=purple>Ej.</font> Me imagino que así será.
Nijrokviyre	<font color=ForestGreen><b>vtr.:</b></font> Te daré. Acción entregar o dar una cosa de una persona a otra de lo que necesita o insiste.
Nim'aprine	<font color=ForestGreen><b>vtr.:</b></font> Yo me encargo. Situación que asume una persona que encuentra por casualidad o situación de emergencia.
Nito'akviyre	<font color=ForestGreen><b>vtr.:</b></font> Te voya ganar. Afirmación de una persona que asegura ganarle en la competencia a la otra.
Nichorikri'i	<font color=ForestGreen><b>vtr.:</b></font> Lo hice llamar. Persona que hace o manda llamar a alguien.
Nitoriko	<font color=ForestGreen><b>v.cop.:</b></font> Yo estoy vivo. Persona que afirma que esta con vida.
Nimoriko	<font color=ForestGreen><b>vtr.:</b></font> Yo visito. Pimera persona en singular.
Nitotijwo	<font color=ForestGreen><b>vtr.afirm.:</b></font> Me encuentro bien. Afirmación de encontrarse sin ningun problema.
Nnikyo	<font color=ForestGreen><b>vtr.:</b></font> Voy a comer. Persona que afirma que va comer algún alimento.
Nnikyore	<font color=ForestGreen><b>vtr.:</b></font> Comeré.
Nniko	<font color=ForestGreen><b>vtr.res.:</b></font> Yo como.  <font color=purple>Ej.</font> Yo como carne. <font color=purple>/</font> <font color=blue>Nuti nniko wakaeche.</font>
Nenwo'u	<font color=ForestGreen><b>adj.:</b></font> Soy pescador. Ser pescador o suertudo.
Nenkora'i	<font color=ForestGreen><b>vtr.:</b></font> Me gusta pescar. Persona que afirma que le gusta pescar.
Nimerikwo	<font color=ForestGreen><b>vtr.prnl.dem.:</b></font> Me muestro. Persona que voluntariamente se presenta ante un grupo o persona.
Niiyarakwo	<font color=ForestGreen><b>vintr.:</b></font> Bostezo. Acto reflejo que consiste en abrir la boca ampliamente, esta relacionado con el sueño, cansancio, aburrimiento.
Niimuiko	<font color=ForestGreen><b>vtr.:</b></font> Bailo. Persona que danza en un grupo de danzarines.
Nijruriko	<font color=ForestGreen><b>vtr.ger.:</b></font> Estoy hilando. Persona que elabora hilo de algodón.
Nito'areko	<font color=ForestGreen><b>vtr.:</b></font> Gané. Persona que afirma que gano alguna competencia, apuesta, etc.
Nitsmeriko	<font color=ForestGreen><b>vtr.ger.:</b></font> Estoy tejiendo. Persona que teje en hilo de algodón, hoja de chuchio.
Nitswochapo	<font color=ForestGreen><b>vtr.:</b></font> Cambio de vida. Persona que cambia de estilo de vida.
Nitswochapi	<font color=ForestGreen><b>n.m.:</b></font> Trueque. Acción de dar una cosa y recibir otra a cambio. Intercambiar animal, alimento, o cosa por otro sin intervención del dinero.
Niptsiko	<font color=ForestGreen><b>vtr.:</b></font> Lo aparto. Separar de un lugar a otro como ser: vaca, caballo, chancho y objeto.
Nissiko	<font color=ForestGreen><b>vintr.:</b></font> Yo silbo. Persona que silba.
Niijiko	<font color=ForestGreen><b>vtr.:</b></font> Sacar todo.
Nviijako	<font color=ForestGreen><b>adj.:</b></font> Apresurado. Persona que se encuentra a prisa o apurado.
Nutyopo	<font color=ForestGreen><b>interj.:</b></font> ¡Ya voy! Ya estoy de ida, llego enseguida.
Nuuponreru	<font color=ForestGreen><b>n.m.:</b></font> Tengo buen pensamiento. Buena idea.
Nkuujo	<font color=ForestGreen><b>deter.poses.:</b></font> Mi plato. Palabra posesiva en Mojeño trinitario.
Nutsareko	<font color=ForestGreen><b>vtr.pres.:</b></font> Estoy zambullendo y nadando.
Nutsarusi	<font color=ForestGreen><b>adj.:</b></font> Soy juguetón. Me gusta jugar.
Nuchku'yórepo	<font color=ForestGreen><b>vtr.afirm.:</b></font> Ya me voya salir.
Nkowo	<font color=ForestGreen><b>vtr.prnl.:</b></font> Me baño. Acción de bañarse.
Nuchku'ripo	<font color=ForestGreen><b>vtr.:</b></font> Ya Salí. Persona que afirma haber salido de una reunion, asamblea, formación Acedémica, de prisión.
Nuchkoripo	<font color=ForestGreen><b>vtr.:</b></font> Ya Salí. Persona que afirma haber salido de un lugar a otro determinado lugar.
Núpasi	<font color=ForestGreen><b>adj.:</b></font> Soy cabelludo. Que tiene mucho cabello.
Nupajiyo'o	<font color=ForestGreen><b>adj.:</b></font> Soy velludo. Que tiene muchos los vellos corporales.
Nanokiko	<font color=ForestGreen><b>vtr.:</b></font> Lo dejaron.  <font color=purple>Ej.</font> <font color=blue>Nanokiko to pkure te kwooku.</font> <font color=purple>/</font> Lo dejaron la canoa en el puerto.
Nanoko	<font color=ForestGreen><b>vtr.obj.direc.:</b></font> Lo pusieron. <font color=purple>/</font> Lo colocaron.
Nanoko	<font color=ForestGreen><b>vtr.obj.direc.:</b></font> Lo designaron. Persona sido designado a otra como autoridad, representante.  <font color=purple>Ej.</font> <font color=blue>Nanoko tparaako ma Kristyan.</font> <font color=purple>/</font> Lo designaron a Cristian como autoridad.
Nowreko	<font color=ForestGreen><b>vintr.:</b></font> Nadó.
Nacharagi	<font color=ForestGreen><b>deter.poses.:</b></font> Su charque. <font color=purple>/</font> Tambien se refiere a la parte de la pierna de una persona (incordiera).
Nanikpo	<font color=ForestGreen><b>vtr.:</b></font> Se lo comieron. Comer algún alimento guardado por otra persona.
Najmirioowo	<font color=ForestGreen><b>n.f.:</b></font> Centro. Prenda de vestir de la mujer que se utiliza anteriormente debajo del vestido o blusa.
Naponreepochu	<font color=ForestGreen><b>n.m.:</b></font> Pensamiento. Capacidad que tienen las personas de formar ideas y representaciones de la realidad.
Nano'okpo	<font color=ForestGreen><b>vtr.:</b></font> Lo aprovecharon. Aprovechar el momento oportuno de cosechar. <font color=purple>/</font> Violar, pegar, chicotear, apalear, maltratar.
Nakochkoyo	<font color=ForestGreen><b>adv.l.:</b></font> Están cerquita.
Narótopo	<font color=ForestGreen><b>vtr.:</b></font> Lo encontraron. Persona que afirma a otro que encontraron a alguien, animal o cosa.
Namuiriocho	<font color=ForestGreen><b>vtr.:</b></font> Lo vistieron. Persona que cubre o adorna el cuerpo de otro con vestidos.
Nakomuii'o	<font color=ForestGreen><b>vtr.pl.:</b></font> Se vistieron.  <font color=purple>Ej.</font> Los deportistas se vistieron de color rojo.
Namimro	<font color=ForestGreen><b>deter.poses.:</b></font> Sus Máscaras.
Nanigiarine	<font color=ForestGreen><b>vtr.interj.:</b></font> ¡Que se lo coman nomás! Persona que autoriza se coman la comida de otro.
Nakootoko	<font color=ForestGreen><b>vtr.:</b></font> Lo agarraron. Lo atraparon.
Nakóyepe	<font color=ForestGreen><b>adj.:</b></font> Fueron sus amantes. Persona que afirma haber tenido amoríos con personas casadas.
Nakóyeno	<font color=ForestGreen><b>vintr.:</b></font> Ellos tuvieron Sexo. Tuvieron unión sexual.
Nachimroko	<font color=ForestGreen><b>adv.mod.:</b></font> Lo pillaron. Persona que sorprende a otra en un acto o situación "in fraganti".
Nachimracho	<font color=ForestGreen><b>vtr.pl.:</b></font> Los visitaron. Personas que visitan a otras.
Nachíneno	<font color=ForestGreen><b>deter.poses.:</b></font> Nuera de ellos.  <font color=purple>Ej.</font> María es la nuera de ellos.
Nakóchane	<font color=ForestGreen><b>vtr.:</b></font> Están con él.
Nuchko	<font color=ForestGreen><b>vtr.:</b></font> Me salí. Persona que se retira de un trabajo o reunión.
Nutyopo	<font color=ForestGreen><b>interj.:</b></font> ¡Ya voy! Persona que indica que va.
Nutsaruriko	<font color=ForestGreen><b>vtr.:</b></font> Juguetear. Persona que se entretiene jugando.
Nuchku'yorepo	<font color=ForestGreen><b>vtr.:</b></font> Voy a salir. Persona que va salir de una reunión, cárcel, estudio, deuda y trabajo.
Nacho'po	<font color=ForestGreen><b>vtr.:</b></font> Lo pelaron. Personas que pelan algo.  <font color=purple>Ej.</font> Pelar un guineo maduro.
Nakojrasamure	<font color=ForestGreen><b>vtr.prnl.pl.:</b></font> Están preocupados. Personas intranquilas.
Najaasamre	<font color=ForestGreen><b>adj.pl.:</b></font> Están pensativos. Personas que meditan intensamente y están distraídos.
Namopachijko	<font color=ForestGreen><b>vtr.pl.:</b></font> Lo arruinaron. Destruir o causar grave daño por un grupo de personas.
Nakajagichpo	<font color=ForestGreen><b>vtr.:</b></font> Lo abrieron. Persona que le abren la pierna al animal para descuerarlo. <font color=purple>/</font> También se utiliza para referirse a la persona en un acto deportivo o sexual.
Nimse	<font color=ForestGreen><b>deter.poses.:</b></font> Mi suegra. Persona que afirma que aquella mujer es su suegra.
Nemnaksare	<font color=ForestGreen><b>deter.poses.:</b></font> Mi amigo.
Néchovi	<font color=ForestGreen><b>n.m.f.:</b></font> Hermano/a mayor. Se refiere al primer hermano de la familia.
Nima	<font color=ForestGreen><b>deter.poses.:</b></font> Mi esposo. Dicho de la mujer para referirse a su marido.
Nimchuko	<font color=ForestGreen><b>deter.poses.:</b></font> Mi suegro. Se utiliza para referirse al padre de su esposo(a).
Nimaruupe	<font color=ForestGreen><b>adj.n.m.f.:</b></font> Primogénito. Dicho por los padres para referirse al primer hijo.
Níso'o	<font color=ForestGreen><b>vtr.:</b></font> Yo carpo. Persona que se pone a carpir.
Nkaseko	<font color=ForestGreen><b>vtr.:</b></font> Yo cazo. Persona que afirma que ha ido de cacería.
Nijroriko	<font color=ForestGreen><b>vtr.:</b></font> Yo vendo. Acción de vender.
Nkomet-si	<font color=ForestGreen><b>vtr.:</b></font> Yo cocino. Persona que realiza la acción de cocinar.
Nkoyeno	<font color=ForestGreen><b>n.m.:</b></font> Tengo relación sexual. Persona que ha tenido relación sexual.
Nkoyeno	<font color=ForestGreen><b>deter.poses.:</b></font> Tengo mujer. Persona que afirma que tiene mujer o esposa.
Nvet'so'i	<font color=ForestGreen><b>adj.n.m.:</b></font> Soy horadador. Persona que hace un agujero o perfora.
Nveporiko	<font color=ForestGreen><b>vtr.:</b></font> Lo descosturé. Persona de descose prenda de vestir.
Nvet-so'iko	<font color=ForestGreen><b>vtr.:</b></font> Lo pinché.
Nvet-sojko	<font color=ForestGreen><b>vtr.:</b></font> Lo perforé. Persona que perfora algo blando como el yomomo, colchón o algo esponjoso.
Nkamisa	<font color=ForestGreen><b>deter.poses.:</b></font> Mi camisa.
Ntevevi	<font color=ForestGreen><b>vtr.:</b></font> Tú debes. Persona que afirma que la otra persona tiene una deuda bancaria o personal.
Ntiwgiene	<font color=ForestGreen><b>adv.num.:</b></font> Primero. Afirmación de una persona que llega o sale de primero de un lugar.  <font color=purple>Ej.</font> Fui el primero en llegar a la fila. <font color=purple>/</font> <font color=blue>Ntiwgiene nitekpoo'i te tapiku.</font>
Ntetu	<font color=ForestGreen><b>deter.poses.:</b></font> Mi quirichí. Prominencia benigna y de pequeño tamaño que sale en la piel y está formada por la dilatación de las papilas vasculares y el endurecimiento de la epidermis que las cubre.
Ntete	<font color=ForestGreen><b>adj.dem.:</b></font> Mi nalga. Parte carnosa y redondeada situada en la parte baja de la espalda del alguien.
Ntitagira	<font color=ForestGreen><b>deter.poses.coloq.:</b></font> Mi chuquito(a). Expresión de adulo o demostración de cariño del padre o madre al hijo(a) pequeño(a).
Nkownora	<font color=ForestGreen><b>deter.poses.:</b></font> Mi Mandado.
Nkowsa	<font color=ForestGreen><b>adv.l.:</b></font> Ahí vivo. Persona nativa de ese lugar por mucho tiempo.
Nkojma	<font color=ForestGreen><b>adj.:</b></font> Estoy enfermo. Persona que afirma que esta mal de salud.
Nkojwo	<font color=ForestGreen><b>vtr.:</b></font> Me colaboró. Persona que colaboró para cumplir un determinado trabajo o tarea.
Nkójora	<font color=ForestGreen><b>adj.:</b></font> Estoy con herida.
Njora	<font color=ForestGreen><b>deter.poses.:</b></font> Mi herida. Persona que afirma que tiene una herida.
Nkómuisi	<font color=ForestGreen><b>prep.deter.poses.:</b></font> Estoy con gorra.
Nkojosi	<font color=ForestGreen><b>prep.deter.poses.:</b></font> Estoy con sombrero.
Nmuisi	<font color=ForestGreen><b>deter.poses.:</b></font> Mi gorra.
Nkoytetu	<font color=ForestGreen><b>vtr.:</b></font> Me tropecé. Persona que pierde el equilibrio por un tropezón.
Nekyoko	<font color=ForestGreen><b>vtr.:</b></font> Yo venero. Sentir y demostrar gran amor y respeto a una cosa o a una persona por su virtud, dignidad, méritos o santidad.
Ntaramo	<font color=ForestGreen><b>adj.:</b></font> Extremo de los labios.
Npórape	<font color=ForestGreen><b>deter.prep.:</b></font> Mi hermano mayor.
Npigi	<font color=ForestGreen><b>deter.poses.:</b></font> Mi tobillo.
Nwoo'o	<font color=ForestGreen><b>vtr.:</b></font> Quiero. Persona que afirma de querer o pretender algo.
Nekyopueggio	<font color=ForestGreen><b>vtr.:</b></font> Me doblé la pierna.  <font color=purple>Ej.</font> Estaba jugando fútbol y me doblé la pierna. <font color=purple>/</font> <font color=blue>Nutsaruu'ini ene nekyopueggiopo.</font>
Nepyusmirucho	<font color=ForestGreen><b>vtr.:</b></font> Me arrodillé en su delante. Arrodillarse delante de una imagen o algo beneficioso.
Nestako	<font color=ForestGreen><b>vtr.:</b></font> Le di guasca. Flagelar, azotar, castigar por algún hecho a otra persona.
Nestareko	<font color=ForestGreen><b>vtr.ger.:</b></font> Estoy huasqueando. Dando azotes a otra persona o como también a un animal.
Nestagie'o	<font color=ForestGreen><b>vtr.:</b></font> Lo huasquée el tallo. Afirmación de una persona cortó el tallo de un árbol.
Netpuejko	<font color=ForestGreen><b>vtr.prnl.:</b></font> Me agacho. Inclinarse, agacharse para evitar chocar algo por delante.
Naetspajko	<font color=ForestGreen><b>vtr.pl.:</b></font> Lo deshicieron. Deshacer o quitar algo la forma a una cosa descomponiéndola.
Nettápueko	<font color=ForestGreen><b>adj.:</b></font> Yo templo algo. Persona templa cuero, cuerda o que clava una estaca.
Nettátako	<font color=ForestGreen><b>vtr.:</b></font> Clavar rápido. Personas que clavan rápido.
Nitne	<font color=ForestGreen><b>deter.poses.:</b></font> Mi sangre. Consanguíneo.
Nitno	<font color=ForestGreen><b>vtr.:</b></font> Se lo terminé. Terminar cosa de otras personas.
Niya	<font color=ForestGreen><b>deter.poses.:</b></font> Mi papá. Dicho de un hijo a su padre.
Niyara'o	<font color=ForestGreen><b>deter.poses.:</b></font> Mi Padrastro.
Nimiijiko	<font color=ForestGreen><b>vtr.:</b></font> Me lo llevo con todo. Adueñarse o llevárselo todo.
Nímoko	<font color=ForestGreen><b>vtr.prnl.:</b></font> Yo duermo. Persona que afirma que está durmiendo.
Ninmomójko	<font color=ForestGreen><b>adj.:</b></font> Fácil de ganarle. Lograr ganar sin dificultad al oponente.
Nimeriko	<font color=ForestGreen><b>vtr.:</b></font> Lo muestro. Persona que expone o muestra algo a la vista señalando para que se vea
Nitpapajkowo	<font color=ForestGreen><b>n.f.interj.:</b></font> ¡Por suerte! Lograr de conseguir algo al azar.  <font color=purple>Ej.</font> Por suerte alguien me prestó dinero. <font color=purple>/</font> <font color=blue>Nitpapajkowo nitkowo meriokore.</font>
Nnippapajiko	<font color=ForestGreen><b>vtr.:</b></font> Lo mastiqué. Persona que mastica chicle, alimento.
Ñañi	<font color=ForestGreen><b>zool.n.f.:</b></font> Garrapatilla. Insecto parásito pequeño de las selvas y pampas.
Ñamri	<font color=ForestGreen><b>adj.dem.:</b></font> Su nieto. 
Ñachi	<font color=ForestGreen><b>adj.:</b></font> Rosado. Color rosa.
Ñachipi	<font color=ForestGreen><b>adj.:</b></font> Rosado. Color de un hilo, soga, liñada o cinta.
Ñapijane	<font color=ForestGreen><b>deter.poses.:</b></font> Su apellido. Dicho de la mujer para referirse al apellido del varón.
Ñena	<font color=ForestGreen><b>vtr.:</b></font> Llamar la atención. Dicho de la mujer para llamar la atención del varón.
Ñichkopeno	<font color=ForestGreen><b>deter.poses.:</b></font> Su ano. 
Ñijgi	<font color=ForestGreen><b>adj.dem.:</b></font> Su cola. Su trasero. 
Ñigia	<font color=ForestGreen><b>deter.demos.:</b></font> Éste.
Ñitko	<font color=ForestGreen><b>adj.:</b></font> Sabe. Mujer que afirma a un hombre que sabe o conoce.
Ñitne	<font color=ForestGreen><b>deter.demos.:</b></font> Su sangre.
'Ñi'u	<font color=ForestGreen><b>n.m.:</b></font> Mosquito. Insecto chupa sangre, de personas y de los animales; la picadura produce molestia y enfermedades mortales.
Ñiye'e	<font color=ForestGreen><b>deter.poses.:</b></font> De él.
Ñiya	<font color=ForestGreen><b>deter.poses.:</b></font> Su papá.
Ñijina	<font color=ForestGreen><b>adv.l.:</b></font> No está. Cuando la mujer habla refiriéndose a un hombre que no está presente.
Ñíjare	<font color=ForestGreen><b>adj.dem.:</b></font> Su nombre. 
Ño'e	<font color=ForestGreen><b>deter.poses.:</b></font> Su diente. 
Ñochko	<font color=ForestGreen><b>adj.dem.:</b></font> Su abuelo. 
Ñósopi	<font color=ForestGreen><b>zool.:</b></font> Ciempiés. Insecto, gusano de muchas patas.
Ñujpankowo	<font color=ForestGreen><b>interj.:</b></font> ¡Por favor! Pedir ayuda, auxilio.
Pim'a	<font color=ForestGreen><b>vtr.imper.:</b></font> ¡Mirá! Mirar, echar un vistazo o dar una mirada.
Pimecha	<font color=ForestGreen><b>vtr.imper.:</b></font> ¡Muéstrele! Mostrar, revelar, expresar lo que uno ha visto o tiene.
Pim'ognenajicha	<font color=ForestGreen><b>n.f.interrog.:</b></font> ¿De verdad lo viste?
Pich'anu	<font color=ForestGreen><b>vtr.imper.:</b></font> ¡Llámame! Llamar, citar, convocar, reunir.
Pichigia	<font color=ForestGreen><b>vtr.interj.:</b></font> ¡Pará! Ordena frenar, detenerse por alguna causa
Pimojna	<font color=ForestGreen><b>vtr.imper.:</b></font> ¡Andá a mirar! Orden a una persona a otra que vaya ver algo.
Pito'aka	<font color=ForestGreen><b>vtr. cond.imper.:</b></font> ¡Tienes que ganarle! Ordena de vencer, dominar en una competencia.
Pikchosgia	<font color=ForestGreen><b>vtr.cond.imper.:</b></font> ¡Tienes que bautizarte! Renacer, nombrarse a través del bautismo religioso.
Pitopona	<font color=ForestGreen><b>vtr.:</b></font> Estirar todo. Orden de una persona a otra de que la pita lo estire todo o termine todo.
Pitvecha	<font color=ForestGreen><b>vtr.imper.:</b></font> ¡Endulza! Ordena darle sabor dulce al refresco u otra bebida.
Pittuj'o	<font color=ForestGreen><b>adj.:</b></font> Eres hechicero. Persona que en algunas culturas hace predicciones, invoca a los espíritus y ejerce prácticas curativas utilizando poderes ocultos y productos naturales.
Pituchapo	<font color=ForestGreen><b>vtr.imper.:</b></font> ¡Termínalo! Orden de realizar un trabajo hasta acabar.
Pitúchapo	<font color=ForestGreen><b>mod.imper.:</b></font> ¡Tienes que casarte! Persona que dictamina a que se case por el matrimonio religioso o civil.
Pimotrugi	<font color=ForestGreen><b>adj.:</b></font> Reconocedor. Persona que fácilmente reconoce a una persona o algo.
Pitiri'i	<font color=ForestGreen><b>pres.indic.:</b></font> ¡Tú has sido!
Pita	<font color=ForestGreen><b>vtr.imper.:</b></font> ¡Termínalo! Orden de una persona hacia otra acabar una actividad.
Pitarine	s.interj.: ¡Ni modo!
Pitekpa	<font color=ForestGreen><b>vtr.:</b></font> Llega. Ordena a una persona que debe llegar a tiempo.
Pitiripo	<font color=ForestGreen><b>vtr.interrog.:</b></font> ¿Es usted?
Pichopa	<font color=ForestGreen><b>vtr.imper.:</b></font> ¡Devolvé! Persona que tiene que devolver algún objeto prestado a su dueño.
Pechorigia	<font color=ForestGreen><b>vintr.imper.:</b></font> ¡Disértalo! Orden de una persona a otra que tiene que dar el discurso en público.
Péchanu	<font color=ForestGreen><b>vintr.imper.:</b></font> ¡Acuérdate! Persona que ordena a otra que debe acordarse de alguien o algo.
Pechapo	<font color=ForestGreen><b>Imper.:</b></font> ¡No te olvides! Insistir en no olvidarse.
Pechpuka	<font color=ForestGreen><b>vtr.imper.:</b></font> ¡Levántate! Persona que ordena a otra levantarse.
Pechemcha	<font color=ForestGreen><b>vtr.imper.:</b></font> ¡Entendé! Persona que insiste que otra comprenda lo hablado.
Pechemra'i	<font color=ForestGreen><b>adj.:</b></font> Eres intelectual. Persona que es inteligente.
¿Perora'i?	<font color=ForestGreen><b>adj.interrog.:</b></font> ¿Eres alcohólico? Pregunta de una persona a otra sobre una adicción negativa.
Peroposgia	<font color=ForestGreen><b>vtr.imper.:</b></font> ¡Dale un sopapo! Orden de dar golpe con las palmas de la mano en la cara de otra.
Pe'rorigia	<font color=ForestGreen><b>n.f.:</b></font> Pelea. Acción de pelear.
Pechemra'chupka	<font color=ForestGreen><b>vtr.interrog.cond.:</b></font> ¿Entendés o no? Interrogación de una persona a otra si asimila o entiende.
Pekyoka	<font color=ForestGreen><b>vtr.prnl.imper.:</b></font> ¡Arrodíllate! persona que ordena que se arrodille otra.
Petyora'i	<font color=ForestGreen><b>adj.:</b></font> Eres celoso. Persona que tiene celos por otra.
Pemnanasko	<font color=ForestGreen><b>adj.:</b></font> Eres loco. Desubicado, persona que no se ubica de lo que expresa.
Pemna'ejru	<font color=ForestGreen><b>n.f.:</b></font> Sin nada. Nombre propio que se le dio al alimento elaborado sin ningún ingrediente para darle un sabor exclusivo.
Pechemchanu	<font color=ForestGreen><b>vtr.imper.:</b></font> ¡Atendeme! Ordena que atienda a lo que habla o explica.
Pemna'oko/a	<font color=ForestGreen><b>n.f.:</b></font> A la suerte <font color=purple>/</font> al tanteo.
¿Pemnako?	<font color=ForestGreen><b>vtr.interrog.:</b></font> ¿Lo amas? Pregunta a otra persona si ama a alguien.
Pémure	<font color=ForestGreen><b>adv.:</b></font> Adrede. Con intensión de causar algo molesto en otra persona.
Pemna'oka/po	<font color=ForestGreen><b>n.f.:</b></font> Por coincidencia. Realizar, hacer, una cosa bien, a conciencia.
Peñuchapo	<font color=ForestGreen><b>vintr.imper.:</b></font> ¡Andá Rezá! Orden espiritual de pedir perdón o misericordia según su credo religioso, rezando.
Peñegiapo	<font color=ForestGreen><b>vtr.imper.:</b></font> ¡Menea tu Cadera!
Pesamijrigia	<font color=ForestGreen><b>n.f.:</b></font> Advertencia. Ten cuidado. Prevenir, informar, notificar o comunicar algo.
¿Peñuchwo?	<font color=ForestGreen><b>vtr.interrog.:</b></font> ¿Estás rezando? Interrogativo a una persona que si esta orando o no.
¿Pepanu?	<font color=ForestGreen><b>interj.:</b></font> ¿Qué miras? Pregunta a una persona a otra sobre la incomoda situación de observación.
Peteregia	<font color=ForestGreen><b>vtr.imper.:</b></font> ¡Saltá! Orden de saltar.
Pettsetsejigia	<font color=ForestGreen><b>vtr.imper.:</b></font> ¡Hacelo rapidito! Realizar una actividad con diligencia por orden de otra persona.
Pesñegia	<font color=ForestGreen><b>vtr.imper.:</b></font> ¡Míralo! Orden de mirar a una persona, animal u objeto.
Peschopa	<font color=ForestGreen><b>vtr.imper.:</b></font> ¡Acéptalo! Aceptar a alguien o algo.
Peschopyo	<font color=ForestGreen><b>vtr.cond.:</b></font> Tienes que estar de acuerdo con la opinión de otra persona.
¿Peschopyo?	<font color=ForestGreen><b>vtr.interrog.:</b></font> ¿Estarás de acuerdo?
Pechpusgia	<font color=ForestGreen><b>vtr.imper.:</b></font> ¡Levantá la cabeza!
Pestigia	<font color=ForestGreen><b>vtr.imper.:</b></font> ¡Córtalo! Orden de cortar algún objeto con cuchillo.
Pengia	<font color=ForestGreen><b>vtr.imper.:</b></font> ¡Dale de comer! Orden de dar de comer a alguien o a un animal.
Pengia	<font color=ForestGreen><b>vtr.imper.:</b></font> ¡Pescá! Orden de una persona a otra para pescar.
¿Penko?	<font color=ForestGreen><b>vtr.ger.interrog.:</b></font> ¿Estás pescando? Pregunta de una persona a otra si está pescando. <font color=purple>/</font> También se utiliza para preguntar si le ha dado de comer a una persona o animal.
¿Penkoripo?	<font color=ForestGreen><b>vtr.interrog.:</b></font> ¿Ya le dio de comer?
¿Penkoripo?	<font color=ForestGreen><b>vtr.interrog.:</b></font> ¿Ya pescaste?
Petarako?	<font color=ForestGreen><b>vtr.afirm.:</b></font> Tienes sed de tomar, beber, de saciarse con alguna bebida.
Pepchoka	<font color=ForestGreen><b>vtr.:</b></font> Botar algo comestible en un lugar determinado.
Pepchopuegia	<font color=ForestGreen><b>vtr.:</b></font> Botar, tirar, Lanzar algo al suelo.
Pestitigigia	<font color=ForestGreen><b>vtr.cond.imper.:</b></font> ¡Tienes que retacear! Cortar, picar trozar por pedazos o retacear.
Pestigia	<font color=ForestGreen><b>vtr.imper.:</b></font> ¡Tienes que cortar! Orden de cortar diferentes objetos o cosas.
Pe'a	<font color=ForestGreen><b>vtr.imper.:</b></font> ¡Pégale! Persona que ordena a pegar a la otra persona.
Pessuka	<font color=ForestGreen><b>vtr.imper.:</b></font> ¡Afilá! Orden de afilar herramientas u otros objetos metálicos.
Peñatsigia	<font color=ForestGreen><b>vtr.imper.:</b></font> ¡Aplástalo! Orden de aplastar un objeto, animal o cosas.
Pemmosgia	<font color=ForestGreen><b>vtr.imper.:</b></font> ¡Tentá su cabeza! Orden de palpar la cabeza de otra persona o animal.
Pemnákanu	<font color=ForestGreen><b>vtr.imper.:</b></font> ¡Ámame! Orden de amar.
Pentévene	<font color=ForestGreen><b>adj.dem.n.f.:</b></font> Tu deuda. persona que tiene deuda pendiente.
Pemtone	<font color=ForestGreen><b>deter.poses.:</b></font> Es tu trabajo. Afirmación de una persona a otra.
Pe'i	<font color=ForestGreen><b>zool.:</b></font> Jochi colorado. Animal silvestre que se alimenta de la calucha del motacú.
Pejwa'i	<font color=ForestGreen><b>adj.:</b></font> Pedorro. Que expele ventosidades del vientre con frecuencia o sin reparo.
Pesmuka	<font color=ForestGreen><b>vtr.imper.:</b></font> ¡Zambullí! Orden para que se sumerja en el agua.
Peti	<font color=ForestGreen><b>n.f.:</b></font> Casa. Lugar de refugio para una familia.
Pe'o	<font color=ForestGreen><b>vtr.interrog.:</b></font> ¿Le pegaste?
Pe'ora'i	<font color=ForestGreen><b>adj.:</b></font> Eres peleador. Califica a una persona de su cualidad de peleador.
Patore	<font color=ForestGreen><b>zool.:</b></font> Marimono. Mono animal silvestre que vive en la selva amazónica.
Paturi	<font color=ForestGreen><b>zool.:</b></font> Tojito pequeño. Ave que imita los cantos, sonidos de otras aves y algunos animales.
Pekyecha	<font color=ForestGreen><b>vtr.imper.:</b></font> ¡Modifícalo! Orden de transformar algún objeto.
Pekyera'i	<font color=ForestGreen><b>adj.:</b></font> Transformador. Persona que posee el don de transformar cosas.
Pepkopewo	<font color=ForestGreen><b>deter.poses.:</b></font> Tú Abarca.
Pepkucha	<font color=ForestGreen><b>vtr.imper.:</b></font> ¡Tápalo! Ordena tapar o cubrir a persona o cosa de algo para protegerlo.
Pjiocha	<font color=ForestGreen><b>vtr.imper.:</b></font> ¡Cerralo! Orden de clausurar, obstruir sellar u obturar.
Pepkómegia	<font color=ForestGreen><b>vtr.imper.:</b></font> ¡Tendé el mantel! Orden de poner y acomodar el mantel en la mesa.
¿Pechjiko?	<font color=ForestGreen><b>vtr.interrog.:</b></font> ¿Hablaste?
Pechjikra'i	<font color=ForestGreen><b>adj.:</b></font> Sos hablador. Afirmación de una persona a otra que es lenguaraz.
Puechora'i	<font color=ForestGreen><b>vtr.imper.:</b></font> ¡Atendé!
Panu	<font color=ForestGreen><b>n.m.:</b></font> Pan. Alimento hecho de harina.
Paku	<font color=ForestGreen><b>zool.:</b></font> Perro. Animal Doméstico.
Pakrara	<font color=ForestGreen><b>zool.:</b></font> Taitetú.  Animal silvestre. Su carne es comestible.
Pakyumtu	<font color=ForestGreen><b>vintr.imper.:</b></font> ¡Hacéte inyectar! Orden de una persona a otra de que se haga inyectar con una jeriga
Paksip'agi	<font color=ForestGreen><b>vtr.prnl.imper.:</b></font> ¡Lávate tu testículo!
Pakchunsiji	<font color=ForestGreen><b>vtr.imper.:</b></font> ¡Ponte Cabecera!
Paksukre	<font color=ForestGreen><b>vtr.imper.:</b></font> ¡Sembrá! Persona que ordena que siembre.
Paksipugi	<font color=ForestGreen><b>vtr.imper.:</b></font> ¡Lávate la cara!
Pakesane	<font color=ForestGreen><b>cond.:</b></font> Tienes que hacer para tu chaco.
¿Pakmumpuka?	<font color=ForestGreen><b>cond.interrog.:</b></font> ¿Será que lo vas a necesitar?
Pakchicha	<font color=ForestGreen><b>adj.interj.:</b></font> ¡Pobre perro! Expresión de pena por un perro.
Pakchicha	<font color=ForestGreen><b>cond.imper.:</b></font> ¡Tienes que tener hijo!
Pakgira	<font color=ForestGreen><b>n.m.dim.:</b></font> Perrito.
Pakjítoru	<font color=ForestGreen><b>vtr.imper.:</b></font> ¡Tenés que chapapear! Carne, pescado asado a fuego.
Pjito'a	<font color=ForestGreen><b>vtr.imper.:</b></font> ¡Cocé! Cocer De manera lenta y con cuidado la carne o pescado.
Pakojtoru	<font color=ForestGreen><b>vtr.imper.:</b></font> ¡Tienes que asar! Cocer porciones de carne o pescado.
Pasamóra'i	<font color=ForestGreen><b>vtr.imper.:</b></font> ¡Tienes que estar atento! Dar advertencia.
Punu	<font color=ForestGreen><b>n.f.:</b></font> Campana. Instrumento de metal en forma de copa invertida que suena al golpearlo.
Puchu	<font color=ForestGreen><b>n.m.:</b></font> Charuto. Resto del cigarro de tabaco.
Puchugi	<font color=ForestGreen><b>adj.:</b></font> Ciego. Persona no vidente.
Puti	<font color=ForestGreen><b>zool.:</b></font> Avispa. Insecto que elabora celdas de prisión de barro, para encerrar a su presa. (Nombre común camoatí).
Puutuna	<font color=ForestGreen><b>bot.:</b></font> Fortuna. Planta de mediana altura que sirve para medicina natural.
Puugieru	<font color=ForestGreen><b>bot.:</b></font> Maíz. Grano blando de color amarillo.
Pújogi	<font color=ForestGreen><b>zool.:</b></font> Yayú. Pez que vive en lugares pantanosos de la Amazonia.
Pimkugi	<font color=ForestGreen><b>adj.:</b></font> Eres dormilón.
Pitsmerigia	<font color=ForestGreen><b>vtr.imper.:</b></font> ¡Tejé! Orden de elaborar un tejido.
Pitse	<font color=ForestGreen><b>zool.:</b></font> Colibrí, picaflor. Ave silvestre, pequeña que habita en las selvas y pampas.
Pusi	<font color=ForestGreen><b>zool.:</b></font> Turiro. Termita, insecto que perfora y se alimenta de madera.
Po'e	<font color=ForestGreen><b>zool.:</b></font> Perezoso. Nombre común de una especie de mamífero lento.
'Pona	<font color=ForestGreen><b>deter.:</b></font> Otro. Uno más. Necesito otro, que pase otro.
Pkowsa	<font color=ForestGreen><b>adj.dem.:</b></font> Tu pueblo. Demuestra el lugar de procedencia natal.
Pnoka	<font color=ForestGreen><b>vtr.imper.:</b></font> ¡Ponelo! Orden de colocar un objeto en un sitio o lugar.
Pyukorocha	<font color=ForestGreen><b>vtr.imper.:</b></font> ¡Añadilo! persona que ordena agregar o incorporar una cosa con la otra.
Pokopewo	<font color=ForestGreen><b>n.f.:</b></font> Abarca. Calzado de cuero que cubre solo la planta de los pies.
'Po'cha	<font color=ForestGreen><b>vtr.imper.:</b></font> ¡Guíate! Guiarse en el monte por el ruido o un sonido
Powre	<font color=ForestGreen><b>adj.:</b></font> Pobre. Persona de escaso recurso económico.
Powrocho	<font color=ForestGreen><b>anat.:</b></font> Paleta. Omóplatos.
Pyog'e	<font color=ForestGreen><b>adj.dem.:</b></font> Tu cuerpo.
'Poy'e	<font color=ForestGreen><b>adj.:</b></font> Ajeno. Animal, objeto que pertenece a otra persona.
Poymo	<font color=ForestGreen><b>zool.:</b></font> Chulupi. Cucaracha, insecto de cuerpo aplanado negruzco.
'Popaku	<font color=ForestGreen><b>zool.:</b></font> Perro silvestre. Anmal salvaje de las selvas y pampas de la Amazonía.
Pocho'o	<font color=ForestGreen><b>adj.:</b></font> Que tiene lunar. Persona, animal que tiene lunar.
'Pochkoyo	<font color=ForestGreen><b>deter.:</b></font> Otro lado. Que está del otro lado.
Pochpo	<font color=ForestGreen><b>adj.:</b></font> Acabado, perfecto, consumado, terminado.
Pochripo	<font color=ForestGreen><b>adj.:</b></font> Terminado. Poner término a una cosa.  <font color=purple>Ej:</font> ¡Por fin termine mi trabajo!
Pócheko	<font color=ForestGreen><b>vtr.:</b></font> Orrillear. Esquivar un obstáculo o dificultad.
Pitoku'o	<font color=ForestGreen><b>vtr.:</b></font> Lo acabaste. Se lo acabó.
Pitoku'a	<font color=ForestGreen><b>vtr.imper.:</b></font> ¡Tienes que terminalo! Orden de terminar o acabar algo.
Pimsama	<font color=ForestGreen><b>vtr.imper.:</b></font> ¡Hacelo escuchar! Persona que ordena a darle la información. O hacer probar algún alimento o bebida.
Pimsamuigia	<font color=ForestGreen><b>v.mod.cond.:</b></font> Tienes que ofrecer. Orden de ofrecer algún objeto a.
Pijrorigia	<font color=ForestGreen><b>v. mod.cond.:</b></font> Tienes que vender. Persona que ordena vender.
Pimyunoka / pimyuujecha	<font color=ForestGreen><b>vtr.imper.:</b></font> ¡Hacelo enojar! Orden de hacer molestar a otra persona.
Pijroka	<font color=ForestGreen><b>mod.cond.:</b></font> Tienes que darle. De dar, otorgar.
Pcheyo	<font color=ForestGreen><b>adj.dem.:</b></font> Tu labio. Señala su labio.
Pchaku	<font color=ForestGreen><b>pron.dem.:</b></font> Tu mosquitero. Que el objeto le pertenece.
Pkute	<font color=ForestGreen><b>pron.dem.:</b></font> Tu corva. Le indica la parte posterior de la rodilla del cuerpo humano.
Pchapo	<font color=ForestGreen><b>v.mod.cond.:</b></font> Tienes que volver. Condiciona a regresar al sitio o lugar.
Ptsuka	<font color=ForestGreen><b>v.mod.cond.:</b></font> Tienes que besarlo. Condiciona a besar o tocar a alguien con los labios en señal de saludo, cariño.
Pyoyuchapo	<font color=ForestGreen><b>v.mod.cond.:</b></font> Tienes que apurarte.
Pyooyoyojiko	<font color=ForestGreen><b>vtr.interrog.:</b></font> ¿Estás temblando?
Pchumka	<font color=ForestGreen><b>v.mod.cond.:</b></font> Tienes que colgarlo.
¿Pchimpo?	<font color=ForestGreen><b>vtr.interrog.:</b></font> ¿Lo encontraste?
Pchumnuka	<font color=ForestGreen><b>v.mod.cond.:</b></font> Tienes que ahorcarlo.
Pchuuka	<font color=ForestGreen><b>v.mod.cond.:</b></font> Tienes que jalarlo.
Pchuupuegia	<font color=ForestGreen><b>v.mod.cond.:</b></font> Tienes que arrastrarlo. Orden de arrastrar canoa, palo, etc
Pchuurigia	<font color=ForestGreen><b>v.mod.cond.:</b></font> Tienes que arrastrarlo.
Pchun'aka	<font color=ForestGreen><b>v.mod.cond.:</b></font> Tienes que sancochar. Orden de sancochar huevo.
Pchunoka	<font color=ForestGreen><b>v.mod.cond.:</b></font> Tienes que sancocharlo. Orden de sancochar alimentos.
Pchumtetegia	<font color=ForestGreen><b>vtr.imper.:</b></font> ¡Llévalo a la fuerza!
Pchúmocha	<font color=ForestGreen><b>v.mod.cond.:</b></font> Tienes que poner el toco debajo de algo.
Pchuncha	<font color=ForestGreen><b>v.mod.cond.:</b></font> Tienes que acuñarlo.
Pyoserigia	<font color=ForestGreen><b>v.mod.cond.:</b></font> Tienes que preguntarle.
Pyosserigia	<font color=ForestGreen><b>v.mod.cond.:</b></font> Tienes que pedir.
Pyosiuchanu	<font color=ForestGreen><b>v.mod.cond.:</b></font> Tienes que orar por mí.
Pyekna	<font color=ForestGreen><b>adj.dem.:</b></font> Es tu parte.
Pye'e	<font color=ForestGreen><b>adj.poses.:</b></font> Es tuyo.
Pyana	<font color=ForestGreen><b>v.mod.cond.:</b></font> Tienes que ir.
Pyutajgia	<font color=ForestGreen><b>v.mod.cond.:</b></font> Tienes que huir, escapar.
Pchuksigianu	<font color=ForestGreen><b>v.mod.cond.:</b></font> Tienes que peluquearme o cortarme el cabello.
Pchuksiko	<font color=ForestGreen><b>vtr.interrog.ger.:</b></font> ¿Lo estás peluqueando?
Pchuksiriko	<font color=ForestGreen><b>vtr.interrog.:</b></font> ¿Está peluqueando?
Pyunaregia	<font color=ForestGreen><b>vtr.imper.:</b></font> ¡Ponte a guardar tus cosas!
Pyunaka	<font color=ForestGreen><b>vtr.imper.:</b></font> ¡Guárdalo! 
Pyuwaragia	<font color=ForestGreen><b>adj.poses.:</b></font> Tu manija. 
Pimaruupe	<font color=ForestGreen><b>adj.dem.:</b></font> Tu primogénito.
Ramón	<font color=ForestGreen><b>n.:</b></font> Ramón. Nombre de persona.
'Rekropa	<font color=ForestGreen><b>n.m.:</b></font> Rayador. Utensilio que se utiliza para rayar algún alimento.
'Rajru	<font color=ForestGreen><b>adj.:</b></font> Nuevo. Objeto o cosa que están nueva
Rawriyu	<font color=ForestGreen><b>n.m.:</b></font> Ladrillo. Material de construcción hecho de barro cocido. 
Rateena	<font color=ForestGreen><b>n.m.:</b></font> Farol. Utensilio para alumbrar las calles que consiste en una luz eléctrica.
Rata	<font color=ForestGreen><b>n.f.:</b></font> Lata. envase de plástico, aluminio o metal.
'Raetona	<font color=ForestGreen><b>adj.:</b></font> Joven. Persona que esta en la etapa de la juventud.
'Repo	<font color=ForestGreen><b>n.f.:</b></font> Tutuma. Fruto de la planta del tutumo, del que se elabora como recipiente.
Rimateesia	<font color=ForestGreen><b>bot.:</b></font> Lima. Fruta cítrica comestible.
'Rimeji	<font color=ForestGreen><b>n.f.:</b></font> Basura. Conjunto de desperdicios, barreduras, materiales etc., que se desechan.
Rimo	<font color=ForestGreen><b>bot.:</b></font> Limón. Fruta cítrica que sirve para sazonar la comida.
Romana	<font color=ForestGreen><b>n.f.:</b></font> Romana. Máquina que sirve para pesar cosas.
Ropo	<font color=ForestGreen><b>zool.:</b></font> Guaso. Venado que vive en la selva.
Roktoru	<font color=ForestGreen><b>adj. n.m.:</b></font> Médico. Persona que tiene la autorización académica y legal para ejercer la medicina.
Rókosi	<font color=ForestGreen><b>zool.:</b></font> Carcoma. Insecto que se utiliza para adornar el plumaje del machetero.
Rusrupaya	<font color=ForestGreen><b>n.f.:</b></font> Gracias. Expresión que se usa para agradecer algo a una persona.
'Rumo	<font color=ForestGreen><b>zool.:</b></font> Palometa. Pez de agua dulce.
'Rukre	<font color=ForestGreen><b>zool.:</b></font> Melero. Animal silvestre de la selva.
'Ruusi	<font color=ForestGreen><b>zool.:</b></font> Peto abeja. Insecto de la familia de la abeja.
Rukresia	<font color=ForestGreen><b>n.f.:</b></font> Lucresia. Nombre de persona femenina.
Rúnesi	<font color=ForestGreen><b>n.m.:</b></font> Lunes. Primer día de la semana
Sache	<font color=ForestGreen><b>n.m.:</b></font> Día. Parte del día en que dura la claridad del Sol.
Saniya	<font color=ForestGreen><b>bot.:</b></font> Fruta de la planta de la sandía.
Sáwaru	<font color=ForestGreen><b>n.f.:</b></font> Sábado. Sexto día de la semana.
'Saype	<font color=ForestGreen><b>n.m.:</b></font> Machete. Herramienta que se utiliza para limpieza.
Sapu	<font color=ForestGreen><b>zool.:</b></font> Sapo. Anfibio similar a la rana de mayor tamaño.
Sapíjane	<font color=ForestGreen><b>n.m.adj.dem.:</b></font> Su Apellido.
'Santi	<font color=ForestGreen><b>n.m.:</b></font> Chaco. Espacio donde se produce los alimentos agrícolas.
Sachono	<font color=ForestGreen><b>deter.:</b></font> Varios días. Conjunto de días durante el mes o año.
Sáchemojo	<font color=ForestGreen><b>n.p.:</b></font> Sol del Gran Mojos.
Sachemo	<font color=ForestGreen><b>bot.:</b></font> Ají sol. Ají muy picante.
Semu	<font color=ForestGreen><b>zool.:</b></font> Jahusi. Reptil pequeño de colores tornasoles que vive en la tierra.
'Seno	<font color=ForestGreen><b>n.f.:</b></font> Mujer. Persona de sexo femenino
Sipu	<font color=ForestGreen><b>zool.:</b></font> Tortuga. Animal silvestre del monte con caparazón.
Sirinka	<font color=ForestGreen><b>n.m.:</b></font> Onda. Arma hecha con dos correas que sirve para lanzar piedras.
'Siipo'e	<font color=ForestGreen><b>zool.:</b></font> Oso hormiguero. Animal silvestre que se alimenta de hormiga.
Sipa	<font color=ForestGreen><b>zool.:</b></font> Piyu. Avestruz. Ave que es corredora de pata larga.
Siya	<font color=ForestGreen><b>n.f.:</b></font> Silla. Asiento individual con patas y respaldo.
Siri	<font color=ForestGreen><b>anat.:</b></font> Nariz. Parte saliente del rostro humano situada entre los ojos y la boca, con dos orificios en la parte inferior y que sirve para respirar y oler.
'Sigieru	<font color=ForestGreen><b>zool.:</b></font> Tiluchi. Ave de color Marrón que elabora su nido de barro.
Súteji	<font color=ForestGreen><b>adj.:</b></font> Incapaz. Persona inútil de realizar un mandato o actividad.
Sivigira	<font color=ForestGreen><b>zool.:</b></font> Chaisita. Paloma pequeña.
Sye'e	<font color=ForestGreen><b>adj.dem.:</b></font> Es de ella. Objeto que corresponde a ella.
Sose	<font color=ForestGreen><b>zool.:</b></font> Cangrejo, seboro. Crustáceo de río.
Sóñore	<font color=ForestGreen><b>zool.:</b></font> Gato montés. Felino silvestre.
Sórare	<font color=ForestGreen><b>zool.n.p.:</b></font> Animal. Se utiliza para referirnos a cualquier animal.
Saware	<font color=ForestGreen><b>n.m.:</b></font> Tabaco. Hoja de esta planta que, curada y preparada, se fuma, se masca o se aspira en forma de rapé.
Sochko	<font color=ForestGreen><b>adj. dem.:</b></font> Su abuelo.
Smoru	<font color=ForestGreen><b>zool.:</b></font> Chancho, cerdo.
'So'i	<font color=ForestGreen><b>zool.:</b></font> Pato macho. Pato doméstico y silvestre.
Spatu	<font color=ForestGreen><b>n.m.:</b></font> Zapato.
Spugi	<font color=ForestGreen><b>zool.:</b></font> Sucha. Ave carroñera.
Smatu	<font color=ForestGreen><b>zool.:</b></font> Sama. Especie de araña de tamaño normal.
Spuire	<font color=ForestGreen><b>zool.:</b></font> Pacú. Pez de agua dulce.
Stovere	<font color=ForestGreen><b>bot.:</b></font> Chonta. Fruto de la palmera propia de la selva.
Smopre	<font color=ForestGreen><b>bot.:</b></font> Kutuqui. Planta de olor rechinante que se utiliza como medicina natural.
Spupkure	<font color=ForestGreen><b>zool.:</b></font> Aurora. Ave que recibe ese nombre.
Samo	<font color=ForestGreen><b>zool.:</b></font> Anta, tapir. Animal silvestre que vive en la selva.
Srugrecho	<font color=ForestGreen><b>n.m.:</b></font> Tiesto. Utensilio de barro o metal que utiliza para tostar.
Srupa	<font color=ForestGreen><b>adj.:</b></font> Tostado. Alimento tostado de la carne de pescado o Como también de harina.
Skureko	<font color=ForestGreen><b>n.f.adj.:</b></font> Sembradío. Que está destinado al sembrado.
Samri	<font color=ForestGreen><b>pron.dem.:</b></font> Su nieto.
Sitgiiri	<font color=ForestGreen><b>zool.:</b></font> Especie de Martín pescador. Ave silvestre que habita en las orillas de los ríos.
Schakra	<font color=ForestGreen><b>zool.:</b></font> Martín pescador. Ave silvestre que se alimenta de peces.
Schokre	<font color=ForestGreen><b>zool.:</b></font> Cuervo víbora. Tipo de ave silvestre que se alimenta de peces
taato'okore	<font color=ForestGreen><b>adj.:</b></font> Indomable. Que no se le puede dominar o domar.
Taem'i	<font color=ForestGreen><b>adj.dem.:</b></font> Su color. Afirmar el color de algo.
Tem'o	<font color=ForestGreen><b>adj.:</b></font> Apagado. Electrodoméstico, fuego, foco, mechero, vela que está apagado
Teyjoko	<font color=ForestGreen><b>vtr.:</b></font> Lo mueve. Mover con una máquina algún objeto de gran tamaño o pesado.
Tenrove	<font color=ForestGreen><b>adj.dem.:</b></font> Su anzuelo. Cuando el anzuelo corresponde a la liñada.
Tete'u	<font color=ForestGreen><b>zool.:</b></font> Leque. Ave comúnmente de la pampa.
Techokore	<font color=ForestGreen><b>n.m.:</b></font> Aviso. Mensaje o comunicado de lo que se puede recordar, pasado, presente.
Taechemra'i	<font color=ForestGreen><b>vtr.:</b></font> Entendido. Persona o animal que entiende o capta.
Techomji	<font color=ForestGreen><b>vtr.prnl.:</b></font> Se preocupa. Animal que tiene pena por su cría, o por volver a su lugar de origen.
Temoti	<font color=ForestGreen><b>vtr.afirm.:</b></font> Manera de un animal en reconocer a su amo.
T-samra'i	<font color=ForestGreen><b>vtr.:</b></font> Escucha. Techora'i.
T-samrogño	<font color=ForestGreen><b>adj.:</b></font> Escuchador. Persona que tiene buen oído para escuchar algún sonido, voz.
Téchosi	<font color=ForestGreen><b>pron.indef.:</b></font> Algo que destinado para una actividad especial.
Tepyako	<font color=ForestGreen><b>n.m.:</b></font> Construcción hecha de animales. Nidos. Cuevas.
Takejworichu	<font color=ForestGreen><b>adj.:</b></font> El único. Se utiliza para referirnos a que una persona va llevar solo a un animal o cosa en especial.
Tamutu	<font color=ForestGreen><b>deter.pron.indef.:</b></font> Todo. Se refiere para afirmar o preguntar si los animales u objetos están todos en un mismo lugar.
Tejamikpo	<font color=ForestGreen><b>vtr.prnl.:</b></font> Se despertó. Para afirmar que el animal se ha despertado.
Tamíro'u	<font color=ForestGreen><b>adj.dem.:</b></font> Su patio.
Tíjroknu	<font color=ForestGreen><b>vtr.:</b></font> Me lo dio. 
Tijru'o	<font color=ForestGreen><b>vtr.prnl.:</b></font> Le hace calor.
T-yosse'i	<font color=ForestGreen><b>adj.:</b></font> Limosnero. Persona que pide limosna.
Tkimotyorakore	<font color=ForestGreen><b>n.m.:</b></font> Reloj. Objeto que sirve para medir el tiempo, indicador de horas, minutos y segundos.
Teprekwo	<font color=ForestGreen><b>vtr.:</b></font> Se derramó. Referido a la semilla que se demarró sobre el campo.
Tejwóro'i	<font color=ForestGreen><b>adj.:</b></font> Está flaco. Afirmación sobre una persona que perdió peso por alguna enfermedad o que tiene contextura delgada.
Tijre'i	<font color=ForestGreen><b>adj.:</b></font> Está caliente. Afirmación sobre un objeto redondo, fruta, caldera caliente.
Tíjru'i	<font color=ForestGreen><b>n.m.:</b></font> Calor. Energía que se manifiesta por un aumento de temperatura.
Tijrumo	<font color=ForestGreen><b>adj.:</b></font> Caliente. Mesa, silla que está caliente.
Taejeko	<font color=ForestGreen><b>vtr.:</b></font> Lo erró. Animal que por su bravura le falló con el asta o ataque a una persona.
Tepjapueko	<font color=ForestGreen><b>vtr.:</b></font> Se partió. Afirmación de que la tierra o piso se dividió.
Tu'eji	<font color=ForestGreen><b>n.f.:</b></font> Masa de yuca que le falta fermentar.
Tu'esi	<font color=ForestGreen><b>adj.:</b></font> Persona que por su característica no sabe escuchar.
'Tummeji	<font color=ForestGreen><b>adj.:</b></font> Valiente. Persona o animal que actúa con valor.
Tummako	<font color=ForestGreen><b>n.m.:</b></font> Frío. Temperatura: Clima está frío.
Tume	<font color=ForestGreen><b>adj.:</b></font> Fuerzudo. Persona que tiene mucha fuerza.
'Tumesi	<font color=ForestGreen><b>n.f.:</b></font> Canoa, gaveta, tutuma de tamaño grande.
Timitriko	<font color=ForestGreen><b>n.f.m.:</b></font> Que  enseña. Persona que transmite enseñanza.
Tatúmewo	<font color=ForestGreen><b>n.m.:</b></font> Fuerza. Fuerza o energía de una maquinaria o animal.
T-siko	<font color=ForestGreen><b>vintr.:</b></font> Silba. Persona o animal que emite un silbido.
T-siso	<font color=ForestGreen><b>n.m.:</b></font> Color negro.
T-soko	<font color=ForestGreen><b>vtr.prnl.:</b></font> Se defecó.
T-semo	<font color=ForestGreen><b>vtr.prnl.:</b></font> Se  enojó. Persona, animal o ave que se enoja.
T-seseko	<font color=ForestGreen><b>zool.:</b></font> Ave silvestre nocturna que vive en la selva.
Tichiko	<font color=ForestGreen><b>vintr.:</b></font> Se detuvo. Exclusivo: para animal que se para o detiene por algún peligro o ruido, también cuando el avión aterriza.
Tsatsagi	<font color=ForestGreen><b>bot.:</b></font> Bibosi. Árbol de la selva que crece en la parte baja especialmente en la orilla de los ríos.
Tsaru	<font color=ForestGreen><b>zool.:</b></font> Comadreja. Animal nocturno marsupial de la familia de los roedores.
Tseru	<font color=ForestGreen><b>zool.:</b></font> Gallareta. Ave de color rojiso de patas largas que habita en los lugares pantanosos.
Titoriko	<font color=ForestGreen><b>adj.:</b></font> Está vivo/viva. Animal, planta o persona que tiene vida o existe.
Taejroko	<font color=ForestGreen><b>vtr.afirm.:</b></font> Da afirmación de que un animal o ave le da de comer o amamantar.
Tijrokra'i	<font color=ForestGreen><b>vtr.:</b></font> Le gusta dar. Le Agrada compartir.
Tisera'i	<font color=ForestGreen><b>adj.:</b></font> Destructor. Persona o animal que le gusta destruir.
Tsigi	<font color=ForestGreen><b>zool.:</b></font> Chichilo. Mono pequeño salvaje de color amarillento.
Tsima	<font color=ForestGreen><b>n.f.:</b></font> Lejía. Líquido extraído de la ceniza de la cáscara de plátano o del árbol etc.
Tsimakure	<font color=ForestGreen><b>adj.:</b></font> Orinón. Persona que por una enfermedad o mala costumbre micciona a cada rato.
T-sókra'i	<font color=ForestGreen><b>adj.:</b></font> Cagón. Persona que defeca a cada rato.
T-yakaeru	<font color=ForestGreen><b>adj.:</b></font> Sin sabor. Comida o bebida que está sin gusto.
Tayeno	<font color=ForestGreen><b>adj.dem.:</b></font> Su hembra.
Taereno	<font color=ForestGreen><b>adj.dem.:</b></font> Su garganta (tragadero).
Taruuno	<font color=ForestGreen><b>bot.:</b></font> Patujú. Flor de planta silvestre que vive en lugares húmedos.
Tito'a	<font color=ForestGreen><b>vtr.:</b></font> Perdió. Persona que pierde algún juego o competencia.
Titopéraji	<font color=ForestGreen><b>n.m.anat.:</b></font> Esqueleto. Hueso de personas, animales. Vertebrados.
Titopa'i	<font color=ForestGreen><b>prep.:</b></font> Sin hierva. Espacio descubierto que no tiene hierva.
Títowo	<font color=ForestGreen><b>vtr.:</b></font> Se acabó. Afirmación de que un trabajo, comida o actividad se ha terminado.
Tittuj'o	<font color=ForestGreen><b>n.m.:</b></font> Mago. Persona que tiene poderes ocultos.
Tichekosi	<font color=ForestGreen><b>adj.:</b></font> Pelopincho. Persona que tiene el cabello parado.
Tinko	<font color=ForestGreen><b>adj.:</b></font> Lleno. Recipiente o vasija que está llena.
Tinkopo	<font color=ForestGreen><b>vtr.:</b></font> Ya se llenó. Afirmación de que un recipiente, carretón o vasija esta completamente lleno.
Tjaraku	<font color=ForestGreen><b>adj.:</b></font> Claridad. Ambiente que esta iluminado o que tiene visibilidad.
Tjara'i	<font color=ForestGreen><b>v.impers.:</b></font> Amaneció. Afirmación que comienza un nuevo día.
Tjopu	<font color=ForestGreen><b>adj.:</b></font> Color Blanco.
Tjopuna	<font color=ForestGreen><b>adj.:</b></font> Blanco. Persona que tiene la tez o piel blanca.
Tjarakupo	<font color=ForestGreen><b>v.impers.:</b></font> Está amaneciendo.
Timora'i	<font color=ForestGreen><b>vtr.:</b></font> Está mirando. Afirmación de que esta mirando algún evento o actividad. <font color=purple>/</font> Persona que es mirón.
Taechcharako	<font color=ForestGreen><b>n.m.:</b></font> Rayo. Descarga eléctrica entre dos nubes cargada de electricidad estática.
T-semoyogi	<font color=ForestGreen><b>n.f.:</b></font> Erección. Aumento del volumen y la rigidez de un órgano del cuerpo (como el clítoris, los pezones, especialmente, el pene).
Taepcharakono	<font color=ForestGreen><b>vintr.afirm.:</b></font> Quebraron los huevos. Afirmación de que las crías de los ovíparos salieron del cascaron.
Taepchako	<font color=ForestGreen><b>vintr.:</b></font> Quebró Sing. Taepcharakono.
Takomjicho	<font color=ForestGreen><b>vtr.:</b></font> Lo abrigó. Afirmación de que un animal o ave cubre o abriga a sus crías.
Takoyeno	<font color=ForestGreen><b>n.m.:</b></font> Apareamiento. Acción de aparear o aparearse un macho y una hembra.
Takomesegnérawo	<font color=ForestGreen><b>adj.:</b></font> Insistente. Acción de insistir del animal hasta conseguir lo que quiere.
Tkojmoru	<font color=ForestGreen><b>vtr.:</b></font> Está asando. Acción de una persona cuando esta asando carne, pecado.
Tkomnukre	<font color=ForestGreen><b>adv.:</b></font> Que es necesario. Por necesidad o por obligación.
Tkotsiomo	<font color=ForestGreen><b>adj.:</b></font> Fermentado. Bebida que esta fermentado.  <font color=purple>Ej.</font> La chicha, guarapo, chapunato que se elabora y consume dentro los Mojeños Trinitarios.
Tkoti	<font color=ForestGreen><b>n.f.:</b></font> Dolencia. Persona que afirma que esta con alguna dolencia. <font color=purple>/</font> También se utiliza para referirse al ají que esta picante.
Tneriko	<font color=ForestGreen><b>vtr.:</b></font> Leñear. Persona que va a recolectar o cortar leña.
To'i	<font color=ForestGreen><b>n.:</b></font> Fruta. Fruta de algún árbol.
Tko'u	<font color=ForestGreen><b>adj.:</b></font> Rancio. Que con el tiempo toma un sabor y olor más fuertes mejorándose o echándose a perder.
Tkoj'u	<font color=ForestGreen><b>bot.vtr.:</b></font> Florece. Afirmación que un árbol está con flores.
Tko'i	<font color=ForestGreen><b>n.f.:</b></font> Tiene fruta. Afirmación que un árbol tiene fruta.
Tvíchemo	<font color=ForestGreen><b>adj.:</b></font> Arrugado.
Tyamo	<font color=ForestGreen><b>adj.:</b></font> Inflamado. Persona que presenta absceso por algún golpe o enfermedad.
Tyoro	<font color=ForestGreen><b>adj.:</b></font> Vuela. Afirmación de que un objeto o ave esta volando.
Tyomera'i	<font color=ForestGreen><b>adj.:</b></font> Ladrón. Persona que hurta lo que no es suyo.
Tyumo	<font color=ForestGreen><b>adj.:</b></font> Largo. Que tiene más extensión en una de las dimensiones del plano que en otra.
Tyuusamre	<font color=ForestGreen><b>adj.:</b></font> Está contento. Estado de ánimo de una persona, animal.
Tyuri	<font color=ForestGreen><b>adv.:</b></font> Bien. Afirmativo para decir que un trabajo o hecho está bien.
Tyuunanaji	<font color=ForestGreen><b>adj.:</b></font> Bonito(a). Que tiene belleza o atractivo y resulta agradable de contemplar o de escuchar
Tyuunisi	<font color=ForestGreen><b>adj.:</b></font> Delicioso. Afirmación de que la comida, fruta que esta sabroso.
Tyuupi	<font color=ForestGreen><b>adj.:</b></font> Bonito. Exclusivamente para: una canción, conversación, discurso esta bonito o interesante.
Tyuuko	<font color=ForestGreen><b>adj.:</b></font> Come siripi. Persona que le gusta comer el siripi.
Tyutagrigi	<font color=ForestGreen><b>n.f.adj.:</b></font> Flecha larga. Herramienta de caza y pesca propia de los pueblos originarios.
Tyupa	<font color=ForestGreen><b>n.f.adj.:</b></font> Aguja larga. Herramienta de costura.
Tyugi	<font color=ForestGreen><b>bot.adj.:</b></font> Árbol de tallo largo.
T-yono	<font color=ForestGreen><b>vtr.afirm.:</b></font> Se va. Afirmación de una persona que alguien se está yendo.
T-yere	<font color=ForestGreen><b>vtr.:</b></font> Se tarda. Persona que tarda mucho. <font color=purple>/</font> También se utiliza para referirse cuando tarda mucho tiempo.
T-yuukóra'i	<font color=ForestGreen><b>adj.:</b></font> Dañino. Persona o animal perjudicial.
T-yuukonu	<font color=ForestGreen><b>vtr.:</b></font> Me hace enojar. Persona que me hace poner molesto.
Tyowreko	<font color=ForestGreen><b>vtr.:</b></font> Que nada. Persona o animal que esta nadando.
Tapikura'i	<font color=ForestGreen><b>adj.n.:</b></font> Sinvergüenza. Persona o animal.
'Tsaysi	<font color=ForestGreen><b>zool.:</b></font> Hormiga cazadora. Especie de hormiga que presenta su tenaza que es su medio de defensa.
Tsuype	<font color=ForestGreen><b>zool.:</b></font> Concha. Tipo de molusco que se encuentra en la orilla de los ríos. Caracoles.
T-semo	<font color=ForestGreen><b>vtr.:</b></font> Se enojó. Persona, animal que presenta una actitud de enojo y de agresividad.
Tit-yara	<font color=ForestGreen><b>zool.:</b></font> Pez Dorado. Alimento cocido a fuego lento.
Tñoro	<font color=ForestGreen><b>adj.:</b></font> Abizcochado. Alimento cocido al horno.
Vewtsuka	<font color=ForestGreen><b>vtr.imper.:</b></font> ¡Botémoslo! Se refiere a la acción de echar o botar a una persona, animal o cosa por alguna circunstancia.
Vensi'yore	<font color=ForestGreen><b>prep.interrog.:</b></font> ¿Dónde pescaremos? Pregunta del lugar donde se va pescar. <font color=purple>/</font> También se refiere al lugar donde se va dar de comer.
Vkeegia	<font color=ForestGreen><b>vtr.imper.:</b></font> ¡Ahóguemoslo! Persona que incita a ahogar a otra persona.
Veesareko	<font color=ForestGreen><b>vtr.:</b></font> Estamos enlazando.
Vépena	<font color=ForestGreen><b>vintr.prnl.imper.:</b></font> ¡Murámosnos!
Vepenaríne	<font color=ForestGreen><b>adv.neg.imper.:</b></font> ¡No importa si morimos!
Veutaregia	<font color=ForestGreen><b>vtr.pl.imper.:</b></font> ¡Chaqueemos!
Veuka	<font color=ForestGreen><b>vtr.imper.:</b></font> ¡Sembremos!
Vemtone	<font color=ForestGreen><b>adj.poses.pl.:</b></font> Nuestro trabajo.
Venriji	<font color=ForestGreen><b>adj.poses.pl.:</b></font> Nuestra carnaza.
Venrigi	<font color=ForestGreen><b>adj.poses.pl.:</b></font> Nuestra vara o caña de pescar.
Vestinka	<font color=ForestGreen><b>vtr.imper.pl.:</b></font> ¡Degollémoslo! ¡Cortémosle el cuello!  <font color=purple>Ej.</font> Cuando carnean un animal.
'Vesa	<font color=ForestGreen><b>zool.:</b></font> Oveja, cordero.
Vesorijko	<font color=ForestGreen><b>vtr.afirm.pl.:</b></font> Lo tumbamos. Tumbar a una persona, árbol o cosa por un empujón.
Veutsegia	<font color=ForestGreen><b>vtr.imper.pl.:</b></font> ¡Champémoslo! Acción de champar a alguien o algo al agua.
Veuriipe	<font color=ForestGreen><b>n.m.:</b></font> Batidor/jometoto. Utensilio de la cocina que se usa para batir alimento, bebida.
Venrigia	<font color=ForestGreen><b>vtr.imper.pl.:</b></font> ¡Invitémosle! Dar de comer o dar un regalo a alguien.
Vito	<font color=ForestGreen><b>vtr.pl.afirm.:</b></font> Lo terminamos. 
Vita	<font color=ForestGreen><b>vtr.pl.imper.:</b></font> ¡Terminémoslo! 
Vita	<font color=ForestGreen><b>zool.:</b></font> Lobo silvestre.
Vite	<font color=ForestGreen><b>zool.:</b></font> Murciélago.
Vitorigia	<font color=ForestGreen><b>adj.:</b></font> Vivos. Que sigamos con vida.
Vyampo	<font color=ForestGreen><b>vtr.imper.:</b></font> ¡Vámonos!
Vyampeewo	<font color=ForestGreen><b>adj.poses.:</b></font> Nuestra juventud.
Vimka	<font color=ForestGreen><b>vtr.imper.pl.:</b></font> ¡Durmamos!
Vich'oo'i	<font color=ForestGreen><b>vtr.afirm.pl.:</b></font> Lo hemos llamado.
Vim'oripo	<font color=ForestGreen><b>vtr.imper.:</b></font> ¡Ya lo vimos!
Vimkataka	<font color=ForestGreen><b>vtr.imper.pl.:</b></font> ¡Ayudémoslo!
Vim'o'e	<font color=ForestGreen><b>vtr.afirm.pl.:</b></font> Los vimos a ustedes.
Vemtoka	<font color=ForestGreen><b>vtr.imper.pl.:</b></font> ¡Atrasémoslo! Persona que retrasa a alguien en una actividad.
Viyara'o	<font color=ForestGreen><b>adj.poses.:</b></font> Nuestro padrasto.
Viyanini	<font color=ForestGreen><b>adj.:</b></font> Difuntos. Personas fallecidas.
Viya	<font color=ForestGreen><b>adj.poses.:</b></font> Nuestro padre terrenal <font color=purple>/</font> Dios.
Viyachicha	<font color=ForestGreen><b>adj.:</b></font> Santo, Dios Padre.
Vyajeru	<font color=ForestGreen><b>vtr.:</b></font> Está de viaje.
Vjiigia	<font color=ForestGreen><b>vtr.imper.pl.:</b></font> ¡Traguémoslo!
Viso'o	<font color=ForestGreen><b>vtr.pl.afirm.:</b></font> Estamos carpiendo.
Vichi	<font color=ForestGreen><b>zool.:</b></font> Grillo. Insecto pequeño invertebrado.
Vyanarine	<font color=ForestGreen><b>vtr.imper.pl.:</b></font> Nos iremos no más.
Vtig're	<font color=ForestGreen><b>adj.poses.:</b></font> Nuestro anillo.
Vyajumeru	<font color=ForestGreen><b>adj.poses.:</b></font> Nuestro cuaderno.
Vyajrigia	<font color=ForestGreen><b>vtr.imper.pl.:</b></font> ¡Escribamos!
Vyana	<font color=ForestGreen><b>vtr.imper.pl.:</b></font> ¡Vamos!
Vyochereku	<font color=ForestGreen><b>adj.poses.:</b></font> Nuestro camino.
Vyongienepo	<font color=ForestGreen><b>vtr.afirm.pl.:</b></font> Ya nos iremos.
Vyowrorokwo	<font color=ForestGreen><b>vtr.afirm.pl.cond.:</b></font> Estábamos enfermo, pero nos fuimos.
Vyooperu	<font color=ForestGreen><b>deter.poses.:</b></font> Nuestro territorio o espacio territorial.
Vyommeru	<font color=ForestGreen><b>deter.poses.:</b></font> Nuestra chapapa. Objeto hecho de madera rustica que sirve para guardar cosa, fruta, etc.
Vyuupo'o	<font color=ForestGreen><b>adj.:</b></font> Nos queda bonito.
Vyutsaru	<font color=ForestGreen><b>vtr.afirm.pl.:</b></font> Jugamos.
Vyuna	<font color=ForestGreen><b>adj.pl.:</b></font> Somos de alta estatura.
Vyunako	<font color=ForestGreen><b>vtr.afirm.pl.:</b></font> Lo guardamos.
'Veregie	<font color=ForestGreen><b>n.m.:</b></font> Granizo.
Wanera	<font color=ForestGreen><b>n.f.:</b></font> Bandera.
Waka	<font color=ForestGreen><b>zool.:</b></font> Vaca.
Wanku	<font color=ForestGreen><b>n.m.:</b></font> Banco. Asiento que sirve para sentarse.
Wawtarine	<font color=ForestGreen><b>adv.:</b></font> No importa que nos cansemos.
Waamutu	<font color=ForestGreen><b>vtr.imper.pl.:</b></font> ¡Reunámonos!
Wákaji	<font color=ForestGreen><b>n.f.:</b></font> Carne.  Carne de cualquier animal.
Wemoti	<font color=ForestGreen><b>vtr.imper.pl.:</b></font> ¡Conozcamos! Acción de conocer un lugar o alguien
Wakachkaka	<font color=ForestGreen><b>adj.:</b></font> Hombre
Wakemtone	<font color=ForestGreen><b>vtr.imper.pl.:</b></font> ¡Trabajemos!
Wawta	<font color=ForestGreen><b>vtr.imper.pl.:</b></font> ¡Cansémonos!
Wajeru	<font color=ForestGreen><b>zool.:</b></font> Japutamo. Insecto muy pequeño que se sujetan en la piel causando picazón.
Wajéma	<font color=ForestGreen><b>bot.:</b></font> Azucaró. Árbol que crece en la pampa, selva y ríos.
Wákagi	<font color=ForestGreen><b>anat.:</b></font> Hueso con un poco de carne.
Wakamiro	<font color=ForestGreen><b>adj.:</b></font> Cara de vaca. Máscara de la danza del torito.
Wacha	<font color=ForestGreen><b>adj.:</b></font> Huérfano. Persona que queda sin padres.
Wama'i	<font color=ForestGreen><b>adj.:</b></font> Persona despectiva o lenta.
Wom'i	<font color=ForestGreen><b>n.f.:</b></font> Pampa. Espacio extenso de palmeras, curichis y bajios.
Wotoopo'o	<font color=ForestGreen><b>adv.:</b></font> No le queda o no le pinta.
wotoopi	<font color=ForestGreen><b>n.f.adj.:</b></font> Música, charla, discurso desagradable.
wotoonanaji	<font color=ForestGreen><b>adj.:</b></font> Feo.
woto'e	<font color=ForestGreen><b>adj.neg.:</b></font> No es largo Referido a bolsa.
wotem'a	<font color=ForestGreen><b>adv.neg.:</b></font> No lo ha visto
wotenajigia	<font color=ForestGreen><b>adv.neg.:</b></font> No lo quiere dejar, soltar. Referido a un animal.
Wono	<font color=ForestGreen><b>adj.n.:</b></font> Sur. Frío helada en tiempos de invierno. <font color=purple>/</font> Punto cardinal.
Wonogiere	<font color=ForestGreen><b>n.m.:</b></font> Sur con agua.
Wo'i	<font color=ForestGreen><b>adv.neg.:</b></font> No. Negación.
'Wogi	<font color=ForestGreen><b>zool.:</b></font> Boga. Pez de agua dulce.
Wijcha	<font color=ForestGreen><b>interj.:</b></font> ¡Hay por dios! Expresión de rechazo o escándalo por alguna acción que realiza una persona.
Winaráji	<font color=ForestGreen><b>adj.:</b></font> Bravo. Expresión de enojo por alguna molestia.
Wich'o	<font color=ForestGreen><b>adv.t.:</b></font> Todavía. 
Wipo'eto	<font color=ForestGreen><b>adv.interj.:</b></font> ¡Ya no! 
Wonomu'i	<font color=ForestGreen><b>n.f.:</b></font> Tiempo de sur. 
Wregie	<font color=ForestGreen><b>zool.:</b></font> Cascabel. Serpiente venenosa.
Wáyosi	<font color=ForestGreen><b>zool.:</b></font> Tábano Insecto muy pequeño.
Wórare	<font color=ForestGreen><b>n.f.:</b></font> Limosna. Ofrenda económica en ritual religioso.
Wrayu	<font color=ForestGreen><b>zool.:</b></font> Gallina. Ave de corral.
Wray'a	<font color=ForestGreen><b>n.m.:</b></font> Huevo. Huevo de aves y de reptiles.
Wachavipo	<font color=ForestGreen><b>adj.:</b></font> Ya sos huérfano.
Worivya	<font color=ForestGreen><b>n.:</b></font> Bolivia. Nombre del Estado Plurinacional de Bolivia.
Wonawro'o	<font color=ForestGreen><b>adv.neg.:</b></font> No quiero.
Woru	<font color=ForestGreen><b>zool.:</b></font> Loro. De la familia de los pericos que es de cola corta o chuta.
Worikusri	<font color=ForestGreen><b>zool.:</b></font> Mauri. Ave silvestre de color negro.
Waatoo'ini	<font color=ForestGreen><b>vtr.afirm.cond.:</b></font> Lo hubiéramos encontrado.
Wariku	<font color=ForestGreen><b>zool.:</b></font> Asno, burro Animal de carga.
'Wósare	<font color=ForestGreen><b>n.:</b></font> Ciudad.
Wiye	<font color=ForestGreen><b>zool.:</b></font> Buey. Animal que sirve para jalar el carretón.
Winepo	<font color=ForestGreen><b>adv.neg.interj.:</b></font> ¡Nunca más!
Wakajkoko	<font color=ForestGreen><b>vtr.imper.pl.:</b></font> ¡Compartamos!
Wákapa	<font color=ForestGreen><b>adj.n.f.:</b></font> Carne molida. 
Wakaeche	<font color=ForestGreen><b>n.f.:</b></font> Carne de res. 
Wakarawo'u	<font color=ForestGreen><b>vtr.imper.pl.:</b></font> ¡Estudiemos!
Wakaji	<font color=ForestGreen><b>vtr.:</b></font> Dar una porción de lo que tiene. Compartir.
Wakaji	<font color=ForestGreen><b>n.f.:</b></font> Carne de res o de otro animal.
Wkemtone	<font color=ForestGreen><b>vtr.afirm.ger.pl.:</b></font> Estamos trabajando.
Wkutirichu	<font color=ForestGreen><b>n.f.:</b></font> Somos iguales. Igualdad.
Wakye'e	<font color=ForestGreen><b>vtr.imper.pl.:</b></font> ¡Tengamos!
Wákachu	<font color=ForestGreen><b>vtr.imper.pl.:</b></font> ¡Hamaquemonos!
Wowre	<font color=ForestGreen><b>adv.l.:</b></font> Lado derecho.
Yare	<font color=ForestGreen><b>vtr.imper.:</b></font> ¡Ven o vení!
Iypeno	<font color=ForestGreen><b>adj.poses.:</b></font> Nuestra casa.
Iyponogieru	<font color=ForestGreen><b>adj.poses.:</b></font> Nuestro guía. Guía para llegar a un lugar o método para hacer música.
Iypona	<font color=ForestGreen><b>vtr.imper.pl.:</b></font> ¡Sigámoslo!
Iypopuegia	<font color=ForestGreen><b>deter.pron.dem.:</b></font> Por ese lugar vamos.
Iyponora'i	<font color=ForestGreen><b>vtr.imper.:</b></font> Seguirlo o repetir lo que realiza.
Iyjiigia / vjiigia	<font color=ForestGreen><b>vtr.imper.pl.:</b></font> ¡Traguémoslo!
Iypochowo	<font color=ForestGreen><b>adj.poses.:</b></font> Nuestro lunar.
Iywoti	<font color=ForestGreen><b>n.f.:</b></font> Hacha. Que sirve para cortar palo
Iywoo'oripo	<font color=ForestGreen><b>vtr.afirm.:</b></font> Ya queremos.
Iywo'u	<font color=ForestGreen><b>anat.:</b></font> Nuestra Muñeca. Parte del cuerpo humano.
Iywáragi	<font color=ForestGreen><b>n.f.:</b></font> Manetacu. Manija para moler alimento en el tacú.
Iywapa	<font color=ForestGreen><b>adj.:</b></font> Charque molido. 
Iywacho	<font color=ForestGreen><b>adj.poses.:</b></font> Nuestro pago. 
Iywachrigia	<font color=ForestGreen><b>vtr.imper.pl.:</b></font> ¡Compremos!!
Iywiyera	<font color=ForestGreen><b>adj.poses.:</b></font> Nuestro buey. 
Iypigi	<font color=ForestGreen><b>adj.dem.:</b></font> Nuestro tobillo. 
Iypúyusi	<font color=ForestGreen><b>adj.dem.:</b></font> Nuestra rodilla. 
Iypuku	<font color=ForestGreen><b>adj.dem.:</b></font> Nuestro cachete 
Iypa'e	<font color=ForestGreen><b>adj.dem.:</b></font> Nuestro muslo. 
Yátupi	<font color=ForestGreen><b>interj.:</b></font> ¡Qué pasó! Problema o suceso inadvertido.
Yatpipijina	<font color=ForestGreen><b>adj.:</b></font> De malas ganas. <font color=purple>/</font> Persona que se está recuperando de una enfermedad.
Yesu	<font color=ForestGreen><b>n.m.:</b></font> Yeso. Material de construcción.
Yewa	<font color=ForestGreen><b>zool.:</b></font> Yegua.
Yona	<font color=ForestGreen><b>zool.:</b></font> Surubí. Pez de agua dulce.
Yopo	<font color=ForestGreen><b>zool.:</b></font> Jochi pintado. Animal que habita en la selva amazónica.
Yoti	<font color=ForestGreen><b>n.f.:</b></font> Noche.
Yotyoopo	<font color=ForestGreen><b>interj.:</b></font> ¡Buenas noches! Expresión de saludo.
Yusa	<font color=ForestGreen><b>zool.:</b></font> Lechuza. Ave nocturna
Yupi	<font color=ForestGreen><b>n.f.:</b></font> Cántaro.  Recipiente elaborado de barro cocido.
Aakare	<font color=ForestGreen><b>n.m.:</b></font> Autoridad. Alcalde.
Taa	<font color=ForestGreen><b>adj.pronom.:</b></font> ¿Qué? 
Naa	<font color=ForestGreen><b>pron.interrog.:</b></font> ¿Quién? 
Maaso	<font color=ForestGreen><b>n.m.:</b></font> marzo. Tercer mes del año.
Paata	<font color=ForestGreen><b>bot.:</b></font> Palta. Fruta del árbol del palto.
Kaame	<font color=ForestGreen><b>n.f.:</b></font> Carmen.  Nombre femenino.
Paake	<font color=ForestGreen><b>n.:</b></font> Parque.  Espacio recreativo
Aeko	<font color=ForestGreen><b>zool.:</b></font> Bufeo. Delfín de agua dulce.
Taeima	<font color=ForestGreen><b>vtr.:</b></font> Lo mezquina.
Taema	<font color=ForestGreen><b>adj.dem.:</b></font> Su macho.
Taegne	<font color=ForestGreen><b>adv.l.:</b></font> Detrás. 
Aee	<font color=ForestGreen><b>n.f.:</b></font> vocal compleja.
Naeemuisrare	<font color=ForestGreen><b>n.f.:</b></font> Discoteca.
Taeemusko	<font color=ForestGreen><b>vtr.prnl.:</b></font> Se hundió su cabeza.
Aei	<font color=ForestGreen><b>n.f.:</b></font> Vocal compleja.
Naeikane	<font color=ForestGreen><b>vintr.afirm.:</b></font> Se maduró. Afirmación de una persona a otra de que su plátano o guineo ya maduró.
Eeterio	<font color=ForestGreen><b>n.m.:</b></font> Eleuterio. Nombre masculino.
Eesapuegia	<font color=ForestGreen><b>vtr.:</b></font> Enlazar.
Vyeenési	<font color=ForestGreen><b>n.:</b></font> viernes. Quinto día de la semana.
Teenera	<font color=ForestGreen><b>zool.:</b></font> Ternero(a).
'Niive	<font color=ForestGreen><b>n.m.:</b></font> Anzuelo.
'Niipi	<font color=ForestGreen><b>n.f.:</b></font> Liñada.
'Jii'i	<font color=ForestGreen><b>zool.:</b></font> Gallo. 
Tiimuiko	<font color=ForestGreen><b>vtr.afirm.:</b></font> Baila. 
Ooyo	<font color=ForestGreen><b>adv.interrog.:</b></font> ¿Dónde?
Oosamre	<font color=ForestGreen><b>vtr.imper.pl.:</b></font> ¡Alégrense!
Oopyos'o	<font color=ForestGreen><b>adv.interrog.:</b></font> ¿De dónde vienes?
Toonaa'ini	<font color=ForestGreen><b>interj.:</b></font> ¡Ojalá que sirva!
Jvejninapo	<font color=ForestGreen><b>vtr.imper.:</b></font> ¡Andá traele!
Jvejna	<font color=ForestGreen><b>vtr.imper.:</b></font> ¡Traé! Orden de que vaya a traer algo.
Jvejno	<font color=ForestGreen><b>vtr.interrog.:</b></font> ¿Lo has traído?
Jvejnoripo	<font color=ForestGreen><b>vtr.interrog.:</b></font> ¿Ya lo trajiste?
Jvejnarine	<font color=ForestGreen><b>adv.t.:</b></font> Después lo trae. 
Jvestirigia	<font color=ForestGreen><b>vtr.imper.:</b></font> ¡Córtalo! 
Jvejchaka	<font color=ForestGreen><b>vtr.afirm.:</b></font> Desamarrar hamaca, mosquitero.
Jvechaka	<font color=ForestGreen><b>vtr.imper.:</b></font> ¡Encógelo!
Jvejchok'a	<font color=ForestGreen><b>vtr.afirm.imper.:</b></font> ¡Descascáralo!
Jooreko	<font color=ForestGreen><b>vtr.:</b></font> Violar. Abusar sexualmente de una persona en contra de su voluntad.
Choogi	<font color=ForestGreen><b>bot.:</b></font> Árbol de ajo. 
Toonera	<font color=ForestGreen><b>adj.:</b></font> Mediano. 
Tooniyu	<font color=ForestGreen><b>n.m.:</b></font> Tornillo.
Pchoopo	<font color=ForestGreen><b>vtr.interrog.:</b></font> ¿Ya regresaste?
Nchoopo	<font color=ForestGreen><b>vtr.afirm.:</b></font> Ya regresé.
Tkoososo	<font color=ForestGreen><b>adj.:</b></font> Espumea.
Tkoososoro'o	<font color=ForestGreen><b>n.m.:</b></font> Espumeador.
Noope	<font color=ForestGreen><b>n.m.:</b></font> Remo. Instrumento de remar.
Uupe	<font color=ForestGreen><b>zool.:</b></font> Rana. Anfibio.
Uututita	<font color=ForestGreen><b>vtr.:</b></font> Acariciar.
Tyuuna	<font color=ForestGreen><b>adj.:</b></font> Está limpio, bonito.
Tayuchororoju'e	<font color=ForestGreen><b>n.f.:</b></font> División. División de casa o habitación.
Tasorawko	<font color=ForestGreen><b>n.f.:</b></font> División. Compartirse en parte iguales 
Nuurichu	<font color=ForestGreen><b>adj.afirm.:</b></font> Estoy bien.
'Nuujipo	<font color=ForestGreen><b>adv.t.:</b></font> Al momento.
Giapo	<font color=ForestGreen><b>zool.:</b></font> Cacare. Ave de color negro, come guayaba
Giewre	<font color=ForestGreen><b>n.f.:</b></font> Fiebre. Aumento de la temperatura del cuerpo por encima de la normal.
Gievi	<font color=ForestGreen><b>zool.:</b></font> Mono. Animal silvestre que huele a ajo.
Gíjogi	<font color=ForestGreen><b>bot.:</b></font> Mara. Tipo de Árbol.
Giyo	<font color=ForestGreen><b>zool.:</b></font> Turo. Molusco de color negro.
Giore	<font color=ForestGreen><b>zool.:</b></font> Víbora. Reptil venenoso.
Giorepi	<font color=ForestGreen><b>zool.:</b></font> Gusano o lombriz.
Giajo	<font color=ForestGreen><b>bot.:</b></font> Chuño de plátano.
Giesu	<font color=ForestGreen><b>n.m.:</b></font> Queso.
Giwre	<font color=ForestGreen><b>bot.:</b></font> Jengibre.
'Motnaeko	<font color=ForestGreen><b>n.m.:</b></font> Trabajo.
'Repo	<font color=ForestGreen><b>n.f.:</b></font> Vasija de tutuma.
'Jinomo	<font color=ForestGreen><b>zool.:</b></font> Raya. Pez raya.
'Nere	<font color=ForestGreen><b>zool.:</b></font> Benton. Pez de agua dulce.
Táchaka	<font color=ForestGreen><b>zool.:</b></font> Tachacá. Pez de agua dulce
'Chónaru	<font color=ForestGreen><b>adj.n.m.f.:</b></font> Adulto.
'Cheve	<font color=ForestGreen><b>n.f.:</b></font> Sal.
'Tikre	<font color=ForestGreen><b>zool.:</b></font> Oso bandera.
'Pojgira	<font color=ForestGreen><b>zool.:</b></font> Patito pequeño.
'Nug'e	<font color=ForestGreen><b>adv.l.:</b></font> Arriba.
'Pog'e	<font color=ForestGreen><b>n.m.:</b></font> Terreno. Planeta tierra.
'Jiro	<font color=ForestGreen><b>n.m.:</b></font> Hombre. Persona de sexo masculino.
'Renako	<font color=ForestGreen><b>adj.:</b></font> Recién parida. Persona que ha dado a luz. 
'Renako	<font color=ForestGreen><b>pron.indef.:</b></font> Algo nuevo, novedoso.
