Árbol de guapomó	Que crece en los llanos orientales de Bolivia. <font color=ForestGreen><b>bot.s.:</b></font> A'gi
Guapomó	Fruto del árbol del guapomó. <font color=ForestGreen><b>bot.s.:</b></font> A'i
¡Reciban!, ¡Recíbanlo!	Orden que da una persona a un grupo para que reciba a personas, animales o cosas. <font color=ForestGreen><b>vtr.imper.:</b></font> Ajachpa
Muela / molares	Dientes de otras personas. <font color=ForestGreen><b>n.f.pl.:</b></font> Ajakaragi
¡Cuiden!	Orden de cuidar. <font color=ForestGreen><b>vtr.imper.:</b></font> Ajañoka
¡Cuídenmelo muy bien!	Cuidar personas, animales o cosas. <font color=ForestGreen><b>vtr.imper.pl.:</b></font> Ajañokagnenajicha
Advertir a alguien de cualquier tipo de peligro	<font color=ForestGreen><b>interj.:</b></font> Ajañokajno
¡No se descuiden!	No descuidar a personas, animales o cosas. Atento en el cuidado. <font color=ForestGreen><b>vtr.imper.pl.:</b></font> Ajañokajnotsero
¿Ya lo cuidaron?	Persona que pregunta si cuidaron a alguna cosa de mucho valor. <font color=ForestGreen><b>vtr.interrog.:</b></font> Ajañokripo
¿Están cuidando?	1.- Persona que pregunta a un grupo si están cuidando animales o cosas. 2.- <font color=ForestGreen><b>Coloq.:</b></font> Velar a un difunto. <font color=ForestGreen><b>vtr.ger.interrog.:</b></font> Ajañoriko
¡Cuídenmelo!	Orden de una persona a otras de cuidar a personas, animales o cosas. <font color=ForestGreen><b>vtr.imper.pl.:</b></font> Ajañosnanu
Rebanar	Hacer rebanadas de alimentos sólidos u otros objetos. <font color=ForestGreen><b>vtr.:</b></font> Ajatka
Picar	Picar hoja de tabaco, como también la yuca asada. <font color=ForestGreen><b>vtr.:</b></font> Ajatpaka
¡Enganchen!	Acción de sujetar, enganchar y unir. <font color=ForestGreen><b>vtr.imper.:</b></font> Ajátaka
Jabón de ustedes	Jabón que pertenece a otras personas. <font color=ForestGreen><b>n.m.ind.:</b></font> Ajawonra
¿Traen?	Acción de traer algo. Pregunta que hace una persona en traer productos agrícolas del chaco. <font color=ForestGreen><b>vtr.interrog.:</b></font> Ajeppono
Gases intestinales	Residuo gaseoso de la digestión que se acumula en el intestino y causa molestias. <font color=ForestGreen><b>n.m.:</b></font> Ajeppueko
Saludar. ¿Cómo están ustedes?	<font color=ForestGreen><b>vtr.:</b></font> Ajichrokwoo'i
Señalar la costilla de una persona	<font color=ForestGreen><b>vtr.pron.demos.:</b></font> Ajiimone
¡Sorpréndanlo ustedes!	Sorprender a otras personas, animales. <font color=ForestGreen><b>vtr.imper.:</b></font> Achimroka
Simba de hamaca	Que sirve de soporte para colgar una hamaca	<font color=ForestGreen><b>n.f.:</b></font> Achmonsi
Hilado	Material de algodón para elaborar hamaca. <font color=ForestGreen><b>n.m.:</b></font> Achpi
Tejido de algodón para confeccionar hamacas	<font color=ForestGreen><b>n.m.:</b></font> Achpiji
Hamaca	Tejido de hilo de algodón fabricada a mano, de acuerdo al contexto de cada pueblo originario. <font color=ForestGreen><b>n.f.:</b></font> Achu
Talón de ustedes	Manera de señalar a los demás la parte posterior del pie humano. <font color=ForestGreen><b>n.m.indic.pl.:</b></font> Achuksipewo
Su Toco	Mueble o taburete rústico. <font color=ForestGreen><b>n.m.coloq.indic.:</b></font> Achúmora
Cabeza de ustedes	Parte superior del cuerpo del hombre dicho de manera indicativa a un grupo de personas. <font color=ForestGreen><b>n.f.mod.indic.:</b></font> Achuti
¡Rebánenlo!	Orden de una persona a otras para que rebanen o corten frutas o maderas. <font color=ForestGreen><b>vtr.imper.:</b></font> Ajat-sigia
Uña de ustedes	Placa córnea y dura que cubre y protege la parte superior de la punta de los dedos del hombre y otros vertebrados. <font color=ForestGreen><b>n.f.mod.indic.:</b></font> Ajipño
¡Lean!	¡Canten! Mandato de leer a un grupo. <font color=ForestGreen><b>vtr.imper.pl.:</b></font> Ajira
Arqueado	Que está curvado en forma de arco. <font color=ForestGreen><b>adj.:</b></font> Aaku
Exclusivo para objetos	Tabla, pared o muro. Con simetría arqueada por fenómeno natural. <font color=ForestGreen><b>adj.:</b></font> Aakucho
Torcido o “simbrado”	Canoa torcida por efecto de la naturaleza. Persona que camina agachada por alguna enfermedad o edad. <font color=ForestGreen><b>adj.coloq.:</b></font> Aakuj'e
Arqueado	Planta de palmera, tacuara o bambú, chuchió, caña que tiene el tallo arqueado. Exclusivo para plantas o árboles. <font color=ForestGreen><b>adj.:</b></font> Aakuno
Torcido	 <font color=purple>Ej.</font> Cable, bejuco o rama, liñada, soga, que por su uso llega a torcerse.  <font color=purple>Ej.</font> Expresión que se da a la forma del arcoíris.  <font color=purple>Ej.</font> Camino o senda que tiene curva. <font color=ForestGreen><b>adj.coloq.:</b></font> Aakupi
Temor	Miedo que se siente al considerar que algo perjudicial o negativo ocurra. Sobresalto o sensación de alarma. Respuesta de la mente y del cuerpo de un estímulo repentino o inesperado (A la luz, sonido, ruido, movimiento, oscuridad). <font color=ForestGreen><b>n.m.:</b></font> Aami
Albóndiga - almóndiga	Alimento elaborado de carne molida con mezcla de varios ingredientes. <font color=ForestGreen><b>n.f.:</b></font> Aamonka
¡Reúnanse!	Acto de reunirse por orden de una persona. <font color=ForestGreen><b>vtr.imper.:</b></font> Aamutu
Decoración, colocación y combinación de alimentos elaborados	Que se exhiben para las fiestas religiosas.  <font color=purple>Ej.:</font> Pan de arroz, jalea, chancaca, bizcocho de maíz, chima de maíz, etc. <font color=ForestGreen><b>n.f.:</b></font> Aapájore
Peyorativo	Actitud negativa, frente a una persona que pone en duda su capacidad e integridad moral. <font color=ForestGreen><b>n.m.adj.:</b></font> Aatattaji
¡Lean bien! o ¡lean de verdad!	Orden de una persona a un grupo. <font color=ForestGreen><b>vtr.imper.pl.:</b></font> Ajiragienenajicha
Recomendación	Acción de recomendar de una persona a un grupo para que no se olviden de leer. <font color=ForestGreen><b>n.f.:</b></font> Ajirajnotsero
Quitar la piel, la cáscara, la corteza o la envoltura de algo	Pelen la cáscara de la yuca o de alguna fruta. <font color=ForestGreen><b>vtr.:</b></font> Ajochegia
Horno de ustedes	Bloque elaborado de barro para la cocina. Se utiliza para hornear, cocer, asar: pan, pan de arroz, bizcocho, carnes, etc. <font color=ForestGreen><b>n.m.pron.poses.:</b></font> Ajoono
Ajo (planta o cabeza)	Fruto en cápsula que encierra unas semillas arriñonadas; el bulbo, de olor y sabor intenso, también se usa como medicina tradicional. <font color=ForestGreen><b>n.m.:</b></font> Ájosi
Pez llamado belea	Pez de agua dulce y de cordillera. <font color=ForestGreen><b>n.m.zoo.:</b></font> Ajpe
Corredor	Ustedes son corredores. Grupo de personas rápidas para correr. <font color=ForestGreen><b>adj.n.f.m.pl.:</b></font> Ajunopoo'o - Ajumpoo'o
“Correteando”	Niños que corren sin ningún orden. <font color=ForestGreen><b>vtr.ger.coloq.:</b></font> Ajunopopuiko - Ajumpopuiko
¡Corran!	Orden de una persona a un grupo de personas para que corran. <font color=ForestGreen><b>verb.tr.imper.pl.:</b></font> Ajúnopa
Ejene	Insecto de color negro o gris muy pequeño, no más grande que la cabeza de un alfiler. Al picar sobre la piel, produce alergias, escozor y ardor intenso. <font color=ForestGreen><b>zool.n.m.:</b></font> Ákaesi
¡Invítenle!	Pedir a una persona que participe en una celebración o un acontecimiento organizado por uno mismo. <font color=ForestGreen><b>vtr.imper.:</b></font> Ákaji
¿Le invitaron?	Pregunta de una persona a otra si compartieron lo que tenían. <font color=ForestGreen><b>vtr.interrog.:</b></font> Akaji
¡Repártanse!	Dar a cada una de las personas que forman un grupo la parte que les corresponde de determinada cosa. <font color=ForestGreen><b>vtr.imper.pl.:</b></font> Akajkoko
¿Se repartieron?	Pregunta de una persona a otros si se repartieron de lo que tenían. <font color=ForestGreen><b>vtr.interrog.pl.:</b></font> ¿Akajkoko?
Compartir	Dar a una persona parte de lo que tiene en partes iguales: alimentos, objetos, espacios. <font color=ForestGreen><b>vtr.:</b></font> Aktikko
¿La camisa de ustedes?	Se dice para saber si la camisa es de ustedes. <font color=ForestGreen><b>deter.poses.interrog.:</b></font> ¿Akámisa?
Su camisa	Prenda de vestir de otra persona. <font color=ForestGreen><b>n.f.pron.demos.:</b></font> Akamisa
¡Acéitense el cabello!	Orden a un grupo para que se aceiten el cabello. <font color=ForestGreen><b>vtr.prnl.imper.:</b></font> Akamasi
¿Se aceitaron?	Se dice para saber si las personas se aceitaron el cabello. <font color=ForestGreen><b>vtr.prnl.interrog.:</b></font> ¿Akámasi?
¡Estudien!	Se usa para ordenar que estudien o como también para preguntar si están estudiando. <font color=ForestGreen><b>vtr.imper.pl.:</b></font> Akarawo'u
Hagan el favor	Aconsejar a alguien sobre lo que puede o lo que debe hacer para el bien o beneficio de otro. <font color=ForestGreen><b>vtr.:</b></font> Akatajigia
Expresión de sentir dolor momentáneo	<font color=ForestGreen><b>interj.coloq.:</b></font> Akayawini – Akeywini.  <font color=purple>Ej.:</font> ¡Por Dios que me duele! ¡Los ayes! <font color=purple>/</font> <font color=blue>¡Ayayai!</font>
Visitante	Tengan visita. Llevarle visitas. <font color=ForestGreen><b>adj.:</b></font> Akchimra
“Tengan yerno”	Exclusivo para exponer un pariente que pueda ser visto por todos. s.dem.m.coloq.: Akchina
¡Déjense sorprender!	Dejarse sorprender por personas. <font color=ForestGreen><b>vtr.imper.:</b></font> Akchimro'u
“Tengan nuera”	Exclusivo para exponer una pariente que pueda ser vista por todos. <font color=ForestGreen><b>demos.f.coloq.:</b></font> Akchineno
“Tengan vaso”	Exclusivo para exponer un objeto que pueda ser visto por todos. <font color=ForestGreen><b>pron.demos.coloq.:</b></font> Ákeeresi
¿Tienen Vaso?	Se utiliza para preguntar si tienen <font color=ForestGreen><b>vtr.interrog.:</b></font> ¿Akeeresi?
¡Tengan amigo(a)!	Especialmente de posesión, pertenencia o inclusión, con la persona designada por el sujeto. <font color=ForestGreen><b>vtr.imper.:</b></font> Akemnaksare
¡Háganse querer!	Ganarse la amistad, el aprecio o la admiración de una persona. <font color=ForestGreen><b>vtr.indic.imper.:</b></font> Akemnaksi
¡Trabajen!	Someter a personas a una acción continua y ordenada. <font color=ForestGreen><b>vtr.imper.pl.:</b></font> Akemtone
¡Háganse apalear!	Advertir de una posible paliza a alguien, en especial con un palo o con otro objeto contundente. <font color=ForestGreen><b>vtr.indic.imper.:</b></font> Akepchi
¡Háganse mojar!	Advertir castigo si llegara a quedarse impregnado de agua. <font color=ForestGreen><b>vtr.indic.imper.:</b></font> Akepsa'o
¡Ahúmense!	Persona que ordena desinfectar una cosa por medio de humo o vapores apropiados. <font color=ForestGreen><b>vtr.imper.prnl.:</b></font> Akepsi'o
¡Tengan machete!	Que ordena hacer posesión, pertenencia, exclusivo de un machete. <font color=ForestGreen><b>vtr.imper.pl.:</b></font> Ákesaviipe
¿Trajeron machete?	Se usa para preguntar si han traído machete. <font color=ForestGreen><b>vtr.interrog.pl.:</b></font> Akesaviipeji
¡Hagan chicotear!	Imponer un castigo a quienes ha cometido un delito o una falta. <font color=ForestGreen><b>vtr.imper.pl.:</b></font> Akesta
¿Los chicotearon?	Castigar con el chicote u otro objeto semejante a un animal o una persona. <font color=ForestGreen><b>vtr. interrog.pl.:</b></font> Akestano
¡Apártense!	Poner a una persona o una cosa lejos o más lejos de otra o de un lugar determinado. <font color=ForestGreen><b>vtr.imper.pl.:</b></font> Akewis'a – Akosku'a
Advertencia	1.- <font color=ForestGreen><b>n.m.:</b></font> Acción de advertir una situación peligrosa. 2.- <font color=ForestGreen><b>vtr.neg.:</b></font> Rehusar a recibir a una persona(s). <font color=ForestGreen><b>n.f.:</b></font> Akagieji
¿Tienen nombre?	Preguntar una persona a otras sobre sus nombres. <font color=ForestGreen><b>vtr.interrog.pl.:</b></font> ¿Akíjare?
¡Háganse bautizar!	Administrar a una persona el sacramento del bautismo. <font color=ForestGreen><b>vtr.imper.pl.:</b></font> Akikchosi
¡Háganlo llegar!	Pasar a estar [una persona o en el fin o el término de un desplazamiento. <font color=ForestGreen><b>vintr.imper.pl.:</b></font> Akitekpa
¡Molestosos!	Personas que causan molestia continua. <font color=ForestGreen><b>adj.pl.:</b></font> Akitemra'i
¡Preocúpense!	Persona que manda ocupar insistentemente el pensamiento de muchas personas a algo que puede ser perjudicial. <font color=ForestGreen><b>vtr.imper.pl.:</b></font> Akjaasamre
¡Insistan!	Hacer hincapié en algo, para destacar su importancia, repitiéndolo. vrt.imper.pl.: Akmesa
¡Cocinen!	Ordenar preparar un alimento para que quede listo para ser comido. <font color=ForestGreen><b>vtr.imper.pl.:</b></font> Akmet-si
Anunciar	1.- Ordenar para que se anuncie un mensaje, aviso, noticias, etc. 2.- Hacer saber una cosa o darla a conocer públicamente. <font color=ForestGreen><b>vtr.:</b></font> Akmetoriru
Aprovechar	1.- Ordenar a un grupo de personas aprovechar el tiempo a consultar algo a alguien en el momento oportuno. 2.- Utilizar cierta circunstancia para obtener provecho o conseguir algo en beneficio propio. <font color=ForestGreen><b>vtr.:</b></font> Akmopra
¡Lleven su remo!	Ordenar exclusivamente a un grupo de personas para que lleven su remo. <font color=ForestGreen><b>vtr.imper.pl.:</b></font> Aknoopeji
¡Lleven su carga en naracuraqui!	Orden de una persona a un grupo para que lleven la carga del lugar en naracuraqui. <font color=ForestGreen><b>vtr.imper.pl.:</b></font> Aknorogi
¡Asen!	Ordenar preparar un alimento mediante la acción directa del fuego o del calor. Asar: pescado, carne, pollo, etc. <font color=ForestGreen><b>vtr.imper.pl.:</b></font> Akojmoru
¡Chapapeen!	Forma de asar diferentes variedades de carne en chapapa (Parrilla de madera rústica). <font color=ForestGreen><b>coloq.imper.vtr.pl.:</b></font> Akojtoru
¿Tienen plato?	Pregunta de una persona a un grupo si tienen el utensilio de cocina. <font color=ForestGreen><b>vtr.interrog.pl.:</b></font> Akokrujo
¡No roben!	Advertencia de no quitar a una persona algo que le pertenece. <font color=ForestGreen><b>adv.imper.pl.:</b></font> Akomeriko
Sorprender o pillar a alguien desprevenido haciendo una falta	¡Ya son castellano hablante! Personas originarias que por el tiempo dejan de hablar su idioma y hablan el castellano. <font color=ForestGreen><b>vtr.coloq.pl.:</b></font> Akomeripo
Aculturar	¡Mucho hablan castellano! Grupo de personas originaria que tienen su propio idioma pero que utilizan más el castellano, adaptándose a ella para comunicarse en diferentes contextos y van perdiendo la propia. <font color=ForestGreen><b>n.f.pl.:</b></font> Akomeririkporo
¡Báñense!	Ordenar de una persona a un grupo a bañarse. <font color=ForestGreen><b>vtr.pron.imper.pl.:</b></font> Akowa
¿Es su recipiente?	Objeto o utensilio cóncavo que se utiliza para bañarse. <font color=ForestGreen><b>n.m.deter.poses.:</b></font> Akowrosi
¿Ya tienen?	Preguntan de una persona a un grupo si tienen o poseen algunas pertenencias <font color=ForestGreen><b>vtr.pres.indic.pl.:</b></font> Akoy'e – Akoy'eripo
¿Tuvieron relaciones sexuales?	Preguntar si tuvieron trato amoroso o sexual a un grupo de personas. <font color=ForestGreen><b>n.f.pl.interrog.:</b></font> Akoyeno – Akoyenoripo
¿Están con sus mujeres?	Pregunta de una persona a otras si están acompañados de sus mujeres. <font color=ForestGreen><b>vtr.prep.interrog.pl.:</b></font> Akoyenoji
¿Están con sus esposos?	Pregunta de una persona a otras mujeres si están con sus esposos. <font color=ForestGreen><b>vtr.prep.interrog.pl.:</b></font> Akimaji
Adictos al sexo	Necesidad incontrolable por sexo de todo tipo. Compulsión incontrolable. <font color=ForestGreen><b>adj.n.f.pl.:</b></font> Akoyenora'i
¡Tienen que sembrar!	Orden de una persona a un grupo esparcir semillas en un terreno preparado para que germinen. <font color=ForestGreen><b>vtr.imper.pl.:</b></font> Aksukrereko
¡Siembren!	Orden de una persona a un grupo para que siembren. 3ª per.pres.imper.pl.: Aksukre
¡Moléstenlo!	Hacer que algunas personas hagan algo a otra y resulte incómodo. <font color=ForestGreen><b>vintr.imper.pl.:</b></font> Aktemo
¡Lleven cuchillo!	Orden a un grupo para que dispongan un cuchillo. <font color=ForestGreen><b>vtr.imper.pl.:</b></font> Aktumraji
1.- ¿Ésta cuchara de ustedes?	Pregunta de una persona a un grupo si ese objeto es propiedad de alguno. <font color=ForestGreen><b>pron.poses.interrog.pl.:</b></font> ¿Akuchara?
1.- La cuchara es de ustedes	Afirmación de una persona de que la cuchara pertenece a alguien del grupo. <font color=ForestGreen><b>pron.poses.dem.pl.:</b></font> Akuchara
¡Sáquenlo!	Orden de una persona a un grupo para que expulse a alguien o algo. <font color=ForestGreen><b>vtr.imper.pl.:</b></font> Akuchka
¡Lo tienen que sacar!	1.- Orden de una persona a otras para desalojar a alguien de un lugar determinado. 2.- Orden de una persona a un grupo para que saquen a un animal u objeto del lugar. <font color=ForestGreen><b>vtr.imper.cond.:</b></font> Akuchkoyre
¿Lo van sacar?	Pregunta de una persona a un grupo si van a desalojar a alguien de un lugar. <font color=ForestGreen><b>vtr.interrog.condic.pl.:</b></font> ¿Akuchkoyre?
¡Persistan!	Ordenar a grupo mantenerse firme y constante en una manera de ser o de obrar. <font color=ForestGreen><b>vtr.imper.pl.:</b></font> Akukinajiru
Será su cuarto de cocina	Indica que la sala de cocina será de alguien o algunos. <font color=ForestGreen><b>pron.poses.sing.:</b></font> Akusnayre
Es su plato	Afirmación de una persona sobre el utensilio de otro. <font color=ForestGreen><b>pron.poses.sing.:</b></font> Akuujo
¿Es su plato?	Pregunta de una persona a un grupo si el plato les pertenece. <font color=ForestGreen><b>pron.poses.sing.interrog.:</b></font> ¿Akuujo?
¡Dénle oficio!	Que sean mandados a realizar una actividad productiva. <font color=ForestGreen><b>mod.subj.imper.pl.:</b></font> Akwonra
Declarar a una persona apta y madura para tener relaciones sexuales	<font color=ForestGreen><b>vtr.imper.:</b></font> Akyeno
¡Hagan quisa!	Orden de una persona a un grupo para que pongan a secar el plátano maduro al sol y éste dure más tiempo. <font color=ForestGreen><b>vtr.imper.pl.:</b></font> Akyine
¡Lleven singa!	1.- Orden de una persona para que lleven singa. 2.- Lo usamos para referirnos al bastón de apoyo. <font color=ForestGreen><b>vtr.imper.pl.:</b></font> Akyupuiigi
¡Su piedra!	Señala una relación de posesión entre el objeto poseído. Su piedra de afilar cuchillos. <font color=ForestGreen><b>adj.poses.sing.:</b></font> Amaane
¿Es su piedra?	Pregunta una relación de posesión entre el objeto poseído. <font color=ForestGreen><b>Adj.poses.interrog.:</b></font> ¿Amaane?
Es su mantel	Afirma posesión de objeto. <font color=ForestGreen><b>adj.afirm.poses.:</b></font> Amanteresi
¿Es su mantel?	Pregunta una relación de posesión entre el objeto poseído. <font color=ForestGreen><b>Adj.poses.interrog.:</b></font> ¿Amanteresi?
¡Pónganle enema!	Aplicar un tratamiento para hacer desaparecer un malestar intestinal con fines laxantes. <font color=ForestGreen><b>vtr.imper.pl.:</b></font> Amasrucha
Son consuegros	Atribuir al sujeto de la oración una cualidad o condición intrínseca familiar. <font color=ForestGreen><b>v.cop.pres.ind.:</b></font> Amatnare
¿Son sus consuegros?	Pregunta al sujeto condición familiar. <font color=ForestGreen><b>v.cop.interrog.:</b></font> Amatnare
¡Avísenle!	Manera de informar un recado, Mensaje o aviso para actuar con precaución. <font color=ForestGreen><b>vtr.imper.pl.:</b></font> Amétaka
¿Ya le avisaron?	<font color=ForestGreen><b>vtr.interrog.afirm.:</b></font> Ametokoripo
Olla de ustedes	Afirmación de posesión grupal de un objeto. <font color=ForestGreen><b>pron.poses.pl.afirm.:</b></font> Amet-si
¿Es la olla de ustedes?	Pregunta una relación de posesión grupal con el objeto. <font color=ForestGreen><b>pron.poses.interrog.pl.:</b></font> ¿Amet-si?
¡Discúlpense!	Pedir perdón en grupo o justificarse por haber cometido una falta. <font color=ForestGreen><b>v.prnl.imper.pl.:</b></font> Ametuchapo
Cuentero, chismoso	Que es aficionado a contar chismes. <font color=ForestGreen><b>adj.nf.nm.sing.:</b></font> Ametura'i
¡Alúmbrenle!	Ayudar a una persona iluminando el lugar. <font color=ForestGreen><b>vtr.imper.pl.:</b></font> Amikucha
Sus máscaras	Afirma que las máscaras les son pertenecientes. <font color=ForestGreen><b>adj.poses.pl.afirm.:</b></font> Amimro
¿Son sus mascaras?	Pregunta de posesión una persona a un grupo de las máscaras. <font color=ForestGreen><b>adj.poses.pl.interrog.:</b></font> ¿Amimro?
Sus rostros	Indicar, mostrar dirigiendo el dedo, hacia los rostros. <font color=ForestGreen><b>adj.dem.pl.:</b></font> Amiro
Sus patios	Afirmación de una persona que el patio delantero de una casa les pertenece. <font color=ForestGreen><b>adj.afirm.poses.pl.:</b></font> Amiro'u
Polilla	Mariposa nocturna y destruye la materia donde anida: maderas, telas y papeles. <font color=ForestGreen><b>zool.n.f.:</b></font> Amirogisi
Día de los difuntos	Celebración de una fiesta religiosa dedicada a los fieles difuntos. <font color=ForestGreen><b>adj.colq.:</b></font> Ammam'i
Sus pestañas	Indicar, mostrar dirigiendo el dedo, las pestañas de los demás. <font color=ForestGreen><b>adj.dem.pl.:</b></font> Amotsipa
Se echaron a perder	Comienzo de realizar una actividad con resultados negativos. <font color=ForestGreen><b>v.prnl.pl.:</b></font> Amopruji
¡Descansen!	Ordenar a un grupo hacer una pausa en el trabajo para recuperar fuerzas. <font color=ForestGreen><b>vintr.imper.pl.:</b></font> Anáraka
Pachío	Fruto comestible de la selva de color amarillo, y que también es cultivado. <font color=ForestGreen><b>bot.n.m.:</b></font> Anariya
¡Empiecen!	Persona que ordena a un grupo para empezar una actividad. <font color=ForestGreen><b>vtr.imper.pl.:</b></font> Anekcha
¡Escojan!	Orden de separar las semillas buenas de las defectuosas. <font color=ForestGreen><b>vtr.imper.pl.:</b></font> Aneregie'a
Escoger	Elegir o tomar los primeros frutos que están maduros de los que no sirven. <font color=ForestGreen><b>vtr.inf.:</b></font> Anerejigia
Cruce	Puerto donde se atraviesa un río, arroyo <font color=purple>/</font> Acto de cruzar animales. <font color=ForestGreen><b>n.m.:</b></font> Anéreku
¡Saquen lo que estorba!	Orden a un grupo de sacar lo que estorba en la sanja o rio para poder pasar. <font color=ForestGreen><b>vtr.imper.pl.:</b></font> Anereku'a
¡Escojan!	Ordena seleccionar o preferir a una de las mejores telas, calaminas, plásticos, papel, cuero. <font color=ForestGreen><b>vtr.imper.pl.:</b></font> Aneremegia
¡Escójanlo!	Ordena a grupo de seleccionar algo exclusivo soga, pita, alambre, bejuco, cable, de acuerdo al grosor. <font color=ForestGreen><b>vtr.imper.sing.:</b></font> Anerepigia
¡Seleccionen!	Ordena un grupo de personas para que seleccionen las mejores hojas de plantas. <font color=ForestGreen><b>vtr.imper.pl.:</b></font> Anerepókocha
¡Vayan a leñear!	Orden de una persona a un grupo que vayan a traer leña. <font color=ForestGreen><b>vtr.imper.pl.:</b></font> Anerigia
¿Ya leñearon?	Pregunta que se hace a un grupo para saber si realizaron el trabajo recolectar leña. <font color=ForestGreen><b>vtr.interrog.afirm.pl.:</b></font> ¿Anerikripo?
¡Tienen que leñear!	Se utiliza para dar orden a un grupo de personas para que ejecuten la acción. <font color=ForestGreen><b>vtr.imper.pl.:</b></font> Anerikyore
¡Escojan!	Ordena seleccionar o preferir lo que mejor le parezca a un grupo. <font color=ForestGreen><b>vtr.imper.pl.:</b></font> Anerioka
¡Escojan bien!	Orden de una persona a un grupo para que se elijan bien a personas, alimentos, animales y cosas. <font color=ForestGreen><b>vtr.imper.pl.:</b></font> Aneriokapgienenajicha
¡Escójanlo!	Orden de una persona a un grupo para que se escojan personas, animales, plantas, y cosas, muy exclusivamente. <font color=ForestGreen><b>vtr.imper.sing.:</b></font> Aneriokwoka
¡Coman!	Invitación u orden de una persona a un grupo para comer. <font color=ForestGreen><b>vtr. imper.pl.:</b></font> Anigia
Es lo que le gusta	Forma propia que tiene cada persona de apreciar o valorar para que le sirvan su comida preferida. <font color=ForestGreen><b>n.m.:</b></font> Aniksare
¡Van a comer! / ¿Van a comer?	Orden de una persona a un grupo que coman. <font color=purple>/</font> También se utiliza para preguntar. <font color=ForestGreen><b>vtr.imper.interrog.pl.:</b></font> Anikyore
¡Muérdalo!	Ordena para que le saquen una tajada con una mordida (queso, pan de arroz, empanizado, etc) <font color=ForestGreen><b>vtr.imper.pl.:</b></font> Anipachoka
¡Desmenucen!	Trocear algo en partes muy pequeñas carne, pollo, charque. <font color=ForestGreen><b>vtr.imper.pl.:</b></font> Avesyayajigia
¡Coman!	Orden de una persona a un grupo para que coman chivé o harina de Pescado. <font color=ForestGreen><b>vtr.imper.pl.:</b></font> Aniparegia
¡Muerdan el piojo!	Ordena clavar los dientes al insecto parásito, causando su eliminación del cabello. <font color=ForestGreen><b>vtr.imper.pl.:</b></font> Anistuka
¡Muérdanlo!	Orden de una persona a otras para que muerdan la parte.de un objeto queso, empanizado, pan, frutas. <font color=ForestGreen><b>vtr.imper.pl.:</b></font> Anitapoka
¡Mastiquen!	Ordena plastar o triturar algo en la boca con los dientes (chicle, carne). <font color=ForestGreen><b>vtr.imper.pl.:</b></font> Anipchachajigia <font color=purple>/</font> aniwawa'igia
De color verde	Alimento o fruta no madura. <font color=ForestGreen><b>n.m.adj.:</b></font> Ano'o
Lápiz o marcador de color verde	Tronco de árbol cortado que está verde. <font color=ForestGreen><b>n.m.adj.:</b></font> Ano'ogi
Forma alagarda exclusiva de alimentos y cosas color verde	Fruta de Pacay, vaina del fréjol, liñada de color verde, gusano, víbora, cable, soga, trenza, cinta, hilo. <font color=ForestGreen><b>n.m.adj.:</b></font> Ano'opi
Frutas de color verde o que no están maduras	También para referirse a cosas: cisterna, balón, galón, turril, casa que son de color verde. <font color=ForestGreen><b>n.m.adj.:</b></font> Ano'o'i
Ojos de color verde	Personas, animales que tienen el ojo de color verde. <font color=ForestGreen><b>n.m.adj.:</b></font> Ano'o'ugi
No está maduro	Que todavía no ha alcanzado su desarrollo completo y no está en la Sazón debida para ser recolectado o consumido Semillas de arroz, maíz. <font color=ForestGreen><b>n.m.adj.:</b></font> Anogji
Patas de color verde	Exclusivo para muebles: silla, mesa, cama, banco, taburete. <font color=ForestGreen><b>n.f.adj.:</b></font> Ano'ogiope
Personas con uñas pintadas de color verde	<font color=ForestGreen><b>n.f.adj.pl.:</b></font> Ano'ojipño
¡Empiecen!	Ordena a un grupo para que empiecen una actividad o trabajo. <font color=ForestGreen><b>vtr.imper.pl.:</b></font> Ano'okapo
Objetos de color verde	Tela, papel, hule, polera, camisa, agua, calamina pintado de color verde. <font color=ForestGreen><b>n.m.adj.:</b></font> Ano'omo
Espacios de color verde	Terrenos, pastizales, potreros, bajios, canchas, de color verde. <font color=ForestGreen><b>n.m.adj.:</b></font> Ano'opa'i
Raíz verde	Raíz del árbol que no está seco o marchito. <font color=ForestGreen><b>n.f.adj.:</b></font> Ano'opore
Rama o gajo del árbol que no está seco y presenta color verde	<font color=ForestGreen><b>n.f.adj.:</b></font> Ano'otawo
Forma geométrica redonda pintada de color verde	<font color=ForestGreen><b>adj.:</b></font> Ano'osi
Orilleras de color verde como lagunas, pozos	<font color=ForestGreen><b>n.f.adj.:</b></font> Anocheyoroku
Objetos con bordes de color verde	<font color=ForestGreen><b>n.f.adj.:</b></font> Anocheyoropi
Tabla o madera pintada de color verde	<font color=ForestGreen><b>n.f.adj.:</b></font> Anocho
Madera o tabla que no esta seca	<font color=ForestGreen><b>n.f.adj.:</b></font> Ano'ocho
Espigas de arroz con el tronco aún verde	<font color=ForestGreen><b>n.f.adj.pl.:</b></font> Anochpe
¡Pónganlo! / ¡Déjenlo!	Ordena hacer que una persona poner una cosa en un lugar determinado. <font color=ForestGreen><b>vtr.imper.sing.:</b></font> Anokigia
¡Pónganse en acción!	Ordena a una persona ponerse en acción en el lugar de trabajo. <font color=ForestGreen><b>vtr.imper.sing.:</b></font> Anokapopo
Sus telares / ¿Son sus telares?	<font color=ForestGreen><b>adj.poses.pl.:</b></font> Anokrogi <font color=purple>/</font> ¿Anokrogi?
Sus tejidos / ¿Son sus tejidos?	Afirmación de una persona que los tejidos son de ellos. <font color=purple>/</font> También se lo utiliza como pregunta. <font color=ForestGreen><b>adj.poses.afirm.interrog.pl.:</b></font> Anoksa <font color=purple>/</font> ¿Anoksa?
Cara pintada de color verde, o una máscara de color verde	<font color=ForestGreen><b>n.m.adj.:</b></font> Anomro
¿El remo de ustedes? / ¿Es su remo?	Afirmación de una persona de que el remo es de ellos <font color=purple>/</font> También se lo utiliza como pregunta. <font color=ForestGreen><b>n.m.pron.poses.afirm.interrog.:</b></font> Anoope <font color=purple>/</font> ¿Anoope?
Su cutibi	Línea en la superficie del cuero cabelludo que divide un peinado. <font color=ForestGreen><b>n.f.:</b></font> Anorojiiku
¿Se quedaron?	Pregunta a un grupo de personas que por cierta circunstancia se quedaron en un lugar. <font color=ForestGreen><b>vtr.interrog.pl.:</b></font> Anospo
Siempre se quedan	Afirmación de una persona a otras que se siempre quedan en un lugar. <font color=ForestGreen><b>vtr.prnl.afirm.:</b></font> Anosra'i
Se tienen que quedar / ¿Se van a quedar?	Orden de una persona a un grupo de que tienen que quedarse en un lugar <font color=purple>/</font> También se utiliza como pregunta. <font color=ForestGreen><b>vtr.afirm. interrog.pl.:</b></font> Anosyore <font color=purple>/</font> ¿Anosyore?
Siempre patacan	Acción de masticar el maíz, yuca, arroz, para la mezcla de la elaboración de chicha. <font color=ForestGreen><b>vtr.pl.:</b></font> Anu'sare
Tienen que patacar / ¿Lo van a patacar?	Orden de una persona a un grupo para que pataquen <font color=purple>/</font> también se utiliza para preguntar. <font color=ForestGreen><b>vtr.imper. interrog.pl.:</b></font> Anu'yo <font color=purple>/</font> ¿Anu'yo?
Cielo	Firmamento infinito. <font color=purple>/</font> Parte de la atmósfera y del espacio exterior vistos desde la tierra, en la que están las nubes y en donde se ve el sol, la luna, y las estrellas. <font color=ForestGreen><b>n.m.:</b></font> Anumo
Bajo el firmamento del cielo	<font color=ForestGreen><b>adv.l.:</b></font> Anúmoku
Arcángeles divinos del cielo	Ser celestial encargado de anunciar los misterios de Dios con categoría superior a la de los ángeles. <font color=ForestGreen><b>n.m.:</b></font> Anumokurunano
Su patacado de ustedes	<font color=ForestGreen><b>adj.poses.pl.:</b></font> Anuneji
Va ser su patacado de ustedes	Persona que afirma que el patacado será de ellos. <font color=ForestGreen><b>v.cop.pl.:</b></font> Anunejiyre
De color lila	Árbol cuya hoja tiñe color lila. <font color=ForestGreen><b>n.m. adj.bot.:</b></font> Añiri
Su cintura	Persona que indica parte de la cintura de otra. <font color=ForestGreen><b>mod.ind.:</b></font> Año'e
Año	Periodo de 365 días, dividido en doce meses; que empieza el 1 de enero y termina el 31 de diciembre. <font color=ForestGreen><b>n.m.:</b></font> Añu
Sus muslos	Persona que indica parte del muslo de otro. <font color=ForestGreen><b>mod.ind.:</b></font> Apa'eji
Cara limpia de ustedes	<font color=ForestGreen><b>n.f.mod.ind.:</b></font> Apajmiro
Marco de su puerta	<font color=ForestGreen><b>n.m.adj.poses.ind.:</b></font> Apajrogi
Puerta de ustedes	<font color=ForestGreen><b>n.m.adj.poses.ind.pl.:</b></font> Apajromo
¡Píntenlo!	Orden de una persona a otras para darle color a un dibujo, pared y otros objetos. <font color=ForestGreen><b>vtr.imper.pl.:</b></font> Apatsacha
¡Pinten!	Ordenar cubrir con pintura una superficie. <font color=ForestGreen><b>vtr.imper.pl.:</b></font> Apatsaregia
Apere	Nombre de un río del Beni. <font color=ForestGreen><b>n.m.:</b></font> Apeereku
Calva oscura	Tipo de calva en la corona de un grupo de personas. <font color=ForestGreen><b>n.f.:</b></font> Apékusi
Están livianos	Grupo de personas que están de poco peso. <font color=ForestGreen><b>adj.:</b></font> Apeveji
Dos plantas de sembradíos o de arboledas	<font color=ForestGreen><b>n.f.:</b></font> Apichpu
Dos árboles maderables	También se utiliza para referirse a un par de lápiz, bolígrafo, pescado. <font color=ForestGreen><b>n.:</b></font> Apigi
Pero téngan miedo	Acción de advertir un susto. <font color=ForestGreen><b>n.m.:</b></font> Apigiatsero
Sus cuellos	Indica parte del cuerpo que une a la cabeza con el cuerpo. <font color=ForestGreen><b>mod.ind.:</b></font> Apigienu
Dos huevos	Forma de contar por la figura: su forma exterior. <font color=ForestGreen><b>n.f.:</b></font> Api'a
Dos testículos	Glándula sexual masculina de forma redondeada que produce los espermatozoides en hombres y animales. <font color=ForestGreen><b>n.m.:</b></font> Api'agi
Dos veces	Actué dos veces en la danza del gracioso. <font color=ForestGreen><b>adv.num.:</b></font> Api'e
Forma de contar por la figura	Dos naranjas, balones de forma redonda. <font color=ForestGreen><b>adj.num.:</b></font> Api'i
¿Están barriendo?	<font color=ForestGreen><b>vtr.interrog.pl.:</b></font> Api'ikwo
¿Van a barrer?	Pregunta a un grupo en tiempo futuro. <font color=ForestGreen><b>vtr.interrog.pl.:</b></font> ¿Api'ikwoyre?
Dos cosas pegadas	También sirve para referirse en el conteo de par en par (tamal, jase de jatata, jase de leña). <font color=ForestGreen><b>n.m.:</b></font> Api'o
¿Tienen miedo?	Pregunta a un grupo que si tienen miedo de lo que puede ocurrir. <font color=ForestGreen><b>n.f.pl.interrog.:</b></font> Apiko
¡Respétenlo!	Ordena de tener respeto hacia alguna persona. <font color=ForestGreen><b>vtr.imper.pl.:</b></font> Apikucha
De par en par	Se refiere a personas, animales o aves que caminan de a dos. <font color=ForestGreen><b>adv.num.:</b></font> Apinararaji
Dos espacios	Medio físico fragmentado en dos. <font color=ForestGreen><b>adv.num.:</b></font> Apípeku
Bípedos	De dos patas. Aves que se sostienen sobre dos pies o patas para caminar. <font color=ForestGreen><b>adv.num.:</b></font> Apipewo
Dos tizones	Dos partes de una leña quemadas por el fuego. <font color=ForestGreen><b>adv.num.:</b></font> Apisri'e
Freír dos veces algún alimento	<font color=ForestGreen><b>vtr.adv.num.:</b></font> Apisrune
¡Vayan con él!	Persona que ordena ir con alguien de viaje, caminata, cacería, trabajo, pesca. <font color=ForestGreen><b>vintr.imper.pl.:</b></font> Apona
¡Guíense!	Dejarse llevar por un sonido hasta llegar al lugar. <font color=ForestGreen><b>v.imper.pl.:</b></font> Apo'cha
Sus brazos	Demostrar la extremidad superior del cuerpo humano de otro. <font color=ForestGreen><b>adj.dem.:</b></font> Apowgi
Guineo	Fruto del platanero, comestible, de forma alargada. <font color=ForestGreen><b>bot.n.m.:</b></font> Apu
¡Acérquense!	Orden de una persona a otras para reunirse y escuchar a alguien dar un discurso. <font color=ForestGreen><b>vtr.pron.imper.pl.:</b></font> Apucha
¿Ya se acercaron?	<font color=ForestGreen><b>vtr.prnl.interrog.pl.:</b></font> ¿Apuchripo?
Sus piernas	Señala las piernas de otra persona. <font color=ForestGreen><b>adj.dem.:</b></font> Apuege
Sus riñones	Señala los riñones de otra persona. <font color=ForestGreen><b>adj.dem.:</b></font> Apuegene'a
¡Síganlo!	Seguir a una persona, después o detrás de otra. <font color=ForestGreen><b>vtr.imper.pl.:</b></font> Apuegne'a 
¡Pónganle pata!	Aplicar a una cosa un objeto para que no se caiga mesa, silla, banco, taburete. <font color=ForestGreen><b>vtr.imper.sing.:</b></font> Apuegiecha
¡Empápense! / ¡Huélanlo!	Quedarse empapado de agua. Forma de ordenar ciertas semillas o granos: arroz, maíz, mediante el olfato. <font color=ForestGreen><b>vtr.prnl.imper.pl.:</b></font> Ajúgie'a
¡Huelan!	Ordena aspirar por la nariz para percibir un olor. <font color=ForestGreen><b>vtr.imper.pl.:</b></font> Ajuka
¡Caminen!	Trasladarse o moverse [una persona o un animal] de un lugar a otro mediante su propio medio de locomoción. <font color=ForestGreen><b>vintr.imper.pl.:</b></font> Apuigia
¡Campeen!	Ordena buscar o perseguir animales (en especial, los de tierra o aire) para atraparlos o matarlos. <font color=ForestGreen><b>vtr.imper.pl.:</b></font> Apuiirigia
Le gusta el guineo	Persona que siente agrado o afición por comer guineo. <font color=ForestGreen><b>vintr.afirm.:</b></font> Apumore
Sus instrumentos	Indica el objeto de alguien que se usa para producir música. <font color=ForestGreen><b>adj.dem.pl.:</b></font> Apunne
Sus platillos	Indica la pertenencia del objeto de alguien. <font color=ForestGreen><b>adj.dem.pl.:</b></font> Apunnerecho
Guineal	Sembradío de guineo. <font color=ForestGreen><b>adj.:</b></font> Apunóji
Hoja de guineo	Órgano de la planta de guineo que crece sobre el tallo, de color verde. <font color=ForestGreen><b>bot.n.f.:</b></font> Apupóko
Sus rodillas	Indica las rodillas de otra persona. <font color=ForestGreen><b>adj.dem.:</b></font> Apúyusi
Alambre	Hilo de metal que sirve para amarrar. <font color=ForestGreen><b>n.m.:</b></font> Aramre
Que sea para todos	Dar a muchas personas una cosa como muestra de afecto o consideración. <font color=ForestGreen><b>vtr.afirm.:</b></font> Arestáwocha
Arrozal	Terreno donde se realiza la ricicultura o cultivo de arroz. <font color=ForestGreen><b>n.m.:</b></font> Arusji
Personaje de una danza	Danza navideña donde participa dos personajes que entonan coros celestiales. <font color=ForestGreen><b>n.m.:</b></font> Aruchu
Música	Música de la danza navideña donde bailan los aruchus sostenido por cuatro personas que alzan a los danzarines, haciéndole dar vueltas al son de la música. <font color=ForestGreen><b>n.f.:</b></font> Aruchurupi
Sus rosarios	Afirmación de pertenencia de objeto religioso. <font color=ForestGreen><b>adj.dem.:</b></font> Arusaa'o
Bajo el arrozal	<font color=ForestGreen><b>adv.l.:</b></font> Arusjeku
¿Le agradecieron?	Pregunta si se dieron las gracias por un beneficio recibido. <font color=ForestGreen><b>vtr.interrog.pl.:</b></font> ¿Arusrupayacho?
¡Agradézcanle!	Ordena dar las gracias por un beneficio recibido. <font color=ForestGreen><b>vtr.imper.pl.:</b></font> Arusrupayacha
Su cumpleaños / ¿Es su cumpleaños?	<font color=ForestGreen><b>vtr.afirm.interrog.dem.:</b></font> Asachera
Tienen que hacerlo de día	Orden de una persona a otras para que realicen una actividad diurna. <font color=ForestGreen><b>vtr.imper.pl.:</b></font> Asachokapo
¡Escuchen!	Ordena percibir una cosa por medio del sentido del oído. <font color=ForestGreen><b>vtr.imper.pl.:</b></font> Asama
¿Ya lo escucharon?	Pregunta a un grupo si escucharon el sonido, bulla, etc. <font color=ForestGreen><b>vtr.interrog.pl.:</b></font> ¿Asamripo?
¿Ya lo probaron?	Persona que ordena tomar una pequeña cantidad de comida o bebida para conocer su sabor, su calidad u otra característica. <font color=ForestGreen><b>vtr.interrog.pl.:</b></font> ¿Asamripo?
¿Ya lo probaron?	Pregunta de una persona a otras que si ya probó el dulce o salado (refresco, sopa, chicha). <font color=ForestGreen><b>vtr.interrog.pl.:</b></font> Asamuekripo
¡Escúchenlo!	Exclusivo para que escuchen el sonido o melodía que produce una persona. <font color=ForestGreen><b>vtr.imper.pl.:</b></font> Asamo'cha
Escuchen consejo / Vayan a misa	Aconseja una persona a un grupo escuchar la opinión positiva y espiritual que alguien da. <font color=ForestGreen><b>vtr.pl.:</b></font> Asammorigia
¡Participen!	Orden de una persona a otras participar en una reunión o asamblea. <font color=ForestGreen><b>vintr.imper.pl.:</b></font> Asammuerigia
¡Negocien!	Tratar un asunto para llegar a un acuerdo o solución. <font color=ForestGreen><b>vintr.pl.imper.:</b></font> Asamnako 
¿Están negociando?	Pregunta de una persona a otras, si están negociando. <font color=ForestGreen><b>vintr.interrog.pl.:</b></font> ¿Asamnareko?
¡Tengan precaución!	persona que alerta a otros(as) de algún peligro. <font color=ForestGreen><b>n.f.imper.pl.:</b></font> Asamuchapo
¡Entérense!	Orden de una persona para que se informen de algún mensaje, aviso, chisme. <font color=ForestGreen><b>vtr.pron.imper.pl.:</b></font> Asamuiigia
¿Ya lo supieron?	Pregunta de una persona si ya enteraron de la noticia. <font color=ForestGreen><b>vtr.prnl.interrog.pl.:</b></font> ¿Asamuiiko?
Asado	Carne bovina y de pescado cocinada sobre brasas. <font color=ForestGreen><b>n.m.:</b></font> Asawo
Persona que le gusta comer asado	<font color=ForestGreen><b>adj.:</b></font> Asawomore
¡Cávenlo!	Hacer un hoyo, galería o zanja en la tierra. <font color=ForestGreen><b>vtr.imper.pl.:</b></font> Asegia
Azuela	Herramienta que sirve para la elaboración de canoa, rueda de carretón, gaveta, cazuela, tací, yugo. <font color=ForestGreen><b>n.m.:</b></font> Ásera
Aceite	Sustancia grasa de origen mineral, vegetal o animal, líquida, insoluble en agua: de motacú, majo, coco, cusi, almendra, tembe, pata. <font color=purple>/</font> Aceite de motor, aceite para cocinar. <font color=ForestGreen><b>n.m.:</b></font> Asete
Sus flautas	<font color=ForestGreen><b>adj.dem.pl.:</b></font> Asiivi
Nariz de ustedes	<font color=ForestGreen><b>adj.dem.:</b></font> Asiri
¡Defequen!	Evacuar. <font color=ForestGreen><b>vintr.imper.pl.:</b></font> Asoka
¿Ya defecaron?	<font color=ForestGreen><b>vintr.interrog.pl.:</b></font> ¿Asokponripo?
Están con disentería	Alteración intestinal que se caracteriza por la mayor frecuencia, fluidez y, a menudo, volumen de las deposiciones. <font color=ForestGreen><b>n.f.afirm.pl.:</b></font> Asokra'i
Son suertudos	Personas que tienen fortuna o buena suerte. <font color=ForestGreen><b>adj.n.f.m.:</b></font> Asópe'i
Por ahí se aprovechan	Aprovecharse del momento o situación de algo que no le corresponde como ser: alimentos, objeto, personas, animales, dinero, moto, auto, etc. <font color=ForestGreen><b>vtr.prnl.pl.:</b></font> Aspe'i
Música introductoria	que se utiliza ante de una celebración religiosa. <font color=ForestGreen><b>adj.n.f.:</b></font> Aspeegi
¿Se atoraron?	Preguntar a un grupo si. Se atragantaron con alguna espina de pescado. <font color=ForestGreen><b>vtr.pron.interrog.pl.:</b></font> ¿Asu'o?
Azúcar	Sustancia orgánica sólida, blanca y soluble en agua proveniente de la caña. <font color=ForestGreen><b>n.:</b></font> Asuka
Azúcar granulada	que es elaborado y procesado de la caña de azúcar. <font color=ForestGreen><b>n.:</b></font> Asukapa
¿Lo sembraron?	Pregunta si sembraron plantas con raíz. <font color=ForestGreen><b>vtr.interrog.pl.:</b></font> ¿Asukcho?
Su sembradío	<font color=ForestGreen><b>adj.dem.:</b></font> Asukre
Estaca	Palo que se usa en un espacio determinado para marcar un limite de un territorio. <font color=ForestGreen><b>n.m.:</b></font> Asumracha
Color azul	<font color=ForestGreen><b>adj.n.m.:</b></font> Asuru
Huevo de color azul	Huevos de perdiz, y otras aves. <font color=ForestGreen><b>adj. n.m.:</b></font> Asuru'a
Su espinilla	Grano que aparece en la piel por obstrucción de los folículos pilosos debida a la acumulación de grasa. <font color=ForestGreen><b>n.m.adj.dem.:</b></font> Asusu
¡Bésenlo en la boca!	Orden de una persona de besar a otra. <font color=ForestGreen><b>vtr.imper.:</b></font> Atsujkacha
¡Frítenlo!	Freir algún alimento. <font color=ForestGreen><b>vtr.imper.:</b></font> Asuu'a
Su sartén	<font color=ForestGreen><b>adj.dem.:</b></font> Asuuneresi
Sucio	Lugar que tiene polvo, basura, manchas o impurezas. <font color=ForestGreen><b>adj.:</b></font> Ata
¡Búsquenlo!	Hacer lo necesario para encontrar o hallar a una persona. <font color=ForestGreen><b>vtr.imper.pl.:</b></font> Atanka
Sus glúteos	Señala parte carnosa y redondeada del cuerpo humano que forman esos músculos. <font color=ForestGreen><b>n.anat.pron.dem.:</b></font> Atete
Hermano(a) menor	Consanguíneo que es el último de los hermanos. <font color=ForestGreen><b>n.m.f.:</b></font> Ati
¡Hablen sin rodeo!	Mantener una conversación con otra u otras personas acerca de un asunto sin divagación. <font color=ForestGreen><b>vintr.imper.pl.:</b></font> Atpemo
Sus canillas	<font color=ForestGreen><b>adj.dem.:</b></font> Atsánogi
¡Jueguen!	Realizar una actividad ejercitando alguna capacidad o destreza, con el fin de divertirse o entretenerse. <font color=ForestGreen><b>vintr.imper.pl.:</b></font> Átsaru
¡Jueguen bien!	<font color=ForestGreen><b>v.imper.:</b></font> Atsarugnenajicha
¡Jueguen de una vez!	<font color=ForestGreen><b>vtr.imper.pl.:</b></font> Atsarupo
¡Sean juguetones! / Que juguetean.	<font color=ForestGreen><b>adj.pl.imper.:</b></font> Atsarusi
¡Jueguen de nuevo!	<font color=ForestGreen><b>v.imper.pl.:</b></font> Atsaruwre
¡Dénle beso!	Orden de besar a otra persona. <font color=ForestGreen><b>vtr.imper.:</b></font> Atsuka
¡Bésense!	<font color=ForestGreen><b>vtr.imper.:</b></font> Atsukka
Tela	Tejido hecho con fibras textiles, fabricado en un telar o a máquina, que se utiliza para confeccionar ropa, hacer labores, forrar diversos objetos, etc. <font color=ForestGreen><b>n.f.:</b></font> Attaji
¿Están con hipo?	Preguntar si están afectados ante el movimiento convulsivo e involuntario del diafragma que se va repitiendo a intérvalos. <font color=ForestGreen><b>n.m.interrog.pl.:</b></font> ¿Atuk'o?
Forzudo/a	Persona que tiene gran fuerza física. <font color=ForestGreen><b>adj.n.f.m.:</b></font> Atukroo'o
Fuerza	Capacidad física para realizar un trabajo o un movimiento. <font color=ForestGreen><b>n.f.:</b></font> Atúmewo
Reforzarse	Añadir nuevas fuerzas físicas mediante el alimento o bebida. <font color=ForestGreen><b>vtr.:</b></font> Atúmewina
Sus cuchillos	<font color=ForestGreen><b>adj.dem.:</b></font> ¿Atumra? <font color=purple>/</font> atumra
¡Pónganse de pie!	<font color=ForestGreen><b>vtr.imper.pl.:</b></font> Atup'egia
Sus dones	Cualidad o habilidad que alguien posee. <font color=ForestGreen><b>adj.:</b></font> Atup'o
¡Cuenten!	Numerar uno por uno los objetos o los grupos de objetos de un conjunto para determinar su cantidad. <font color=ForestGreen><b>vtr.imper.pl.:</b></font> Atúpacha
¿Ya contaron?	<font color=ForestGreen><b>vtr.interrog.pl.:</b></font> ¿Atupachopka?
Su cargo	Función de la cual una persona(s) tiene la responsabilidad en una organización, un organismo o una empresa. <font color=ForestGreen><b>n.m.adj.dem.:</b></font> Atupara'o
¡Chóquenlo!	<font color=ForestGreen><b>vintr.imper.:</b></font> Atupchegia
Sus pechos	Zona externa y delantera correspondiente a una parte del cuerpo. <font color=ForestGreen><b>adj.dem.n.f.:</b></font> Atupo
Ir al rumbo	Ir por un camino o dirección. <font color=ForestGreen><b>vtr.:</b></font> Atuppuegia
¡Arrojen!	Lanzar con fuerza una cosa con la mano hacia una determinada dirección. <font color=ForestGreen><b>vtr.pl.imper.:</b></font> Atupsigia
¡Sáquenlo!	Persona que da orden de sacar un objeto o cosas. <font color=ForestGreen><b>vtr.imper.:</b></font> Ave'a
¡Tienen que sacarlo!	Orden a un grupo sacar animales u objetos <font color=ForestGreen><b>vtr.imper.pl.:</b></font> Ave'ajno
¿Lo sacaron?	<font color=ForestGreen><b>vtr.interrog.:</b></font> Ave'po
Zafar la soga de la cabeza de un animal	<font color=ForestGreen><b>vtr.:</b></font> Avechjusgia
¡Pelen la fruta!	Quitar la piel, la cáscara, la corteza o la envoltura de una fruta. <font color=ForestGreen><b>vtr.imper.:</b></font> Avejcho'igia
¡Descascaren el palo!	Quitar la cáscara a una cosa, en especial la de un árbol. <font color=ForestGreen><b>vtr.imper.pl.:</b></font> Avejchogie'a
¡Záfenlo!	Ayudar a liberarse de algo desagradable o de alguien molesto. <font color=ForestGreen><b>vintr.pron.imper.:</b></font> Avejchu'a
¡Tráiganlo!	Orden de una persona a otras de traer una cosa u objeto. <font color=ForestGreen><b>vtr.imper.:</b></font> Avejna
¡Deberían traerlo!	Suposición o posibilidad de que tienen que traer algún objeto. <font color=ForestGreen><b>vtr.imper.:</b></font> Avejnaa'ini
¿Ya lo trajeron?	<font color=ForestGreen><b>vtr.interrog.:</b></font> ¿Avejnoripo?
¡Cosechen!	Orden de cosechar frutas de la planta. <font color=ForestGreen><b>vtr.imper.pl.:</b></font> Avejtaka
¡Québrenlo el gajo!	Desgajar una rama del árbol. <font color=ForestGreen><b>vtr.imper.pl.:</b></font> Avechtawocha
¡Vaciénlo!	Ordenar sacar el contenido de un recipiente o lugar, o verterlo en otra parte. <font color=ForestGreen><b>vtr.imper.pl.:</b></font> Avek'a
¡Desensíllenlo!	Ordenar quitar la silla de montar a un caballo u otra caballería. <font color=ForestGreen><b>vtr.imper.:</b></font> Avekgiecha
¡Desháganlo!	Orden de una persona a un grupo de deshacer, un lugar, como vivienda o pascana. <font color=ForestGreen><b>vtr.imper.:</b></font> Avettaka
Abadesa	Mujer adulta y viuda que se encarga de la limpieza de la iglesia. <font color=ForestGreen><b>n.f.:</b></font> Awaresa
¡Mandenlo!	Persona que ordena a otra persona para un mandado. <font color=ForestGreen><b>vtr.imper.sing.:</b></font> Awonigia
Agosto	Octavo mes del año. <font color=ForestGreen><b>n.m.:</b></font> Awosto
Son conversadores	Personas que tienen la facultad de hablar bien con fluidez. <font color=ForestGreen><b>adj.n.f.m.pl.:</b></font> Awoyora'i
¡Se pasaron!	Excederse al hacer algo. <font color=ForestGreen><b>v.prnl.pl.imper.:</b></font> Awoyuchpo
¡Vayan!	Orden a un grupo de que tienen que ir a algún lugar. <font color=ForestGreen><b>vtr.imper.pl.:</b></font> Ayana
¡Descansen!	Orden de hacer una pausa en el trabajo o en otra actividad para recuperar fuerzas. <font color=ForestGreen><b>vintr.imper.pl.:</b></font> Ayópapo
¡Apúrense!	Meter prisa a un grupo de personas en ejecutar algo con urgencia. <font color=ForestGreen><b>vtr.imper.pl.:</b></font> Ayoyuchapo
¡Súnchenlo!	Ordenar clavar un objeto puntiagudo o punzante en una superficie o persona. <font color=ForestGreen><b>vtr.imper.:</b></font> Ayuchchegia
Su cerco	<font color=ForestGreen><b>pron.dem.:</b></font> Ayuchmo
¡Dispárenle!	Orden de una persona a un grupo disparar a un animal o persona. <font color=ForestGreen><b>vtr.imper.pl.:</b></font> Ayúka
¡Ensarten!	Atravesar una cosa con un objeto acabado en punta: ensartar pescado, chaquira, semilla u otro objeto. <font color=ForestGreen><b>vtr.imper.pl.:</b></font> Ayukjoka
¡Escóndanlo!	Poner una cosa o a una persona en un lugar en el que no pueda ser vista. <font color=ForestGreen><b>vtr.imper.sing.:</b></font> Ayumruka
¡Pónganle soporte!	Orden de colocar soporte a un objeto, árbol, cerco que se está por caerse. <font color=ForestGreen><b>vtr.imper.:</b></font> Ayupcha
Su cántaro	<font color=ForestGreen><b>adj.poses.:</b></font> Ayupi
Su batidora	<font color=ForestGreen><b>adj.poses.:</b></font> Ayuprora
Su singa	<font color=ForestGreen><b>adj.poses.:</b></font> Ayupuiigi
Clavar algo con punta en alguna cosa colgada	<font color=ForestGreen><b>vtr.:</b></font> Ayutawaka
¡Zunchar!	<font color=ForestGreen><b>vtr.imper.:</b></font> Ayutspegia
¡Complétenlo!	Orden de completar el trabajo, medida, peso, o volcar una canoa. <font color=ForestGreen><b>vtr.imper.pl.:</b></font> Ayuutigia 
Que transmite una connotación negativa de desprecio o poco respeto	<font color=ForestGreen><b>adj.:</b></font> Aatattaji
¡Tóquenle!	Orden de tocar una puerta o ventana. <font color=ForestGreen><b>vtr.imper.:</b></font> Etaka
Tienen que saberlo	Afirmación de saber sobre un determinado mensaje o acontecimiento y decir a otras. <font color=ForestGreen><b>vtr.afirm.pl.:</b></font> Echa
¡Repitan!	Orden a un grupo de repetir acciones como lectura y aprendizaje. <font color=ForestGreen><b>vtr.imper.pl.:</b></font> Echaarijgia
Sus carnes	<font color=ForestGreen><b>adj.poses.:</b></font> Écheji
¡Córtenlo!	Orden a un grupo de cortar un árbol. <font color=ForestGreen><b>vtr.imper.:</b></font> Echka
Lo saben	Afirmación de saber un mensaje, comunicado <font color=purple>/</font> Puede funcionar como pregunta. <font color=ForestGreen><b>vtr.afirm.:</b></font> Echo
Objeto especial	preparado para personas en un acontecimiento especial. <font color=ForestGreen><b>adj.:</b></font> Échosi
¡Cuídenlo!	Orden un grupo para que cuiden una persona, objeto o animal. <font color=ForestGreen><b>vtr.imper.:</b></font> Echpojrigia
¡Cuídense!	<font color=ForestGreen><b>vtr.imper.pl.:</b></font> Echpojrigiapo
¡Levántense!	<font color=ForestGreen><b>vtr.imper.pl.:</b></font> Echpuka
¡Enlácenlo!	Persona que ordena aprisionar a un animal con un lazo: vaca, buey, caballo. <font color=ForestGreen><b>vtr.imper.:</b></font> Eesaka
¡Peguen la puerta!	Accionar el cerrojo o seguro de una puerta. <font color=ForestGreen><b>vtr.imper.pl.:</b></font> Eetaka
Pesadilla	Sueño desagradable que produce angustia, ansiedad, miedo o terror. <font color=ForestGreen><b>n.f.:</b></font> Eeye
¡Sientense!	<font color=ForestGreen><b>vtr.prnl.imper.:</b></font> Ejaka
¡Siéntense bien!	Orden de sentarse adecuadamente. <font color=ForestGreen><b>vtr.imper.adj.pl.:</b></font> Ejakagnenajicha
¡Despierten temprano!	Orden de despertar a temprana hora. <font color=ForestGreen><b>vtr.imper.pl.adv.:</b></font> Ejamigiawne
¡Buenos días!	Saludo por la mañana. <font color=ForestGreen><b>n.m.:</b></font> Ejamikpo
¡Siéntense en la cabeza!	Orden de una persona a otras de sentarse encima de la cabeza de un animal como toro, caballo. etc. <font color=ForestGreen><b>vtr.prnl.:</b></font> Ejasgia
¿Lo extrañan?	Pregunta a un grupo de personas si extrañan a otras personas del lugar. <font color=ForestGreen><b>vtr.interrog.:</b></font> ¿Ejepono?
Sus delitos	Acción contraria de una persona hacia la ley. <font color=ForestGreen><b>adj.dem.n.:</b></font> Ejiiwo
Sus errores	Afirmación de una persona a otras que sus acciones, ideas, opiniones, expresiones no están correctas. <font color=ForestGreen><b>adj.dem.n.:</b></font> Ejkojwo
Ubillo	Árbol que nace en región montañosa y que sirve para correas de amarre. <font color=ForestGreen><b>bot.n.m.:</b></font> Ejteeyeregi
Se huelen	Afirmación de percibir el olor que emana de una cosa o persona a través del olfato. <font color=ForestGreen><b>vtr.afirm.pl.:</b></font> Ejvemeko
Ventosidad	<font color=ForestGreen><b>n.m.:</b></font> Ejwako
Él	Es la forma del pronombre personal en tercera persona, en género masculino. <font color=ForestGreen><b>pron.pers.:</b></font> Ema
¡Conozcan!	<font color=ForestGreen><b>vtr.imper.pl.:</b></font> Emoti
Ellos/ellas	Forma del pronombre personal en tercera persona del plural, en género masculino o femenino. <font color=ForestGreen><b>pron.pers.:</b></font> Eno
¡Échenlo!	orden de derramar tierra en un lugar determinado. <font color=ForestGreen><b>vtr.imper.:</b></font> Epraka
¡Échenle confite, arroz, serpentina!	Exclusivo de una boda. <font color=ForestGreen><b>vtr.imper.:</b></font> Eprasgia
Bejuco	Nombre genérico con que se designa a diversas especies de plantas tropicales de tallos largos, delgados y flexibles que se utilizan en la elaboración de tejidos de cestería y fabricación de muebles y cuerdas. <font color=ForestGreen><b>bot.n.m.:</b></font> Epre
Bejucal	Terreno lleno de bejucos. <font color=ForestGreen><b>adj.n.:</b></font> Epreji
Bejucal que se cría por encima de una chapapa	<font color=ForestGreen><b>bot.n.:</b></font> Epremo
Tienen asco	Sensación de desagrado que produce alguien o algo y que impulsa a rechazarlo. <font color=ForestGreen><b>n.m.pl.afirm.:</b></font> Epru
¡Beban!	Orden de una persona a otras beber agua, cerveza, chicha, refresco, etc. <font color=ForestGreen><b>vintr.imper.pl.:</b></font> Era
No lo molesten	<font color=ForestGreen><b>n.m.neg.:</b></font> Esamijrigia
Su chaco	<font color=ForestGreen><b>adj.dem.:</b></font> Ésane
Escuela / colegio	Institución destinada a la enseñanza, en especial la primaria, que proporciona conocimientos que se consideran básicos en la alfabetización. <font color=ForestGreen><b>n.f.:</b></font> Eskaera
Escalera	Estructura constituida por una sucesión de escalones que sirve para subir y bajar o para poner en comunicación dos superficies a distinto nivel. <font color=ForestGreen><b>n.m.:</b></font> Eskarera
¡Zambúllanse!	Orden de una persona a otras de que se metan al agua. <font color=ForestGreen><b>vtr.prnl.pl.:</b></font> Esmuka
¡Guasquéenlo!	Orden de dar uno o varios golpes a personas. <font color=ForestGreen><b>vtr.imper.pl.:</b></font> Estaka
Estancia	Establecimiento rural destinado a la producción agrícola o ganadera; suele componerse de una vivienda y una extensión de tierra. <font color=ForestGreen><b>n.f.:</b></font> Estas'io
¡Azoten!	Orden de una persona a otras de ahuyentar a ciertos insectos como ser moscas, mosquitos, etc. <font color=ForestGreen><b>vtr.imper.pl.:</b></font> Estasgia
Salpicar	Acción de lanzar la vara de pescar repetitivamente al agua para atraer a los peces. <font color=ForestGreen><b>vtr.:</b></font> Estatéko
Estera	Tejido de cogollo de motacú, hoja de chuchío, junquillo, etc. <font color=ForestGreen><b>n.f.:</b></font> Estera
¡Corten!	Orden de una persona a otras de talar árbol, cortar carne. <font color=ForestGreen><b>vtr.imper.:</b></font> Estigia
¡Corten palo o trocen!	Orden de una persona a otras de trozar un árbol, picar y hueso. <font color=ForestGreen><b>vtr.imper.:</b></font> Estirigia
Ella	Forma del pronombre personal en tercera persona del singular en género femenino. <font color=ForestGreen><b>pron.pers.f.:</b></font> Esu
¡Remojen!	Orden de una persona a otras para que remojen cuero, bolsa o ropa. <font color=ForestGreen><b>vtr.imper.pl.:</b></font> Etamu'egia
¡Dénle en la cabeza!	Orden de una persona a otras golpear en la cabeza a un animal con el fin de matarlo. <font color=ForestGreen><b>vtr.imper.:</b></font> Etasgia
¡Salten!	orden de una persona a otras de saltar. <font color=ForestGreen><b>vintr.imper.pl.:</b></font> Eteregia
Ustedes	Pronombre personal en plural en segunda persona. <font color=ForestGreen><b>pron.pers.pl.:</b></font> Eti
Un, una	Indica indeterminación al referirse a personas o cosas. det.indef.m.f.: Etna
Éso, Ésa	Indica una cosa no determinada que está cerca de la persona a la que se habla o en un lugar no muy alejado de la persona que habla o escribe.  <font color=ForestGreen><b>pron.dem.:</b></font> Eto.  <font color=purple>Ej1:</font> Dame eso que está sobre la mesa. <font color=purple>/</font> <font color=blue>Pyoma eto tyow'o te mesa.</font>  <font color=purple>Ej2:</font> Trae esa silla. <font color=purple>/</font> <font color=blue>Pyoma eto siya.</font>
¡Eso nomás!	Equivalen a oraciones que expresan un sentimiento vivo. <font color=ForestGreen><b>interj.:</b></font> Etochujcha
Uno	Es el primer número natural y también es el número entero que sigue al cero y precede al 2. <font color=ForestGreen><b>adv.num.:</b></font> Etona
¡Uno nomás!	Frase exhortativa coloquial de dar mayor énfasis algo. <font color=ForestGreen><b>interj.:</b></font> Etonarichu
Enumerar: un, uno, una	un fierro, un clavo, una flecha, aguja, anzuelo. <font color=ForestGreen><b>adv.cant.:</b></font> Etopa.  <font color=purple>Ej1.</font> Una aguja <font color=purple>/</font> <font color=blue>etopa priipa.</font>  <font color=purple>Ej2.</font> Un clavo <font color=purple>/</font> <font color=blue>etopa krawo.</font>
Debería ser eso/esa	Se utiliza cuando no esta satisfecho en alguna compra o negocio.  <font color=purple>Ej.</font> Debería ser esta vaca que hubieras comprado. <font color=purple>/</font> <font color=blue>Etori'ini pjoka waka jwachrigiari'ini.</font> <font color=ForestGreen><b>vtr.cond.:</b></font> Etori'ini
¡Eso nomás quiere!	Se utiliza para referirse a un animal que solo quiere comer, estar en un solo lugar, ya sea por gusto o por dañino.  <font color=purple>Ej.</font> El caballo eso nomas quiere comer. <font color=purple>/</font> <font color=blue>Etoyumja tawoo'o tanigia to kwoyu.</font> <font color=ForestGreen><b>interj.:</b></font> Etoyumja
¡Agáchense!	Orden de una persona a otras de que se agachen. <font color=ForestGreen><b>vtr.imper.pl.:</b></font> Etpuegia
¡Siembren!	Orden de una persona a otras de que siembren en su chaco. <font color=ForestGreen><b>vtr.imper.pl.:</b></font> Ewka
¡Mezan!	Orden de una persona a otra de mecer la hamaca. <font color=ForestGreen><b>vtr.imper.pl.:</b></font> Ewko
Plato	Utensilio para servir alimento comestible. <font color=ForestGreen><b>n.m.:</b></font> Krujo
Mantel	Pieza de tela, papel o plástico con que se cubre la mesa para comer. <font color=ForestGreen><b>n.m.:</b></font> Mantéresi
Sagrado	Que merece un respeto excepcional y no puede ser ofendido. <font color=ForestGreen><b>adj.:</b></font> Muemmo
Monte virgen	Monte, bosque, laguna, pampa, que no ha sido alcanzado por el hombre. <font color=ForestGreen><b>n.m.:</b></font> Myujto
Virginidad	Estado de la persona que es virgen, que no ha tenido nunca relaciones sexuales. <font color=ForestGreen><b>n.f.:</b></font> Mjoore, myutta
Violación	Delito que consiste en tener relaciones sexuales con una persona sin su consentimiento o con un consentimiento obtenido mediante la violencia o la amenaza. <font color=ForestGreen><b>n.f.:</b></font> Napikucha
¡Alineen!	Orden de sembrar, alambrar, postear en línea recta. <font color=ForestGreen><b>n.f.imper.pl.:</b></font> Nápikucha
Amor	Sentimiento de vivo afecto e inclinación hacia una persona o cosa a la que se le desea todo lo bueno. <font color=ForestGreen><b>n.m.:</b></font> Taemnarapi
Asilo	Lugar de acogida de ancianos. <font color=ForestGreen><b>n.m.:</b></font> Takomjírawo
Violador	Persona que comete una violación sexual, física y psicológica. <font color=ForestGreen><b>adj.m.:</b></font> Tapikúra'i
Apodo	Nombre que se da a una persona en vez del suyo propio y que, generalmente, hace referencia a algún defecto, cualidad o característica particular que lo distingue. <font color=ForestGreen><b>n.m.:</b></font> Tkiijaja'okre
Agua	Elemento líquido que es indispensable para la vida. <font color=ForestGreen><b>n.f.:</b></font> Une
Árbol o planta de tronco leñoso, grueso y elevado	que se ramifica a cierta altura del suelo formando la copa. <font color=ForestGreen><b>n.m.:</b></font> Wkugi
Hacha	Herramienta para cortar madera, en especial árboles y ramas, que consiste en una pieza de metal. <font color=ForestGreen><b>n.f.:</b></font> Eywoti
¡Miren, observen!	Mirar algo o alguien con atención y detenimiento para adquirir conocimiento. <font color=ForestGreen><b>vtr.imper.pl.:</b></font> Im'a
¡Vayan a verlo!	Orden de una persona a otras que vayan a ver.  <font color=purple>Ej.</font> Vayan ver la canoa. <font color=ForestGreen><b>vtr.imper.pl.:</b></font> Imojna
¡Muéstrenlo!	Exponer una cosa de manera que pueda ser vista. <font color=ForestGreen><b>vtr.imper.:</b></font> Imerigia
¡Muéstrenme!	<font color=ForestGreen><b>vtr.imper.:</b></font> Imechanu
¡Muéstrense!	Orden de una persona a otras para que se muestren en un lugar determinado. <font color=ForestGreen><b>vtr.imper.pl.:</b></font> Imerígiapo
¡Llámenme!	Orden de una persona a otras de que tienen que comunicarse con él o ella. <font color=ForestGreen><b>vtr.imper.:</b></font> Ich'anu
¡Llámalo!	Persona que ordena a otra a que convoque a cierta persona. <font color=ForestGreen><b>vtr.imper.:</b></font> Ich'a
¡Deténganse!	Orden de una persona a un grupo para que paren la actividad que están realizando. <font color=ForestGreen><b>vtr.prnl.imper.:</b></font> Ichigia
¡Deténganse inmediatamente!	Persona que ordena a otras que se detengan de inmediato. <font color=ForestGreen><b>vtr.prnl.imper.:</b></font> Ichígiapo
¡Tienen que revivir!	<font color=ForestGreen><b>vintr.imper.:</b></font> Itorigiapo
¡Lleguen!	Persona que sugiere a otras a que lleguen al lugar. <font color=ForestGreen><b>vintr. Imper.pl.:</b></font> Itekpa.  <font color=purple>Ej.</font> Lleguen a pescar a la laguna. <font color=purple>/</font> <font color=blue>Itekpa engia te kogiure.</font>
¡Tienen que llegar!	Orden de una persona a otras que tienen que llegar si o si al lugar. <font color=ForestGreen><b>cond.imper.pl.:</b></font> Itekpajnotse
¿Conocen?	Pregunta de la acción de conocer. <font color=ForestGreen><b>vtr.interrog.pl.:</b></font> ¿Imoti?  <font color=purple>Ej.</font> ¿Conocen el Instituto? <font color=purple>/</font> <font color=blue>¿Imoti to takarawo'irare?</font>
¡Gánenlo!	Ordenar ganar un concurso, juego, competencia, etc. <font color=ForestGreen><b>vtr.imper.pl.:</b></font> Ito'aka
¿Perdieron?	Dejar de poseer determinada cosa a causa de alguna circunstancia. <font color=ForestGreen><b>vtr.interrog.pl.:</b></font> ¿Íto'a?
Sangre	Líquido, de color rojo en los vertebrados, que, impulsado por el corazón. <font color=ForestGreen><b>n.f.:</b></font> Iti
Comida exótica elaborada con sangre de la vaca	<font color=ForestGreen><b>n.f.:</b></font> Ítipa
¡Amárrenlo!	Atar o asegurar una cosa o persona por medio de cuerdas, cadenas, etc. <font color=ForestGreen><b>vtr.imper.:</b></font> Itipaka
Cabeza ensangrentado	Persona, animal que tiene la cabeza con sangre ya sea por alguna herida. <font color=ForestGreen><b>adj.:</b></font> Ítisi
Ensangrentado	Exclusivo para persona, animal manchado de sangre. <font color=ForestGreen><b>adj.:</b></font> Itiripo
Agua ensangrentada	<font color=ForestGreen><b>adj.:</b></font> Ityomo
Espacio o piso manchado de sangre	<font color=ForestGreen><b>adj.:</b></font> Ichchoropa'i
Manechi	Nombre genérico con que se designa a cualquiera de los primates oriundos del Beni. <font color=ForestGreen><b>zool.n.m.:</b></font> Ichi
Gusano burro	Gusano venenoso que es peludo de diferentes colores. <font color=ForestGreen><b>zool.n.m.:</b></font> Ichijiyo'o
¡Terminen!	Orden de terminar un trabajo o actividad. <font color=ForestGreen><b>vtr.imper.pl.:</b></font> Ita
¡Termínenlo ya!	Orden de terminar de inmediato la actividad o trabajo. <font color=ForestGreen><b>vtr.imper.pl.:</b></font> Itapo
Mono Martín	Mamífero que habita en las selvas del oriente, Chaco y Amazonía. <font color=ForestGreen><b>zool.n.m.:</b></font> Iyo
¡Visiten!	Persona que ordena a otras que vayan a visitar. <font color=ForestGreen><b>vtr.imper.pl.:</b></font> Imorigia
¡No dejen de mirar!	<font color=ForestGreen><b>adv.neg.imper.pl.:</b></font> Imooroka
¿Conocen?	<font color=ForestGreen><b>vtr.interrog.pl.:</b></font> IImoti
¿Lo vieron?	<font color=ForestGreen><b>vtr.interrog.:</b></font> Im'o
¿Ya lo vieron?	<font color=ForestGreen><b>vtr.interrog.:</b></font> Im'oripo
¿Tienen que cuidarlo?	<font color=ForestGreen><b>vtr.interrog.:</b></font> Im'ajnotsero
¡Envuélvanlo!	Cubrir completamente una cosa o a una persona rodeándola o ciñéndola con algo. <font color=ForestGreen><b>vtr.imper.:</b></font> In'oka
¡Háganle entender!	<font color=ForestGreen><b>vtr.imper.:</b></font> Imnekpa
¡Pónganse a envolver!	Orden para que se pongan a envolver como ser: encomienda, alimento, etc. <font color=ForestGreen><b>vtr.imper.:</b></font> In'origia
¿Ya lo envolvieron?	<font color=ForestGreen><b>vtr.interrog.:</b></font> In'okripo
No se olviden de envolverlo	Encargo por otra persona de que tienen que envolver algo. <font color=ForestGreen><b>vtr.cond.:</b></font> In'okajnotsero
¿Lo enrollaron?	<font color=ForestGreen><b>vtr.interrog.:</b></font> In'okpo
¡Báñenme!	Persona que solicita que lo bañen. <font color=ForestGreen><b>vtr.prnl.imper.:</b></font> Ikchanu
¡Báñenlo!	Orden de una persona a otra para bañen a una persona o animal. <font color=ForestGreen><b>vtr.imper.:</b></font> Ikcha
¡Échenle agua a su cuerpo!	<font color=ForestGreen><b>vtr.imper.:</b></font> Ikcho'oka
¿Terminaron de hablar?	<font color=ForestGreen><b>vtr.interrog.pl.:</b></font> Itempo
¿Ya dejaron de hablar?	<font color=ForestGreen><b>vtr.interrog.pl.:</b></font> Itemripo
¿Entendieron?	<font color=ForestGreen><b>vtr.interrog.pl.:</b></font> Itemchoripo
¿Están carpiendo?	Limpiar o sacar hierba inútil o perjudicial. <font color=ForestGreen><b>vtr.interrog.pl.:</b></font> Iso'o
¿Ya están carpiendo?	<font color=ForestGreen><b>vtr.interrog.pl.:</b></font> Iso'oripo
Certificado de Bautismo	Documento o escrito en el que se certifica o da por verdadera una cosa. Bautizado en una religión. <font color=ForestGreen><b>adj.:</b></font> Ikchosi
¿Están regando?	<font color=ForestGreen><b>vtr.interrog.pl.:</b></font> Ikchoriko
¡Bailen!	Orden de que tienen que bailar o danzar. <font color=ForestGreen><b>vtr.imper.pl.:</b></font> Iimuigia
Ponerse apodos	Poner un nombre o un apodo a una persona, animal o cosa. <font color=ForestGreen><b>vtr.afirm.:</b></font> Iijajakwo
¡Enseñenlo!	<font color=ForestGreen><b>vtr.imper.:</b></font> Imitka
¡Duerman!	Orden para que reposar. <font color=ForestGreen><b>vtr.imper.:</b></font> Imka
Sus suegros	<font color=ForestGreen><b>adj.dem.pl.m.:</b></font> Imchuko
Sus suegras	<font color=ForestGreen><b>adj.dem.pl.f.:</b></font> Imse
¡Aprendan!	Orden de que tienen que aprender. <font color=ForestGreen><b>vtr.imper.pl.:</b></font> Itka
¡Entiéndase!	Orden que tienen que llegar a un acuerdo o solución entre ellos. <font color=ForestGreen><b>vtr.imper.pl.:</b></font> Itkoka
¿Están tejiendo? / Están tejiendo.	Afirmación de que están tejiendo <font color=purple>/</font> Pregunta si están tejiendo. <font color=ForestGreen><b>vtr.interrog.afirm.pl.:</b></font> Itsmeriko <font color=purple>/</font> ¿Itsmeriko?
Cambiar frecuentemente	Orden de cambiar algo, como ser música, vestimenta, objeto. <font color=ForestGreen><b>vtr.imper.:</b></font> Itswowojigia
Cada rato cambian	Persona que afirma que cada vez o momento cambian como ser: vestimenta, comida, música. <font color=ForestGreen><b>vtr.adv.:</b></font> Itswowojiko
¡Amarren!	Atar o asegurar una cosa por medio de cuerdas. <font color=ForestGreen><b>vtr.imper.pl.:</b></font> Itinukcha <font color=purple>/</font> itnukcha
¿Van a terminar?	Interrogativo para saber si lo acabaran alguna actividad. <font color=ForestGreen><b>vtr.interrog.pl.:</b></font> Ittoo'oyre
¡Consigan algo!	Mandato de obtener algo que se pretende. <font color=ForestGreen><b>vtr.imper.pl.:</b></font> Itpapajgiapo
Tienen que conseguir algo	<font color=ForestGreen><b>vtr.cond.:</b></font> Itpapajkowyore
Lo tienen que poder / ¿Lo van a poder?	<font color=ForestGreen><b>vtr.cond.afirm.pl.:</b></font> Itrukyore
¡Cambien!	Entregar o cambiar algo al vendedor.  <font color=ForestGreen><b>vtr.imper.pl.:</b></font> Itswocha
¡Muéstrenlo!	<font color=ForestGreen><b>vtr.imper.:</b></font> Imecha
¿Ya lo mostraron?	<font color=ForestGreen><b>vtr.interrog.:</b></font> Imechripo
Cambiar	Poner una cosa o una persona en el lugar o puesto de otra. <font color=ForestGreen><b>vtr.:</b></font> Itswojgia
Arcoíris	Banda luminosa con forma de arco que presenta los colores del espectro solar y aparece a veces en el cielo, debido a la refracción y reflexión de la luz del sol en las gotas de lluvia. <font color=ForestGreen><b>n.m.:</b></font> O'e
Urina	Animal silvestre de las pampas y selvas. <font color=ForestGreen><b>zool.:</b></font> Ona
Allá, allí	Indica de forma poco precisa un lugar alejado de la persona que habla y de la que ecucha. <font color=ForestGreen><b>adv.l.:</b></font> Onogi
Pica, pica	Planta. Existen dos tipos de plantas, que se encuentra en la Amazonia como también en la serranía y que sirve de medicina natural. <font color=ForestGreen><b>bot.:</b></font> Ótino
Hormigas negras	Insecto de color negro, tienen mal olor y caminan en grupo. Su aparición anuncia mal tiempo (lluvia). <font color=ForestGreen><b>zool.n.f.:</b></font> Ososori
Aquí	Indica el lugar en el que está la persona que habla o escribe, o un lugar próximo a él. <font color=ForestGreen><b>adv.l.:</b></font> Oni
Borochi	Animal silvestre de pampas. <font color=ForestGreen><b>zool.:</b></font> Okromo
¿Cuánto?	Introduce una pregunta sobre la cantidad, el tamaño, el número, etc. determ.num.interrog.: Oyna
¿Dónde estás?	Introduce una pregunta de lugar. <font color=ForestGreen><b>adv.l.interrog.:</b></font> Oyvi
Más acá	Indica de forma poco precisa el lugar donde se encuentra una persona. <font color=ForestGreen><b>adv.l.:</b></font> Oniye'e
¿Dónde es?	Persona que pregunta donde queda la dirección, ruta o lugar de una persona, objeto o cosas. <font color=ForestGreen><b>adv.l.interrog.:</b></font> Oypuka
Desprecio	Falta de aprecio hacia una persona o algún animal. <font color=ForestGreen><b>n.m.:</b></font> Oytataji
Jucumari	Personaje mítico de la selva. Similar a un hombre salvaje. <font color=ForestGreen><b>mit.:</b></font> U'ari
Capibara	Mamífero roedor. Animal silvestre de las pampas y ríos de mojos. <font color=ForestGreen><b>zool.n.m.:</b></font> Uchu
Agua	Elemento líquido y esencial para la supervivencia de toda la humanidad. <font color=ForestGreen><b>n.f.:</b></font> Une
Nube	Masa visible suspendida en la atmósfera, de color y densidad variable, formada por la acumulación de partículas diminutas de agua. <font color=ForestGreen><b>n.f.:</b></font> Úkoji
Yoperojobobo	Serpiente, vibora muy venenosa que vive en las bajuras, pampas y selvas. <font color=ForestGreen><b>zool.n.f.:</b></font> Úsepi
Pozas de agua	Espacio de agua detenida en los bajios, montes, cerros y pampas. <font color=ForestGreen><b>n.f.pl.:</b></font> Unekure
Diarrea	Alteración intestinal que se caracteriza por alguna enfermedad malestar estomacal que se da con mayor frecuencia, en las personas o animales.  <font color=ForestGreen><b>n.f.:</b></font> Unechkore
Mudo	Persona que tiene discapacidad física en las cuerdas vocales. No habla. <font color=ForestGreen><b>adj. n.f.m.:</b></font> Upa
Personaje mítico que tenía poderes en el pueblo trinitario	<font color=ForestGreen><b>mit.:</b></font> Chawre
Mosquitero	Ropaje. Cortina de tejido fino casi transparente, como gasa, que cuelga sobre una cama cubriéndola por completo para impedir el ingreso de insectos. <font color=ForestGreen><b>n.m.:</b></font> Chaku
Charque	Carne salada que se ha dejado secar al aire o al sol para que pierda humedad y se conserve más tiempo. <font color=ForestGreen><b>n.m.:</b></font> Cháragi
Comida	Sustancia sólida que se come y sirve de alimento <font color=ForestGreen><b>n.f.:</b></font> Charuji
Serere	Ave silvestre de la orilla de las lagunas. <font color=ForestGreen><b>zool.n.m.:</b></font> 'Chavesi
Ají	Planta herbácea americana con diferentes sabores de picante. <font color=ForestGreen><b>bot.n.m.:</b></font> 'Cheti
Cuchillo	Utensilio para cortar que consiste en una hoja de metal generalmente alargada y afilada por un solo lado, a veces puntiagudo, con un mango de metal, madera u otro material. <font color=ForestGreen><b>n.m.:</b></font> 'Chátrope
General	Pez comestible de los ríos de la Amazonía. <font color=ForestGreen><b>zool.:</b></font> 'Chugiesi
Sal	Sustancia blanca, cristalina que le da sabor a la comida. <font color=ForestGreen><b>n.f.:</b></font> 'Cheve
Mutún	Ave de color negro o gris, de montes y pampas. <font color=ForestGreen><b>zool.:</b></font> Chuni
Zorro	Animal silvestre de las pampas y ríos. <font color=ForestGreen><b>zool.n.m.f.:</b></font> Chuye
Pugilla (mosquito)	Insecto punsante mayormente que habitan en las pampas. <font color=ForestGreen><b>zool.:</b></font> Chupi
Grande	<font color=ForestGreen><b>adj.:</b></font> 'Chope
Sabayón	Insecto lombríz de tierra que se utiliza para carnada en la pesca. <font color=ForestGreen><b>zool.n.f.:</b></font> Chepi
Color verde lechuga	<font color=ForestGreen><b>n.m.adj.:</b></font> Chora
Sabalina	Pez de río con escamas muy menudas. <font color=ForestGreen><b>zool.:</b></font> Chororo
Toco / taburete	<font color=ForestGreen><b>n.m.:</b></font> Chumo
Mosca	Insecto de cuerpo negro de unos 6 mm de largo, con dos alas transparentes cruzadas de nervios. Ojos grandes y salientes, y un aparato bucal para chupar las sustancias de las que se alimenta. <font color=ForestGreen><b>zool.:</b></font> 'Chuve
Sicurí (anaconda)	Boa semi-acuática que mayormente vive en el agua de los ríos profundos. <font color=ForestGreen><b>zool.:</b></font> Churu
Chirimoya	Fruto del chirimoyo, del tamaño aproximado de una manzana, de color verde. <font color=ForestGreen><b>bot.:</b></font> Chiimoya
Mazorca	Espiga grande, formada por granos gruesos y apretados: fruta del árbol de chocolate. <font color=ForestGreen><b>bot.:</b></font> Chukrate
Árbol	Planta de tronco leñoso, grueso y elevado que se ramifica a cierta altura del suelo formando la copa: árbol del chocolate <font color=ForestGreen><b>bot.:</b></font> Chukrategie
Cabello	Pelo de la cabeza de una persona. <font color=ForestGreen><b>n.m.:</b></font> Chutmoko
Cabello	Pelo que se encuentra en un lugar o depósito. <font color=ForestGreen><b>n.m.:</b></font> Chtimkore
Cabeza	Puede ser de animal o persona encontrada en un lugar. <font color=ForestGreen><b>n.f.anat.:</b></font> 'Chtire
Sabayonera o criadero de lombrices	<font color=ForestGreen><b>adj.n.f.:</b></font> 'Cheprisi
Camino	franja de terreno donde se puede transitar. <font color=ForestGreen><b>n.m.:</b></font> 'Chene
Seno, pecho/senos, pechos	Órgano glandular de las hembras de los mamíferos que produce la leche que sirve para alimentar a las crías. <font color=ForestGreen><b>n.f.anat.pl.sing.:</b></font> Chene <font color=purple>/</font> cheñono
Redondo	Objeto que tiene forma circular o esférica. <font color=ForestGreen><b>adj.:</b></font> 'Choyoro
Turbio	Agua de ríos, lagunas que están alterado por una cosa que le quita la transparencia o la claridad. También se utiliza para referirse a otros líquidos. <font color=ForestGreen><b>adj.:</b></font> Chipyomo
Sucio	Que no cuida su higiene personal, o descuida la limpieza de su ropa o de sus cosas. <font color=ForestGreen><b>adj.:</b></font> Chípeji
Persona sucia	Personas que están sucias por trabajo, borrachera, etc. <font color=ForestGreen><b>adj.:</b></font> Chípe'o
Salmuera	Agua saturada de sal. <font color=ForestGreen><b>n.f.:</b></font> 'Chevyomo
Tarope	Planta acuática que tiene forma deslumbrante. <font color=ForestGreen><b>bot.:</b></font> 'Cheveji
Taropal	Lugar de taropes, en lagunas o en ríos. <font color=ForestGreen><b>bot.:</b></font> 'Chevejikre
Enano / pequeño	Persona o animal de baja estatura. <font color=ForestGreen><b>adj.n.f.m.:</b></font> 'Chichchu
Excremento	Materia compuesta de residuos de alimento que el organismo elimina por el ano tras haber hecho la digestión. <font color=ForestGreen><b>n.m.:</b></font> 'Chigi
Tigre/jaguar	Mamífero felino feroz, temible; que viven en los bosques amazónicos. <font color=ForestGreen><b>zool.:</b></font> 'Chini
Machetero	Persona que baila la danza típica del machetero, baile propio del Beni. <font color=ForestGreen><b>n.m.:</b></font> Chriperu
Carachupa	Animal mamífero marsupial, omnívoro y nocturno del monte que ataca a los gallineros. <font color=ForestGreen><b>zool.n.f.:</b></font> Chrisi
Morral, mochila, bolsón	Sirve para llevar alimento, material, etc. <font color=ForestGreen><b>n.f.:</b></font> Chmoro
Pez Raya	Similar a la raya de tamaño gigante que vive en aguas profundas. <font color=ForestGreen><b>zool.:</b></font> Chrumere
Verde retoño	Color verde retoño: liñada, soga, cable, etc <font color=ForestGreen><b>adj.:</b></font> Chorapi
Peto o avispa	Insecto que segrega liquido que causa dolor fuerte al picar. <font color=ForestGreen><b>zool.:</b></font> Jane
Fécula de chivé	Alimento elaborado de la yuca, propio de la Amazonia. Harina de yuca. <font color=ForestGreen><b>n.f.:</b></font> Jarina
Afirmación / verdad	<font color=ForestGreen><b>n.f.:</b></font> Je'chu
Pez	Animal vertebrado acuático provisto de aletas, con el cuerpo generalmente cubierto de escamas, respira por branquias y se reproduce por huevos. <font color=ForestGreen><b>zool.:</b></font> Jimo
Pescado preparado para el consumo humano	<font color=ForestGreen><b>n.f.:</b></font> Jimueche
Culebra / chicotillo	Reptil que tiene la forma de un chicotillo que ataca con su cola como chicoteando. <font color=ForestGreen><b>zool.:</b></font> Jimtsugi
Raya	Familia de los peces, es acuático, tiene forma redondeada. <font color=ForestGreen><b>zool.:</b></font> 'Jínomo
Vestido	Prenda de vestir de una dama que encuentra en un lugar especifico. <font color=ForestGreen><b>n.m.:</b></font> Jmú'i
Ictiófago(a)	Persona, animal o ave que le gusta comer carne de pescado. <font color=ForestGreen><b>adj.zool.:</b></font> Jimomore
Uña	Placa cornea dura que protege la parte superior de la punta de los dedos del hombre y de otros vertebrados. <font color=ForestGreen><b>n.f.:</b></font> Jipño
Chiriguano	Tipo de peto o avispa que pica y posee un aguijón que provoca picaduras muy dolorosas. <font color=ForestGreen><b>zool.:</b></font> Jisgi
Ambaibo	Árbol que crece cerca de los ríos y bosques de la región amazónica. <font color=ForestGreen><b>bot.:</b></font> Joyno
Horno	Aparato elaborado de barro o ladrillo para la cocción de pan de arroz, pan, carne, etc. <font color=ForestGreen><b>n.m.:</b></font> Joono
Barriga	Vientre, cavidad abdominal de los vertebrados que contiene diversos órganos del cuerpo. <font color=ForestGreen><b>anat.n.f.:</b></font> Ju'e
Baboso	Persona o animal que echan baba por la boca. <font color=ForestGreen><b>adj.:</b></font> Juve
Pava campanilla	Ave que vive en las selvas y pampas que se alimenta de frutas e insectos. <font color=ForestGreen><b>zool.:</b></font> Juvi
Ahora	Indica el momento mismo en el que se habla, está o escribe. <font color=ForestGreen><b>adv.t.:</b></font> Juiti.  <font color=purple>Ej.</font> Ahora, llegamos a Trinidad. <font color=purple>/</font> <font color=blue>Juiti vitekpoyre te trinra.</font>
Más un rato	<font color=ForestGreen><b>loc.adv.:</b></font> Juitney'e.  <font color=purple>Ej.</font> Voy mas rato a la casa. <font color=purple>/</font> <font color=blue>Juitney'e nñonño te peti.</font>
Ahorita	Indica un momento muy próximo al presente, inmediatamente antes o después del momento que se habla, está o escribe. <font color=ForestGreen><b>adv.t.:</b></font> Juitrichu.  <font color=purple>Ej.</font> Ahorita voy. <font color=purple>/</font> <font color=blue>Juitrichu nutekyo.</font>
Jueves	Cuarto día de la semana. <font color=ForestGreen><b>n.m.:</b></font> Juévesi
¡Andá traé!	Orden de una persona a otra de que tiene que traer algún objeto. <font color=ForestGreen><b>vtr.imper.:</b></font> Jvejna
Urupé	Cernidor que sirve para apartar del grano más grande a los más menudos. <font color=ForestGreen><b>n.m.:</b></font> Jremo
Estrella	Astro o cuerpo celeste que brilla con luz propia en el firmamento. <font color=ForestGreen><b>n.f.:</b></font> Jraeegi
Canastilla	Cesta pequeña de mimbre utilizada por las señoras para sacudir el algodón para que salga la suciedad. <font color=ForestGreen><b>n.f.:</b></font> Jre'i
Calzonsillo / calzón	Ropa interior. En idioma trinitario la misma palabra es usada para los dos géneros de ropa. <font color=ForestGreen><b>n.m.:</b></font> Kaasonsiyu
Camote	Planta trepadora comestible dulce de color amarillo, blanco y morado. <font color=ForestGreen><b>bot.:</b></font> Kaere
Camisa	Prenda de vestir. <font color=ForestGreen><b>n.f.:</b></font> Kamisa
Catalina	Nombre de persona de sexo femenino. <font color=ForestGreen><b>n.:</b></font> Katarina
Carretón	Medio de transporte elaborado de madera que es jalado por bueyes. <font color=ForestGreen><b>n.m.:</b></font> Kareta
Tucura	Grillo. Insecto que vive en los montes, pampa y yomomo. <font color=ForestGreen><b>zool.:</b></font> Katsa
Café	Semilla del cafeto. <font color=purple>/</font> También se utiliza para referirse al color café. <font color=ForestGreen><b>bot.n.m.:</b></font> Kajve
Plátano	Fruto del platanero. Comestible. <font color=ForestGreen><b>bot.n.m.:</b></font> Keeno
Penga del plátano	Conjunto de frutos que están sostenidos por un mismo tallo. <font color=ForestGreen><b>n.m.:</b></font> Keenochowa
Raíz del plátano	Órgano de la planta, desprovisto de hojas y generalmente introducido en la tierra. <font color=ForestGreen><b>bot.n.m.:</b></font> Keenochpu
Hoja de plátano	<font color=ForestGreen><b>bot.n.f.:</b></font> Keenopoko
Conejo silvestre	Animal mamífero de la selva y monte. <font color=ForestGreen><b>zool.:</b></font> Kaeiji
Pala	Herramienta utilizada para carpir, cavar. <font color=ForestGreen><b>n.f.:</b></font> Kaeicha (kicha)
Querosén	Líquido inflamable. Combustible. <font color=ForestGreen><b>n.m.:</b></font> Kirosena
Chuchió	Planta gramínea perenne, cuyo tallo puede alcanzar hasta 10 m de altura. Crece en las orillas de algunos ríos. <font color=ForestGreen><b>bot.:</b></font> Krino
Clase formada por aves	<font color=ForestGreen><b>zool.:</b></font> Koyre
Luna / Mes	Astro, satélite natural de la Tierra, que gira alrededor de ella y refleja la luz del Sol. <font color=ForestGreen><b>n.f.:</b></font> Koje
Guayabochi	Árbol maderable. <font color=ForestGreen><b>bot.:</b></font> Kojegie
Algodón	Planta. Fibra natural que se obtiene del algodón y se utiliza en industria textil. <font color=ForestGreen><b>bot.:</b></font> Kjoregie
Motacusillo	Variedad de la planta del guineo comestible. <font color=ForestGreen><b>bot.:</b></font> Kochigira
Pacai	Fruta propia de América del Sur. Fruto dulce. <font color=ForestGreen><b>bot.:</b></font> Kópopi
Caña	Caña de tallo leñoso que está lleno de un tejido esponjoso y dulce del que se extrae el azúcar. <font color=ForestGreen><b>bot.:</b></font> 'Kuteno
Yuca	Tubérculo comestible. <font color=ForestGreen><b>bot.:</b></font> Kujpa
Hormiga	Variedad exclusiva de hormiga. <font color=ForestGreen><b>zool.:</b></font> Kchiru
Achachairú	Planta y fruto exótico de la Amazonia. <font color=ForestGreen><b>bot.:</b></font> Kchicheru
Cusiré	Tubérculo de color morado y blaco comestible. <font color=ForestGreen><b>bot.:</b></font> Ktsire
Clavo	Material de acero exclusivo para clavar cosas. <font color=ForestGreen><b>n.m.:</b></font> Krawo
Tucán	Ave pico grande de las pampas de mojos. <font color=ForestGreen><b>zool.:</b></font> Knore
Cuervo	Ave solitaria, omnívora, monógama de río. <font color=ForestGreen><b>zool.:</b></font> Ktino
Lagarto	Reptil que vive en los ríos y lagunas. <font color=ForestGreen><b>zool.:</b></font> Kjiure
Anguila	Pez con cuerpo de serpiente. Vive en los ríos y lagunas de la Amazonía. <font color=ForestGreen><b>zool.:</b></font> Ktírepi
Bagre	Pez del río muy común del Mamoré y otros ríos. <font color=ForestGreen><b>zool.:</b></font> Ktoru
Curichi	Espacios de acumulados de agua donde especies de plantas como el junco viven. <font color=ForestGreen><b>n.m.coloq.:</b></font> Kricheji
Bagre	Especie de Bagres o pez de color cristalino, pardusco dependiendo del color de agua. <font color=ForestGreen><b>zool.:</b></font> Kyúrare
Hoja de chuchió	Especie de hierba que sirve para elaborar artesanía y techos de casa. <font color=ForestGreen><b>bot.:</b></font> Krinopoko
Totaí	Árbol de palmera que crece en las pampas de la Amazonía. <font color=ForestGreen><b>bot.:</b></font> Kyara
Tejón	Mamífero, carnívoro, silvestre de las selvas. <font color=ForestGreen><b>zool.:</b></font> Kpeji
Tucancillo	Ave mediana de las pampas y selvas de la Amazonía. <font color=ForestGreen><b>zool.:</b></font> ktso'i
Ciervo	Mamífero rumiante, silvestre que vive en los pantanos. Yom omales de la Amazonía. <font color=ForestGreen><b>zool.:</b></font> Kjowo
Marayaú	Plantas con espinas que crecen en las selvas y montes. <font color=ForestGreen><b>bot.:</b></font> Kyagi
Pájaro Carpintero	Ave silvestre de las selvas y pampas. <font color=ForestGreen><b>zool.:</b></font> Kyowre
Carayana	Seudónimo o apodo a los grupos de poder no considerados indígenas. Descendientes de los españoles. <font color=ForestGreen><b>adj.coloq.:</b></font> Króyono
Plato	Utensilio de cocina útil para servir los alimentos. <font color=ForestGreen><b>n.m.:</b></font> Krujo
Doradillo	Pez que habita mayormente en las cachuelas de los ríos. <font color=ForestGreen><b>zool.:</b></font> Krujpangi
Puerto	Lugar de desembarco de barcos, canoas, pontones o también se utiliza para referirnos a un cruzadero. <font color=ForestGreen><b>n.m.:</b></font> Kwooku
Caballo	Mamífero herbívoro doméstico útil para transporte y la ganadería. <font color=ForestGreen><b>zool.:</b></font> Kwoyu
Buey caballo	Buey que es utilizado como caballo que es útil para transporte y carga. <font color=ForestGreen><b>zool.:</b></font> Kwoysumu
Mata caballo	Insecto casi parecido a la tucura, que vive en las pampas, bajío. <font color=ForestGreen><b>zool.:</b></font> Kwoyette
Cuchara	Utensilio que sirve para llevar los alimentos a la boca. <font color=ForestGreen><b>n.f.:</b></font> Kchara
Su estómago	Meme: <font color=ForestGreen><b>n.f.coloq.:</b></font> Mamá <font color=purple>/</font> señora. <font color=ForestGreen><b>adj.dem.:</b></font> Mami
También	persona que participó en algún hecho, trabajo o acontecimiento. <font color=ForestGreen><b>adv.afirm.:</b></font> Mamuire.  <font color=purple>Ej.</font> <font color=blue>Mamuire emjaa'i te t-semkokompo.</font> <font color=purple>/</font> También él estaba presente en la discusión. 
Lo llevará	Persona que se encargara de llevar o traer a una persona, animal o cosa. <font color=ForestGreen><b>vtr.:</b></font> Mamyore.  <font color=purple>Ej.</font> <font color=blue>Mamyore ma napyaru to pkure.</font> <font color=purple>/</font> Mi tío va a llevar/traer la canoa.
¡Lo encontró!	Persona que encuentra a otra persona, animal o cosa. <font color=ForestGreen><b>vtr.excl.:</b></font> Maroto
Chuturubí	Peto avispa de color rojizo negro que su picada es dolorida. <font color=ForestGreen><b>zool.:</b></font> Máchosi
Su hijo	Se utiliza para referirse al hijo de un hombre. <font color=ForestGreen><b>adj.dem.:</b></font> Machicha
Manteca	Grasa extraía de animal o de pescado grasoso. <font color=ForestGreen><b>n.f.:</b></font> Mateka
Martes	Segundo día de la semana. <font color=ForestGreen><b>n.m.:</b></font> Maatesi
Poner	Acción de vestirse. <font color=ForestGreen><b>vtr.prnl.:</b></font> Manoko
Camijeta	Vestimenta típica, elaborado de hilo de algodón. Ancestralmente era utilizado a diario por nuestros antepasados. <font color=ForestGreen><b>n.m.:</b></font> Muiriore
¡Imposible / Ni modo!	Actividad que no se puede realizar o continuar por alguna situación. <font color=ForestGreen><b>interj.:</b></font> Muitji <font color=purple>/</font> muitjipo
Mayo	Quinto mes del año. <font color=ForestGreen><b>n.m.:</b></font> Mayo
Niño/niña	Niñez. Se utiliza para referirnos al primer período de la vida de una persona, comprendido entre el nacimiento y el principio de la adolescencia. <font color=ForestGreen><b>n.f.m.:</b></font> 'Moyo
Estudiante / alumno	Persona que recibe formación y cursa estudios en un centro educativo. <font color=ForestGreen><b>n.f.m.:</b></font> 'Mitreko
Miércoles	Tercer Día de la semana. <font color=ForestGreen><b>n.m.:</b></font> Myeekúresi
Diente de otra persona	Persona que señala el diente de otro. <font color=ForestGreen><b>adj.dem.:</b></font> Ma'e
Es de él	Afirmación de una persona de que el animal, objeto es de él. <font color=ForestGreen><b>adj.dem.:</b></font> Maye'e
Mandarina	Fruta cítrica del mandarino que es comestible. <font color=ForestGreen><b>bot.:</b></font> Mantarina
Tipoi	Vestido elaborado de tela para el sexo femenino. (Vestimenta típica originaria de los pueblos indígenas del oriente boliviano). <font color=ForestGreen><b>n.f.:</b></font> 'Moroji
Pantalón	Prenda de vestir elaborado de tela para ambos sexos. <font color=ForestGreen><b>n.m.:</b></font> Muipuere
Mocheó	Enfermedad que proviene de los difuntos y ataca a los niños causándoles sudoración. <font color=ForestGreen><b>n.m.:</b></font> Moche
Ardilla	Animal silvestre que se alimenta con la semilla o calucha del motacú. <font color=ForestGreen><b>zool.:</b></font> Matse
Paja / pasto	Hierba que crece en el campo que sirve de alimento para el ganado y otros animales herbívoros. <font color=ForestGreen><b>n.f.:</b></font> Muiji
Color morado	Color violeta oscuro, como la remolacha. <font color=ForestGreen><b>n.m.f.adj.:</b></font> Mraru
¡Oí / oye!	Expresión propia del pueblo Mojeño Trinitario que se utiliza para llamar la atención de otra persona. <font color=ForestGreen><b>interj.coloq.:</b></font> Muena.  <font color=purple>Ej.</font> ¡Oye!, ¿Qué está haciendo? <font color=purple>/</font> <font color=blue>¡Muena!, ¿taa pemtone?</font>
Éste	Indica una persona que esta cerca de la persona que habla o escribe. det.pron.dem.: Maka
Su hamaca	Afirmación de propiedad de una hamaca. <font color=ForestGreen><b>adj.dem.:</b></font> Machu
Animal macho	Animal de sexo masculino. <font color=ForestGreen><b>n.m.:</b></font> Machu
Adolescente	<font color=ForestGreen><b>adj.:</b></font> 'Moperu
Cantidad	Número de unidades, personas, tamaño o porción de una cosa. <font color=ForestGreen><b>n.f.:</b></font> Movéra
Tres	El número o cantidad de tres en Mojeño Trinitario. <font color=ForestGreen><b>n.:</b></font> Mopona
Nace/sale	Salir [una persona o un animal vivíparo] del vientre de la madre. <font color=ForestGreen><b>vintr.:</b></font> Machre
Su muslo	<font color=ForestGreen><b>adj.dem.:</b></font> Mapa'e
Su pierna	<font color=ForestGreen><b>adj.dem.:</b></font> Mapuegie
Su casa	Afirmación de hombre a otro de ser dueño de una casa. <font color=ForestGreen><b>adj.dem.:</b></font> Mapeno
Tarumá	Árbol que crece en las pampas y las selvas amazónica. <font color=ForestGreen><b>bot.:</b></font> Mítugi
Inacabable	Que no tiene fin o término en el tiempo o en el espacio. <font color=ForestGreen><b>adj.:</b></font> Muitokóresi
Infinito	Sin fin, que no tiene ni puede tener fin ni limite. <font color=ForestGreen><b>adj.:</b></font> Muitrawre <font color=purple>/</font> muitreko
Su carga	Afirmación de una persona a otra que el objeto o cosa que carga durante el viaje es de él (dicho de hombre a hombre). <font color=ForestGreen><b>adj.dem.:</b></font> Mamgiene
Canilla	Hueso largo de la pierna o el brazo, en especial la tibia. <font color=ForestGreen><b>n.f.anat.:</b></font> Matsánogi
Fue el primero	Afirmación de una persona a otra que el llegó primero. <font color=ForestGreen><b>adv.t.:</b></font> Mawri'i
Tatú	Animal silvestre que habita en las pampas y selvas amazónicas. <font color=ForestGreen><b>zool.:</b></font> Moto
Trompa de tatú	Nombre originario en Mojeño trinitario que se da a una variedad de planta de yuca. <font color=ForestGreen><b>n.f.:</b></font> Motosumu
Trabajo	Actividad o trabajo que la persona realiza. <font color=ForestGreen><b>n.m.:</b></font> 'Motneko
Azotar	Persona que da azotes a otra persona como castigo. (chicotear o guasquear). <font color=ForestGreen><b>vtr.:</b></font> Muestako
Siempre	En todas las ocasiones en que es posible o se dan las circunstancias apropiadas, o con mucha frecuencia pasa lo mismo. <font color=ForestGreen><b>adv.t.:</b></font> 'Muirijinve
Identifica	Persona que reconoce a otra persona o cosa. <font color=ForestGreen><b>vtr.:</b></font> Muemoti
Desentendido	Persona que no entiende o escucha consejo o enseñanza de alguien. <font color=ForestGreen><b>adj.:</b></font> Muechemrekko
Su abuela	<font color=ForestGreen><b>adj.dem.:</b></font> Matse
Matico	Nombre de ave silvestre de las pampas. <font color=ForestGreen><b>zool.:</b></font> Matiku
Soplar	Persona que sopla un instrumento musical como ser flauta, trompeta, fifano, etc. <font color=ForestGreen><b>vtr.:</b></font> Máchuko.  <font color=purple>Ej.</font> <font color=blue>Machuko to yuku.</font> <font color=purple>/</font> Sopló el fuego.
Su cabeza	Persona que sopla un instrumento musical como ser flauta, trompeta, fifano, etc. <font color=ForestGreen><b>adj.dem.:</b></font> Machuti.  <font color=purple>Ej.</font> <font color=blue>Machuko to yuku.</font> <font color=purple>/</font> Sopló el fuego.
Chupar	Persona que extrae líquido con la boca.  <font color=purple>Ej.</font> Un lactante. <font color=ForestGreen><b>vtr.:</b></font> Machuchko
Su talón	<font color=ForestGreen><b>adj.dem.:</b></font> Machuksipewo
Atrevido	Que se comporta con descaro, insolencia, falta de respeto. <font color=ForestGreen><b>adj.:</b></font> Mueperáji
Ambicioso	Persona que tiene ambición. <font color=ForestGreen><b>adj.n.m.:</b></font> Mamuepesirawo
Su frente	<font color=ForestGreen><b>adj.dem.:</b></font> Mano'si
¡Se quedó!	Persona que no pudo continuar. <font color=ForestGreen><b>vtr.imper.:</b></font> ¡Manosi!
¡Que se quede!	Persona que ordena a otra a que se quede. <font color=ForestGreen><b>vtr.imper.:</b></font> Mánosi.  <font color=purple>Ej.</font> Que se quede cuidando la casa. <font color=purple>/</font> <font color=blue>Mánosi majañoka to peti.</font> 
¿Se quedó?	Integorración a otra persona si se quedo alguien. <font color=ForestGreen><b>vtr.interrog.:</b></font> ¿manosí?
¿Lo colocó?	Pregunta a una persona colocó o puso en su lugar a alguien u objeto. <font color=ForestGreen><b>vtr.interrog.:</b></font> Manoko
Ganó	Persona que gana alguna competencia, apuesta o pelea <font color=purple>/</font> acción de ganar. <font color=ForestGreen><b>vtr.afirm.:</b></font> Mueto'ako
Su esposa	afirmación que es su mujer. <font color=ForestGreen><b>adj.dem.:</b></font> Mayeno
Lo suspendió	Acción de levantar, colgar una cosa en algo o en el aire. <font color=ForestGreen><b>vtr.:</b></font> Makangiecho
Montar	Persona que se sube al lomo de un caballo, buey, toro, etc. <font color=purple>/</font> Acción de montar. <font color=ForestGreen><b>vintr.:</b></font> Mawgiecho
Lo abrió	Persona que en cierta circunstancia realiza la acción de abrir las piernas (juego deportivo, sexo). <font color=ForestGreen><b>vtr.:</b></font> Makajagicho
Enrectar	Enderezar algo que esta doblado o torcido. <font color=ForestGreen><b>vtr.:</b></font> Makajapeko
Estado de preocupación, intranquilidad	<font color=ForestGreen><b>n.f.:</b></font> Makoponreru
Compadrerio	Reunión familiar de presentación de una unión de pareja hacia ambos familiares. <font color=ForestGreen><b>n.m.:</b></font> Matnare
Lo encontropersona	Que encuentra a otra persona o animal. <font color=ForestGreen><b>vtr.:</b></font> Makpojko
¿Lo encontró?	<font color=ForestGreen><b>vtr.interrog.:</b></font> ¿Makpojko?
Aprovechar	Persona que en el momento oportuno aprovecha la oportunidad como ser en la cosecha, pesca, acoso. <font color=ForestGreen><b>vtr.:</b></font> Mano'okpo
Lo atrapó	Afirmación de una persona a otra de coger fuertemente con la mano o, de cualquier modo. <font color=ForestGreen><b>vtr.afirm.:</b></font> Makootoko
Aprovecharse	Persona que en el momento oportuno aprovecha de lo que existe en esa ocasión. <font color=ForestGreen><b>vtr.prnl.:</b></font> Mano'oko
Ocasión	persona que aprovecha en cierta ocasión de sacar provecho en su beneficio. <font color=ForestGreen><b>n.f.:</b></font> Makompura
Retear	Persona que regaña a otra persona o como también a un animal. <font color=ForestGreen><b>vtr.:</b></font> Makojcho
Su pestaña	<font color=ForestGreen><b>adj.dem.:</b></font> Mamotsipa
Su tronco	<font color=ForestGreen><b>adj.dem.:</b></font> Machupu'i
Su amante	persona afirma que aquella mujer es amante de otra. <font color=ForestGreen><b>adj.dem.:</b></font> Makóyepe
Lo (la) quiere	Persona que estima a otra persona, objeto u animal por algún motivo o circunstancia. art.deter.: Mawoo'o
Lo besó	Persona que afirma que la otra persona acaricia a la mujer besándola. <font color=ForestGreen><b>vtr.:</b></font> Matsuko
¡Ya lo besó!	Afirmación de una persona a otra persona que le dió un beso. <font color=ForestGreen><b>vtr.afirm.interj.:</b></font> Matsukpo
Manso	Animal que no ataca ni actúa con agresividad, sino que se muestra dócil en compañía de las personas y se deja tomar o acariciar. <font color=ForestGreen><b>adj.:</b></font> Masu
Enema	Instrumento propio de los pueblos originarios hecho de tripa seca que sirve para introducir el liquido desinflamatorio a través del ano <font color=purple>/</font> liquido que se inyecta en el intestino por el ano con fines laxantes. <font color=ForestGreen><b>n.m.:</b></font> Masuurupi
Lo frita/o	Afirmación de freír alimentos. <font color=ForestGreen><b>vtr.:</b></font> Masuu'o
Curubina	Nombre que se le da a un pez de los ríos y lagunas trinitarias. <font color=ForestGreen><b>zool.:</b></font> 'Mu'i
Invencible	Que no se le puede ganar o vencer. <font color=ForestGreen><b>adj.:</b></font> Muito'a
Se atoró	Quedársele a alguien algo detenido o atravesado en la garganta, obstruyéndola e impidiendo que se pueda tragar. <font color=ForestGreen><b>vtr.:</b></font> Masu'o
Pez sin sangre	Pez de agua dulce, de la familia de la sardina. <font color=ForestGreen><b>zool.:</b></font> Muitnerepe
Boca de vieja	Pez de agua dulce, que tiene la boca grande. <font color=ForestGreen><b>zool.:</b></font> Mneneru
Utensilio de cocina plano de color morado	<font color=ForestGreen><b>n.:</b></font> Mrarupe
Consejera	Persona adulta de sexo femenino que da consejo a otras personas. <font color=ForestGreen><b>n.f.:</b></font> Memenajriore
Su papel higiénico	<font color=ForestGreen><b>adj.dem.:</b></font> Majmere
Su brazo	<font color=ForestGreen><b>adj.dem.:</b></font> Mapowgi
Ciego	Que no ve por estar privado del sentido de la vista. <font color=ForestGreen><b>adj.n.m.f.:</b></font> Ma'u
Su voz	<font color=ForestGreen><b>adj.dem.:</b></font> Ma'u
Su escrito	<font color=ForestGreen><b>adj.dem.:</b></font> Majre
Lo que se escribió	Escrituras ancestrales históricas. <font color=ForestGreen><b>vtr.:</b></font> Majumeru
Su rosario	Afirmación de una persona que el material elaborado de madera fraganciosa llamado tijiyequi le pertenece. <font color=ForestGreen><b>adj.dem.:</b></font> Marusaa'o
Comedor	Habitación de una vivienda o de un establecimiento que dispone de lo necesario para servir comidas. <font color=ForestGreen><b>n.m.:</b></font> Manisrare
Su preferido	Comida favorita. <font color=ForestGreen><b>adj.dem.n.m.:</b></font> Mani'o
Conejo	Animal silvestre que habita diferentes geografias. Comestible. <font color=ForestGreen><b>zool.:</b></font> Myuku
Color Café, marrón	Color para distinguir objetos cosas y animales. <font color=ForestGreen><b>adj.:</b></font> Myo'u
Su cuerpo	<font color=ForestGreen><b>adj.dem.:</b></font> Mag'e
Lo lanzó	<font color=ForestGreen><b>vtr.afirm.:</b></font> Mag'o
Su ojo	<font color=ForestGreen><b>adj.dem.:</b></font> Mag'a
Su testículo	<font color=ForestGreen><b>adj.dem.:</b></font> Magi
Hilo de pescar	Prolongación de la tarrafa de pescar. <font color=ForestGreen><b>n.m.:</b></font> Magierepi
Hombre o animal sin testículos	<font color=ForestGreen><b>adj.:</b></font> Mágire
Paleta	Pez de agua dulce de la especie del surubí. <font color=ForestGreen><b>zool.:</b></font> Myupi
Máscaras	Diferentes tipos de máscaras que usan en diferentes danzas. <font color=ForestGreen><b>n.f.pl.:</b></font> Mírore
Fruta del tarumá	Fruta comestible para las aves y animales, tambien se utiliza como medicina tradicional. <font color=ForestGreen><b>bot.:</b></font> Mitu'i
Inútil	Sinónimo de suteji. <font color=ForestGreen><b>adj.:</b></font> Muitujegne
Gato	Animal doméstico diurno y nocturno. <font color=ForestGreen><b>zool.n.m.f.:</b></font> Mitsi
Dinero	Plata que se utiliza para la compra o venta de cosas. <font color=ForestGreen><b>n.m.:</b></font> Meriope
Retrasado mental	<font color=ForestGreen><b>adj.:</b></font> Meriope
Caimán	Reptil acuático. Muy similar al cocodrilo en forma y color, pero de hocico más corto <font color=ForestGreen><b>zool.:</b></font> Merómero
Olla	Utensilio de la cocina para la cocción de los alimentos. <font color=ForestGreen><b>n.f.:</b></font> Met-si
Silleta	Persona, animal que tiene el espinaso simbrado. <font color=ForestGreen><b>adj.:</b></font> Metemitsgi
Lo transformó	Objeto cambiado de forma por otra. <font color=ForestGreen><b>vtr.:</b></font> Muekyechpo
Su caminar	Forma particular de caminar de la persona. <font color=ForestGreen><b>n.f.:</b></font> Mapuisra
Entidad financiera	Banco.  <font color=purple>Ej.</font> El banco Unión. <font color=ForestGreen><b>n.m.:</b></font> Meriowkure
Lo salvó	Persona que salvó de morir a otra. <font color=ForestGreen><b>vtr.afirm.:</b></font> Muepucho
Lo curó	Persona que hacer desaparecer una enfermedad, una herida o un daño físico a otra persona, un animal o un organismo. <font color=ForestGreen><b>vtr.afirm.:</b></font> Mueprujcho
Martillo	Herramienta fabricada de fierro que sirve para clavar y extraer clavos. <font color=ForestGreen><b>n.m.:</b></font> Maatiyu
Martina	Nombre de mujer. <font color=ForestGreen><b>n.:</b></font> Maatina
Sarnoso	Animal enfermo de sarna. <font color=ForestGreen><b>adj.:</b></font> Mójomo
Leche de majo	Palmera de la selva con frutos comestibles. <font color=ForestGreen><b>n.f.bot.:</b></font> Majomo
Mayordomo	Autoridad que ocupa una cartera dentro del cabildo indígenal. <font color=purple>/</font> También se utiliza para nombrar a un encargado de una estancia. <font color=ForestGreen><b>n.m.:</b></font> Myóromo
Manzana	Fruta dulce comestible. <font color=ForestGreen><b>n.f.bot.:</b></font> Maasana
Moco	Sustancia espesa y pegajosa segregada por una membrana mucosa, especialmente por la mucosa nasal. <font color=ForestGreen><b>n.m.:</b></font> Muchji
Entero, cosa redonda completa	<font color=ForestGreen><b>adj.:</b></font> 'Muirisi
Resistente	Objeto que soporta peso y resistente al tiempo. <font color=ForestGreen><b>adj.:</b></font> Mraka
Colectividad	Conjunto de personas que tienen problemas e intereses comunes. <font color=ForestGreen><b>n.f.:</b></font> Mriji
Bárbaro	Que no está en contacto con los pueblos organizados. Concepto que dieron los colonizadores españoles a los pueblos originarios. <font color=ForestGreen><b>adj.n.f.:</b></font> Muikchosiono
Sin bautizo	Persona que no ha sido bautizada. <font color=ForestGreen><b>prep.:</b></font> Muikchosi
Manga	Fruta del árbol del mango que es comestible y dulce. <font color=ForestGreen><b>bot.:</b></font> Manka
Maíz tostado	Harina molina del maíz que sirve para elaborar chicha. <font color=ForestGreen><b>bot.n.m.:</b></font> Maskapa
Esta aquí	Su utiliza para afirmar que una persona que ya llegó. <font color=ForestGreen><b>adv.l.:</b></font> Makapripo
Irse directo	Persona que indica que le diga a la otra persona que se vaya al lugar indicado. <font color=ForestGreen><b>vintr.prnl.:</b></font> Matpiru
Se bajó	Persona que recientemente acaba de bajar de un avión, barranco, canoa, auto, caballo o carretón. <font color=ForestGreen><b>vtr.:</b></font> Makpuiru
Se fué directo	Persona que comenta a otra que alguien se fue directo a algún lugar. <font color=ForestGreen><b>vtr.prnl.:</b></font> Matúpiru.  <font color=purple>Ej.</font> El señor se fue directo a su casa <font color=purple>/</font> <font color=blue>Ma tata matupiru te mapeno.</font> 
Se pasó directo	Afirmación de una persona que alguien se pasó directo sin parar. <font color=ForestGreen><b>vtr.prnl.:</b></font> Matupiirichu
Su pecho	<font color=ForestGreen><b>adj.dem.:</b></font> Matupo
¡Oiga!	Expresión propia originaria empleada para llamar la atención de alguien. <font color=ForestGreen><b>interj.:</b></font> Makje'e
¡Que se agache!	<font color=ForestGreen><b>vtr.imper.:</b></font> Muetpuegia
¡Que le pegue!	Orden de una persona a otra persona a que le de golpes. <font color=ForestGreen><b>vtr.imper.:</b></font> Mue'a
Su suegro	Afirmación de una persona a otra de que es su suegro. <font color=ForestGreen><b>adj.dem.:</b></font> Muemchuko
Su semen	<font color=ForestGreen><b>deter.poses.:</b></font> Mayogiomo
Su adulado	Que solo estima y adula a una sola persona, que puede ser por cariño o interés. <font color=ForestGreen><b>deter.poses.:</b></font> Muemnaru
Orador	Persona que utiliza la elocuencia oral en público. <font color=ForestGreen><b>n.m.:</b></font> Mkata
Se proteje	Persona que se resguarda de alguien, algo peligroso o daño. <font color=ForestGreen><b>vtr.prnl.:</b></font> Makósiña
Loco	Que tiene poco juicio o se comporta de forma disparatada, imprudente o temeraria, sin pensar en las consecuencias. <font color=ForestGreen><b>adj.:</b></font> Muemnanasko
Lo mezclo	Acción de mesclar los alimentos con otros ingredientes. <font color=ForestGreen><b>vtr.:</b></font> Muemsiigicho
Su trabajo	detrer.poses.: Muemtone
Su juguete	<font color=ForestGreen><b>deter.poses.:</b></font> Maye'eru
Su pene	<font color=ForestGreen><b>deter.poses.:</b></font> Mayogi
Su pala	<font color=ForestGreen><b>deter.poses.:</b></font> Makaeicha
Su acha	<font color=ForestGreen><b>deter.poses.:</b></font> Mayowo
Su machete	<font color=ForestGreen><b>deter.poses.:</b></font> Muesaviipe
Su cuchillo	<font color=ForestGreen><b>deter.poses.:</b></font> Matumra
Su flecha	Arma de cacería que pertenece a alguien. <font color=ForestGreen><b>deter.poses.:</b></font> Matagrigi
Su chaco	Chaco que le pertenece a una persona. <font color=ForestGreen><b>deter.poses.:</b></font> Muesane
Su barbecho	Afirmación de que el barbecho es de una persona. <font color=ForestGreen><b>deter.poses.:</b></font> Muesanereji
Sin oficio	Persona que no trabaja. Es vago, flojo. <font color=ForestGreen><b>adj.:</b></font> Muemtonere
Lo bebió	Persona que afirma que tomó un líquido, refresco, vino, etc. <font color=ForestGreen><b>pron.pers.:</b></font> Muero
Su bebida favorita	<font color=ForestGreen><b>deter.poses.:</b></font> Muerosare
Se lo tomó	Persona que se tomó una bebida, agua, etc. <font color=ForestGreen><b>vtr.:</b></font> Mueropo
Testarudo	Que se mantiene firme en su actitud, aunque se le den razones en contra. <font color=ForestGreen><b>adj.n.f.m.:</b></font> Muechorekko
Su sangre	<font color=ForestGreen><b>deter.poses.:</b></font> Muetne
Invisible	Animal o cosa que no se puede percibir, notar o ver. <font color=ForestGreen><b>adj.:</b></font> Muechoroji
Sin carne	Comida o alimento preparado sin carne. <font color=ForestGreen><b>prep.:</b></font> Mneji
Sin olor	Se utiliza para referirse a persona, animal o cosa que carece de olor. <font color=ForestGreen><b>prep.:</b></font> Muijyere
Voy a tomar	Persona que afirma que va tomar o beber, refresco, agua, etc. <font color=ForestGreen><b>vintr.ind.:</b></font> Neroyo
Ya bebí	Afirmación de la persona que ya bebió agua, refresco, chicha, etc <font color=ForestGreen><b>vtr.afirm.:</b></font> Neroripo
Estoy bebiendo	Persona que afirma que está consumiendo bebida alcohólica. <font color=ForestGreen><b>vtr.ger.:</b></font> Neeriko
Mi chicha	Persona que afirma que la bebida elaborada de maíz, yuca, plátano, camote y arroz es suya. <font color=ForestGreen><b>deter.poses.:</b></font> Neesa
Su chicha	Afirmación que la chicha es de ellos. <font color=ForestGreen><b>deter.poses.:</b></font> Neesa
Te amo	Persona que afirma que ama, quiere, estima a otra persona. <font color=ForestGreen><b>vtr.afirm.:</b></font> Nemnakvi
¡Tengo sed!	Expresión de tener sed. <font color=ForestGreen><b>vtr.imper.:</b></font> Netarako
¡Que lo claven!	<font color=ForestGreen><b>vtr.imper.:</b></font> Nettáka
¿Lo clavó?	<font color=ForestGreen><b>vtr.interrog.:</b></font> ¿Nettáka?
Su señal	Elementos tangibles o intangibles que el hombre utiliza para guiarse. <font color=ForestGreen><b>deter.poses.:</b></font> Naemotyora
Soy chismoso	Persona que le gusta el chisme. <font color=ForestGreen><b>adj.afirm.:</b></font> Nechjikra'i
Doy discurso	Persona que ofrece su servicio de dar un discurso. <font color=ForestGreen><b>vintr.afirm.:</b></font> Nechoriko
Hago rodar	Persona que afirma que hace rodar un objeto. <font color=ForestGreen><b>vintr.afirm.:</b></font> Nechoriko
Lo llamaron	Afirmación de una persona a otra que ha sido invitada o convocado. <font color=ForestGreen><b>pron.pers.:</b></font> Nechoriko
Me cuido	Acción de cuidarse, protegerse y conservarse. <font color=ForestGreen><b>vtr.:</b></font> Nechpojrikwo
Precavido	Persona cautelosa, que anda siempre con mucho cuidado. <font color=ForestGreen><b>adj.:</b></font> Nechpopokwo
Soy loco	Persona despistada, negligente, que no toma precaución. <font color=ForestGreen><b>adj.:</b></font> Nemnanasko
Soy bueno	Persona agradable, amable, que comparte y es cordial. <font color=ForestGreen><b>adj.:</b></font> Nemna'i
Soy celoso	Persona que siente celos a algo o alguien. <font color=ForestGreen><b>adj.:</b></font> Netyora'i
Madrugador	Persona que se levanta muy temprano a realizar su actividad laboral. <font color=ForestGreen><b>adj.:</b></font> Nechpukowne
Mentiroso	Persona que acostumbra mentir. <font color=ForestGreen><b>adj.:</b></font> Nepya'ra'i
Te hago acuerdo	Persona que le hace acuerdo sobre algo para que no se olvide. <font color=ForestGreen><b>vtr.:</b></font> Nemechapi
Mi abuelo	<font color=ForestGreen><b>deter.poses.:</b></font> Nochko
Mi abuela	<font color=ForestGreen><b>deter.poses.:</b></font> Notse
Bebí	Persona que acaba de tomar alguna bebida. <font color=ForestGreen><b>vtr.:</b></font> Néropo
Lo llevo	Persona que afirma que lleva a alguien o algo. <font color=ForestGreen><b>pron.pers.:</b></font> Nomo
Lo llevaron	<font color=ForestGreen><b>vtr.:</b></font> Nompo
¡Ahí vienen!	Persona que afirma que un grupo se aproxima. <font color=ForestGreen><b>interj.:</b></font> Noniripo
Le eché agua	Acción de echar agua a alguien o a un animal. <font color=ForestGreen><b>vtr.:</b></font> Nocho'okpo
Yo lo llevaré	Persona que afirma que por algún motivo va llevar a alguien, animal o cosa. <font color=ForestGreen><b>vtr.:</b></font> Nomarine
Que lo lleven	Afirmación de una persona de que ellos lo van a llevar a la persona, animal o cosa. <font color=ForestGreen><b>vtr.:</b></font> Nomarine
Lo voy a llevar/traer	Persona que afirma que lo va llevar o traer a alguien, animal o cosa. <font color=ForestGreen><b>vtr.afirm.:</b></font> Nomyóre
¡Ya vienen por ahí!	Persona que afirma que un grupo de persona se viene acercando. <font color=ForestGreen><b>vtr.interj.:</b></font> Noñoppo
¡Otra vez Están por aquí!	art.indef.: Noniri'ojnopo
Estorbo	Persona que pone un obstáculo a la ejecución de algo. <font color=ForestGreen><b>adj.:</b></font> Noomiruchpo
Lo Chamuscaron	<font color=ForestGreen><b>adj.:</b></font> Nochoro'okpo
Soplé	Persona que sopló algo con la boca. <font color=ForestGreen><b>vtr.:</b></font> Nochukpo
Lo encontré	Afirmación de encotrar a una persona o animal. <font color=ForestGreen><b>vtr.:</b></font> Nokpojkopo
¡Que lo soplen!	Orden de una persona a otras de que tienen que soplar. <font color=ForestGreen><b>vtr.imper.:</b></font> Nochuka
¡Lo voy a cargar!	Afirmación de una persona de llevar o cargar continuamente una cosa por necesidad. <font color=ForestGreen><b>vtr.imper.:</b></font> Nompookoyre
Soy pateador	Persona que agrede físicamente a otro proporcionándole patadas. <font color=ForestGreen><b>adj.:</b></font> Nokchu'i
¿Lo llevo?	Pregunta que si puedo llevar a una persona, animal o cosa. <font color=ForestGreen><b>vtr.interrog.:</b></font> Noma
Remojar / ¿Lo puedo remojar?	Remojar algo solido con un líquido.  <font color=purple>Ej.</font> Agua con chivé. <font color=purple>/</font> También se utiliza como pregunta. <font color=ForestGreen><b>vtr.interrog.:</b></font> Nochopaka
¿Puedo verlo?	<font color=ForestGreen><b>vtr.interrog.:</b></font> Nim'a
Lo voy a ver	Persona que afirma que verá a alguien o algo. <font color=ForestGreen><b>vtr.afirm.:</b></font> Nim'oyre
Te mostraré	Persona que muestra algo a alguien. <font color=ForestGreen><b>vtr.afirm.:</b></font> Nimechviyre <font color=purple>/</font> nimekviyre
¡Estoy pariendo!	Dicho de una mujer que está dando a luz. <font color=ForestGreen><b>vintr.ger.imper.:</b></font> Nínako
Voy a parir	Persona que afirma que dará a luz. <font color=ForestGreen><b>vtr.afirm.:</b></font> Ninakoyre
Suposición	Persona que considera una deducción de algo como cierto. <font color=ForestGreen><b>n.f.:</b></font> Nimijroko.  <font color=purple>Ej.</font> Me imagino que así será.
Te daré	Acción entregar o dar una cosa de una persona a otra de lo que necesita o insiste. <font color=ForestGreen><b>vtr.:</b></font> Nijrokviyre
Yo me encargo	Situación que asume una persona que encuentra por casualidad o situación de emergencia. <font color=ForestGreen><b>vtr.:</b></font> Nim'aprine
Te voya ganar	Afirmación de una persona que asegura ganarle en la competencia a la otra. <font color=ForestGreen><b>vtr.:</b></font> Nito'akviyre
Lo hice llamar	Persona que hace o manda llamar a alguien. <font color=ForestGreen><b>vtr.:</b></font> Nichorikri'i
Yo estoy vivo	Persona que afirma que esta con vida. <font color=ForestGreen><b>v.cop.:</b></font> Nitoriko
Yo visito	Pimera persona en singular. <font color=ForestGreen><b>vtr.:</b></font> Nimoriko
Me encuentro bien	Afirmación de encontrarse sin ningun problema. <font color=ForestGreen><b>vtr.afirm.:</b></font> Nitotijwo
Voy a comer	Persona que afirma que va comer algún alimento. <font color=ForestGreen><b>vtr.:</b></font> Nnikyo
Comeré	<font color=ForestGreen><b>vtr.:</b></font> Nnikyore
Yo como	<font color=ForestGreen><b>vtr.res.:</b></font> Nniko.  <font color=purple>Ej.</font> Yo como carne. <font color=purple>/</font> <font color=blue>Nuti nniko wakaeche.</font>
Soy pescador	Ser pescador o suertudo. <font color=ForestGreen><b>adj.:</b></font> Nenwo'u
Me gusta pescar	Persona que afirma que le gusta pescar. <font color=ForestGreen><b>vtr.:</b></font> Nenkora'i
Me muestro	Persona que voluntariamente se presenta ante un grupo o persona. <font color=ForestGreen><b>vtr.prnl.dem.:</b></font> Nimerikwo
Bostezo	Acto reflejo que consiste en abrir la boca ampliamente, esta relacionado con el sueño, cansancio, aburrimiento. <font color=ForestGreen><b>vintr.:</b></font> Niiyarakwo
Bailo	Persona que danza en un grupo de danzarines. <font color=ForestGreen><b>vtr.:</b></font> Niimuiko
Estoy hilando	Persona que elabora hilo de algodón. <font color=ForestGreen><b>vtr.ger.:</b></font> Nijruriko
Gané	Persona que afirma que gano alguna competencia, apuesta, etc. <font color=ForestGreen><b>vtr.:</b></font> Nito'areko
Estoy tejiendo	Persona que teje en hilo de algodón, hoja de chuchio. <font color=ForestGreen><b>vtr.ger.:</b></font> Nitsmeriko
Cambio de vida	Persona que cambia de estilo de vida. <font color=ForestGreen><b>vtr.:</b></font> Nitswochapo
Trueque	Acción de dar una cosa y recibir otra a cambio. Intercambiar animal, alimento, o cosa por otro sin intervención del dinero. <font color=ForestGreen><b>n.m.:</b></font> Nitswochapi
Lo aparto	Separar de un lugar a otro como ser: vaca, caballo, chancho y objeto. <font color=ForestGreen><b>vtr.:</b></font> Niptsiko
Yo silbo	Persona que silba. <font color=ForestGreen><b>vintr.:</b></font> Nissiko
Sacar todo	<font color=ForestGreen><b>vtr.:</b></font> Niijiko
Apresurado	Persona que se encuentra a prisa o apurado. <font color=ForestGreen><b>adj.:</b></font> Nviijako
¡Ya voy!	Ya estoy de ida, llego enseguida. <font color=ForestGreen><b>interj.:</b></font> Nutyopo
Tengo buen pensamiento	Buena idea. <font color=ForestGreen><b>n.m.:</b></font> Nuuponreru
Mi plato	Palabra posesiva en Mojeño trinitario. <font color=ForestGreen><b>deter.poses.:</b></font> Nkuujo
Estoy zambullendo y nadando	<font color=ForestGreen><b>vtr.pres.:</b></font> Nutsareko
Soy juguetón	Me gusta jugar. <font color=ForestGreen><b>adj.:</b></font> Nutsarusi
Ya me voya salir	<font color=ForestGreen><b>vtr.afirm.:</b></font> Nuchku'yórepo
Me baño	Acción de bañarse. <font color=ForestGreen><b>vtr.prnl.:</b></font> Nkowo
Ya Salí	Persona que afirma haber salido de una reunion, asamblea, formación Acedémica, de prisión. <font color=ForestGreen><b>vtr.:</b></font> Nuchku'ripo
Ya Salí	Persona que afirma haber salido de un lugar a otro determinado lugar. <font color=ForestGreen><b>vtr.:</b></font> Nuchkoripo
Soy cabelludo	Que tiene mucho cabello. <font color=ForestGreen><b>adj.:</b></font> Núpasi
Soy velludo	Que tiene muchos los vellos corporales. <font color=ForestGreen><b>adj.:</b></font> Nupajiyo'o
Lo dejaron	<font color=ForestGreen><b>vtr.:</b></font> Nanokiko.  <font color=purple>Ej.</font> <font color=blue>Nanokiko to pkure te kwooku.</font> <font color=purple>/</font> Lo dejaron la canoa en el puerto.
Lo pusieron. / Lo colocaron.	<font color=ForestGreen><b>vtr.obj.direc.:</b></font> Nanoko
Lo designaron	Persona sido designado a otra como autoridad, representante. <font color=ForestGreen><b>vtr.obj.direc.:</b></font> Nanoko.  <font color=purple>Ej.</font> <font color=blue>Nanoko tparaako ma Kristyan.</font> <font color=purple>/</font> Lo designaron a Cristian como autoridad. 
Nadó	<font color=ForestGreen><b>vintr.:</b></font> Nowreko
Su charque	Tambien se refiere a la parte de la pierna de una persona (incordiera). <font color=ForestGreen><b>deter.poses.:</b></font> Nacharagi
Se lo comieron	Comer algún alimento guardado por otra persona. <font color=ForestGreen><b>vtr.:</b></font> Nanikpo
Centro	Prenda de vestir de la mujer que se utiliza anteriormente debajo del vestido o blusa. <font color=ForestGreen><b>n.f.:</b></font> Najmirioowo
Pensamiento	Capacidad que tienen las personas de formar ideas y representaciones de la realidad. <font color=ForestGreen><b>n.m.:</b></font> Naponreepochu
Lo aprovecharon	Aprovechar el momento oportuno de cosechar. <font color=purple>/</font> Violar, pegar, chicotear, apalear, maltratar. <font color=ForestGreen><b>vtr.:</b></font> Nano'okpo
Están cerquita	<font color=ForestGreen><b>adv.l.:</b></font> Nakochkoyo
Lo encontraron	Persona que afirma a otro que encontraron a alguien, animal o cosa. <font color=ForestGreen><b>vtr.:</b></font> Narótopo
Lo vistieron	Persona que cubre o adorna el cuerpo de otro con vestidos. <font color=ForestGreen><b>vtr.:</b></font> Namuiriocho
Se vistieron	<font color=ForestGreen><b>vtr.pl.:</b></font> Nakomuii'o.  <font color=purple>Ej.</font> Los deportistas se vistieron de color rojo.
Sus Máscaras	<font color=ForestGreen><b>deter.poses.:</b></font> Namimro
¡Que se lo coman nomás!	Persona que autoriza se coman la comida de otro. <font color=ForestGreen><b>vtr.interj.:</b></font> Nanigiarine
Lo agarraron	Lo atraparon. <font color=ForestGreen><b>vtr.:</b></font> Nakootoko
Fueron sus amantes	Persona que afirma haber tenido amoríos con personas casadas. <font color=ForestGreen><b>adj.:</b></font> Nakóyepe
Ellos tuvieron Sexo	Tuvieron unión sexual. <font color=ForestGreen><b>vintr.:</b></font> Nakóyeno
Lo pillaron	Persona que sorprende a otra en un acto o situación "in fraganti". <font color=ForestGreen><b>adv.mod.:</b></font> Nachimroko
Los visitaron	Personas que visitan a otras. <font color=ForestGreen><b>vtr.pl.:</b></font> Nachimracho
Nuera de ellos	<font color=ForestGreen><b>deter.poses.:</b></font> Nachíneno.  <font color=purple>Ej.</font> María es la nuera de ellos.
Están con él	<font color=ForestGreen><b>vtr.:</b></font> Nakóchane
Me salí	Persona que se retira de un trabajo o reunión. <font color=ForestGreen><b>vtr.:</b></font> Nuchko
¡Ya voy!	Persona que indica que va. <font color=ForestGreen><b>interj.:</b></font> Nutyopo
Juguetear	Persona que se entretiene jugando. <font color=ForestGreen><b>vtr.:</b></font> Nutsaruriko
Voy a salir	Persona que va salir de una reunión, cárcel, estudio, deuda y trabajo. <font color=ForestGreen><b>vtr.:</b></font> Nuchku'yorepo
Lo pelaron	Personas que pelan algo. <font color=ForestGreen><b>vtr.:</b></font> Nacho'po.  <font color=purple>Ej.</font> Pelar un guineo maduro. 
Están preocupados	Personas intranquilas. <font color=ForestGreen><b>vtr.prnl.pl.:</b></font> Nakojrasamure
Están pensativos	Personas que meditan intensamente y están distraídos. <font color=ForestGreen><b>adj.pl.:</b></font> Najaasamre
Lo arruinaron	Destruir o causar grave daño por un grupo de personas. <font color=ForestGreen><b>vtr.pl.:</b></font> Namopachijko
Lo abrieron	Persona que le abren la pierna al animal para descuerarlo. <font color=purple>/</font> También se utiliza para referirse a la persona en un acto deportivo o sexual. <font color=ForestGreen><b>vtr.:</b></font> Nakajagichpo
Mi suegra	Persona que afirma que aquella mujer es su suegra. <font color=ForestGreen><b>deter.poses.:</b></font> Nimse
Mi amigo	<font color=ForestGreen><b>deter.poses.:</b></font> Nemnaksare
Hermano/a mayor	Se refiere al primer hermano de la familia. <font color=ForestGreen><b>n.m.f.:</b></font> Néchovi
Mi esposo	Dicho de la mujer para referirse a su marido. <font color=ForestGreen><b>deter.poses.:</b></font> Nima
Mi suegro	Se utiliza para referirse al padre de su esposo(a). <font color=ForestGreen><b>deter.poses.:</b></font> Nimchuko
Primogénito	Dicho por los padres para referirse al primer hijo. <font color=ForestGreen><b>adj.n.m.f.:</b></font> Nimaruupe
Yo carpo	Persona que se pone a carpir. <font color=ForestGreen><b>vtr.:</b></font> Níso'o
Yo cazo	Persona que afirma que ha ido de cacería. <font color=ForestGreen><b>vtr.:</b></font> Nkaseko
Yo vendo	Acción de vender. <font color=ForestGreen><b>vtr.:</b></font> Nijroriko
Yo cocino	Persona que realiza la acción de cocinar. <font color=ForestGreen><b>vtr.:</b></font> Nkomet-si
Tengo relación sexual	Persona que ha tenido relación sexual. <font color=ForestGreen><b>n.m.:</b></font> Nkoyeno
Tengo mujer	Persona que afirma que tiene mujer o esposa. <font color=ForestGreen><b>deter.poses.:</b></font> Nkoyeno
Soy horadador	Persona que hace un agujero o perfora. <font color=ForestGreen><b>adj.n.m.:</b></font> Nvet'so'i
Lo descosturé	Persona de descose prenda de vestir. <font color=ForestGreen><b>vtr.:</b></font> Nveporiko
Lo pinché	<font color=ForestGreen><b>vtr.:</b></font> Nvet-so'iko
Lo perforé	Persona que perfora algo blando como el yomomo, colchón o algo esponjoso. <font color=ForestGreen><b>vtr.:</b></font> Nvet-sojko
Mi camisa	<font color=ForestGreen><b>deter.poses.:</b></font> Nkamisa
Tú debes	Persona que afirma que la otra persona tiene una deuda bancaria o personal. <font color=ForestGreen><b>vtr.:</b></font> Ntevevi
Primero	Afirmación de una persona que llega o sale de primero de un lugar. <font color=ForestGreen><b>adv.num.:</b></font> Ntiwgiene.  <font color=purple>Ej.</font> Fui el primero en llegar a la fila. <font color=purple>/</font> <font color=blue>Ntiwgiene nitekpoo'i te tapiku.</font> 
Mi quirichí	Prominencia benigna y de pequeño tamaño que sale en la piel y está formada por la dilatación de las papilas vasculares y el endurecimiento de la epidermis que las cubre. <font color=ForestGreen><b>deter.poses.:</b></font> Ntetu
Mi nalga	Parte carnosa y redondeada situada en la parte baja de la espalda del alguien. <font color=ForestGreen><b>adj.dem.:</b></font> Ntete
Mi chuquito(a)	Expresión de adulo o demostración de cariño del padre o madre al hijo(a) pequeño(a). <font color=ForestGreen><b>deter.poses.coloq.:</b></font> Ntitagira
Mi Mandado	<font color=ForestGreen><b>deter.poses.:</b></font> Nkownora
Ahí vivo	Persona nativa de ese lugar por mucho tiempo. <font color=ForestGreen><b>adv.l.:</b></font> Nkowsa
Estoy enfermo	Persona que afirma que esta mal de salud. <font color=ForestGreen><b>adj.:</b></font> Nkojma
Me colaboró	Persona que colaboró para cumplir un determinado trabajo o tarea. <font color=ForestGreen><b>vtr.:</b></font> Nkojwo
Estoy con herida	<font color=ForestGreen><b>adj.:</b></font> Nkójora
Mi herida	Persona que afirma que tiene una herida. <font color=ForestGreen><b>deter.poses.:</b></font> Njora
Estoy con gorra	<font color=ForestGreen><b>prep.deter.poses.:</b></font> Nkómuisi
Estoy con sombrero	<font color=ForestGreen><b>prep.deter.poses.:</b></font> Nkojosi
Mi gorra	<font color=ForestGreen><b>deter.poses.:</b></font> Nmuisi
Me tropecé	Persona que pierde el equilibrio por un tropezón. <font color=ForestGreen><b>vtr.:</b></font> Nkoytetu
Yo venero	Sentir y demostrar gran amor y respeto a una cosa o a una persona por su virtud, dignidad, méritos o santidad. <font color=ForestGreen><b>vtr.:</b></font> Nekyoko
Extremo de los labios	<font color=ForestGreen><b>adj.:</b></font> Ntaramo
Mi hermano mayor	<font color=ForestGreen><b>deter.prep.:</b></font> Npórape
Mi tobillo	<font color=ForestGreen><b>deter.poses.:</b></font> Npigi
Quiero	Persona que afirma de querer o pretender algo. <font color=ForestGreen><b>vtr.:</b></font> Nwoo'o
Me doblé la pierna	<font color=ForestGreen><b>vtr.:</b></font> Nekyopueggio.  <font color=purple>Ej.</font> Estaba jugando fútbol y me doblé la pierna. <font color=purple>/</font> <font color=blue>Nutsaruu'ini ene nekyopueggiopo.</font> 
Me arrodillé en su delante	Arrodillarse delante de una imagen o algo beneficioso. <font color=ForestGreen><b>vtr.:</b></font> Nepyusmirucho
Le di guasca	Flagelar, azotar, castigar por algún hecho a otra persona. <font color=ForestGreen><b>vtr.:</b></font> Nestako
Estoy huasqueando	Dando azotes a otra persona o como también a un animal. <font color=ForestGreen><b>vtr.ger.:</b></font> Nestareko
Lo huasquée el tallo	Afirmación de una persona cortó el tallo de un árbol. <font color=ForestGreen><b>vtr.:</b></font> Nestagie'o
Me agacho	Inclinarse, agacharse para evitar chocar algo por delante. <font color=ForestGreen><b>vtr.prnl.:</b></font> Netpuejko
Lo deshicieron	Deshacer o quitar algo la forma a una cosa descomponiéndola. <font color=ForestGreen><b>vtr.pl.:</b></font> Naetspajko
Yo templo algo	Persona templa cuero, cuerda o que clava una estaca. <font color=ForestGreen><b>adj.:</b></font> Nettápueko
Clavar rápido	Personas que clavan rápido. <font color=ForestGreen><b>vtr.:</b></font> Nettátako
Mi sangre	Consanguíneo. <font color=ForestGreen><b>deter.poses.:</b></font> Nitne
Se lo terminé	Terminar cosa de otras personas. <font color=ForestGreen><b>vtr.:</b></font> Nitno
Mi papá	Dicho de un hijo a su padre. <font color=ForestGreen><b>deter.poses.:</b></font> Niya
Mi Padrastro	<font color=ForestGreen><b>deter.poses.:</b></font> Niyara'o
Me lo llevo con todo	Adueñarse o llevárselo todo. <font color=ForestGreen><b>vtr.:</b></font> Nimiijiko
Yo duermo	Persona que afirma que está durmiendo. <font color=ForestGreen><b>vtr.prnl.:</b></font> Nímoko
Fácil de ganarle	Lograr ganar sin dificultad al oponente. <font color=ForestGreen><b>adj.:</b></font> Ninmomójko
Lo muestro	Persona que expone o muestra algo a la vista señalando para que se vea <font color=ForestGreen><b>vtr.:</b></font> Nimeriko
¡Por suerte!	Lograr de conseguir algo al azar. <font color=ForestGreen><b>n.f.interj.:</b></font> Nitpapajkowo.  <font color=purple>Ej.</font> Por suerte alguien me prestó dinero. <font color=purple>/</font> <font color=blue>Nitpapajkowo nitkowo meriokore.</font>
Lo mastiqué	Persona que mastica chicle, alimento. <font color=ForestGreen><b>vtr.:</b></font> Nnippapajiko
Garrapatilla	Insecto parásito pequeño de las selvas y pampas. <font color=ForestGreen><b>zool.n.f.:</b></font> Ñañi
Su nieto	<font color=ForestGreen><b>adj.dem.:</b></font> Ñamri
Rosado	Color rosa. <font color=ForestGreen><b>adj.:</b></font> Ñachi
Rosado	Color de un hilo, soga, liñada o cinta. <font color=ForestGreen><b>adj.:</b></font> Ñachipi
Su apellido	Dicho de la mujer para referirse al apellido del varón. <font color=ForestGreen><b>deter.poses.:</b></font> Ñapijane
Llamar la atención	Dicho de la mujer para llamar la atención del varón. <font color=ForestGreen><b>vtr.:</b></font> Ñena
Su ano	<font color=ForestGreen><b>deter.poses.:</b></font> Ñichkopeno
Su cola	Su trasero.  <font color=ForestGreen><b>adj.dem.:</b></font> Ñijgi
Éste	<font color=ForestGreen><b>deter.demos.:</b></font> Ñigia
Sabe	Mujer que afirma a un hombre que sabe o conoce. <font color=ForestGreen><b>adj.:</b></font> Ñitko
Su sangre	<font color=ForestGreen><b>deter.demos.:</b></font> Ñitne
Mosquito	Insecto chupa sangre, de personas y de los animales; la picadura produce molestia y enfermedades mortales. <font color=ForestGreen><b>n.m.:</b></font> 'Ñi'u
De él	<font color=ForestGreen><b>deter.poses.:</b></font> Ñiye'e
Su papá	<font color=ForestGreen><b>deter.poses.:</b></font> Ñiya
No está	Cuando la mujer habla refiriéndose a un hombre que no está presente. <font color=ForestGreen><b>adv.l.:</b></font> Ñijina
Su nombre	<font color=ForestGreen><b>adj.dem.:</b></font> Ñíjare
Su diente	<font color=ForestGreen><b>deter.poses.:</b></font> Ño'e
Su abuelo	<font color=ForestGreen><b>adj.dem.:</b></font> Ñochko
Ciempiés	Insecto, gusano de muchas patas. <font color=ForestGreen><b>zool.:</b></font> Ñósopi
¡Por favor!	Pedir ayuda, auxilio. <font color=ForestGreen><b>interj.:</b></font> Ñujpankowo
¡Mirá!	Mirar, echar un vistazo o dar una mirada. <font color=ForestGreen><b>vtr.imper.:</b></font> Pim'a
¡Muéstrele!	Mostrar, revelar, expresar lo que uno ha visto o tiene. <font color=ForestGreen><b>vtr.imper.:</b></font> Pimecha
¿De verdad lo viste?	<font color=ForestGreen><b>n.f.interrog.:</b></font> Pim'ognenajicha
¡Llámame!	Llamar, citar, convocar, reunir. <font color=ForestGreen><b>vtr.imper.:</b></font> Pich'anu
¡Pará!	Ordena frenar, detenerse por alguna causa <font color=ForestGreen><b>vtr.interj.:</b></font> Pichigia
¡Andá a mirar!	Orden a una persona a otra que vaya ver algo. <font color=ForestGreen><b>vtr.imper.:</b></font> Pimojna
¡Tienes que ganarle!	Ordena de vencer, dominar en una competencia. <font color=ForestGreen><b>vtr. cond.imper.:</b></font> Pito'aka
¡Tienes que bautizarte!	Renacer, nombrarse a través del bautismo religioso. <font color=ForestGreen><b>vtr.cond.imper.:</b></font> Pikchosgia
Estirar todo	Orden de una persona a otra de que la pita lo estire todo o termine todo. <font color=ForestGreen><b>vtr.:</b></font> Pitopona
¡Endulza!	Ordena darle sabor dulce al refresco u otra bebida. <font color=ForestGreen><b>vtr.imper.:</b></font> Pitvecha
Eres hechicero	Persona que en algunas culturas hace predicciones, invoca a los espíritus y ejerce prácticas curativas utilizando poderes ocultos y productos naturales. <font color=ForestGreen><b>adj.:</b></font> Pittuj'o
¡Termínalo!	Orden de realizar un trabajo hasta acabar. <font color=ForestGreen><b>vtr.imper.:</b></font> Pituchapo
¡Tienes que casarte!	Persona que dictamina a que se case por el matrimonio religioso o civil. <font color=ForestGreen><b>mod.imper.:</b></font> Pitúchapo
Reconocedor	Persona que fácilmente reconoce a una persona o algo. <font color=ForestGreen><b>adj.:</b></font> Pimotrugi
¡Tú has sido!	<font color=ForestGreen><b>pres.indic.:</b></font> Pitiri'i
¡Termínalo!	Orden de una persona hacia otra acabar una actividad. <font color=ForestGreen><b>vtr.imper.:</b></font> Pita
¡Ni modo!	s.interj.: Pitarine
Llega	Ordena a una persona que debe llegar a tiempo. <font color=ForestGreen><b>vtr.:</b></font> Pitekpa
¿Es usted?	<font color=ForestGreen><b>vtr.interrog.:</b></font> Pitiripo
¡Devolvé!	Persona que tiene que devolver algún objeto prestado a su dueño. <font color=ForestGreen><b>vtr.imper.:</b></font> Pichopa
¡Disértalo!	Orden de una persona a otra que tiene que dar el discurso en público. <font color=ForestGreen><b>vintr.imper.:</b></font> Pechorigia
¡Acuérdate!	Persona que ordena a otra que debe acordarse de alguien o algo. <font color=ForestGreen><b>vintr.imper.:</b></font> Péchanu
¡No te olvides!	Insistir en no olvidarse. <font color=ForestGreen><b>Imper.:</b></font> Pechapo
¡Levántate!	Persona que ordena a otra levantarse. <font color=ForestGreen><b>vtr.imper.:</b></font> Pechpuka
¡Entendé!	Persona que insiste que otra comprenda lo hablado. <font color=ForestGreen><b>vtr.imper.:</b></font> Pechemcha
Eres intelectual	Persona que es inteligente. <font color=ForestGreen><b>adj.:</b></font> Pechemra'i
¿Eres alcohólico?	Pregunta de una persona a otra sobre una adicción negativa. <font color=ForestGreen><b>adj.interrog.:</b></font> ¿Perora'i?
¡Dale un sopapo!	Orden de dar golpe con las palmas de la mano en la cara de otra. <font color=ForestGreen><b>vtr.imper.:</b></font> Peroposgia
Pelea	Acción de pelear. <font color=ForestGreen><b>n.f.:</b></font> Pe'rorigia
¿Entendés o no?	Interrogación de una persona a otra si asimila o entiende. <font color=ForestGreen><b>vtr.interrog.cond.:</b></font> Pechemra'chupka
¡Arrodíllate!	persona que ordena que se arrodille otra. <font color=ForestGreen><b>vtr.prnl.imper.:</b></font> Pekyoka
Eres celoso	Persona que tiene celos por otra. <font color=ForestGreen><b>adj.:</b></font> Petyora'i
Eres loco	Desubicado, persona que no se ubica de lo que expresa. <font color=ForestGreen><b>adj.:</b></font> Pemnanasko
Sin nada	Nombre propio que se le dio al alimento elaborado sin ningún ingrediente para darle un sabor exclusivo. <font color=ForestGreen><b>n.f.:</b></font> Pemna'ejru
¡Atendeme!	Ordena que atienda a lo que habla o explica. <font color=ForestGreen><b>vtr.imper.:</b></font> Pechemchanu
A la suerte / al tanteo	<font color=ForestGreen><b>n.f.:</b></font> Pemna'oko/a
¿Lo amas?	Pregunta a otra persona si ama a alguien. <font color=ForestGreen><b>vtr.interrog.:</b></font> ¿Pemnako?
Adrede	Con intensión de causar algo molesto en otra persona. <font color=ForestGreen><b>adv.:</b></font> Pémure
Por coincidencia	Realizar, hacer, una cosa bien, a conciencia. <font color=ForestGreen><b>n.f.:</b></font> Pemna'oka/po
¡Andá Rezá!	Orden espiritual de pedir perdón o misericordia según su credo religioso, rezando. <font color=ForestGreen><b>vintr.imper.:</b></font> Peñuchapo
¡Menea tu Cadera!	<font color=ForestGreen><b>vtr.imper.:</b></font> Peñegiapo
Advertencia	Ten cuidado. Prevenir, informar, notificar o comunicar algo. <font color=ForestGreen><b>n.f.:</b></font> Pesamijrigia
¿Estás rezando?	Interrogativo a una persona que si esta orando o no. <font color=ForestGreen><b>vtr.interrog.:</b></font> ¿Peñuchwo?
¿Qué miras?	Pregunta a una persona a otra sobre la incomoda situación de observación. <font color=ForestGreen><b>interj.:</b></font> ¿Pepanu?
¡Saltá!	Orden de saltar. <font color=ForestGreen><b>vtr.imper.:</b></font> Peteregia
¡Hacelo rapidito!	Realizar una actividad con diligencia por orden de otra persona. <font color=ForestGreen><b>vtr.imper.:</b></font> Pettsetsejigia
¡Míralo!	Orden de mirar a una persona, animal u objeto. <font color=ForestGreen><b>vtr.imper.:</b></font> Pesñegia
¡Acéptalo!	Aceptar a alguien o algo. <font color=ForestGreen><b>vtr.imper.:</b></font> Peschopa
Tienes que estar de acuerdo con la opinión de otra persona	<font color=ForestGreen><b>vtr.cond.:</b></font> Peschopyo
¿Estarás de acuerdo?	<font color=ForestGreen><b>vtr.interrog.:</b></font> ¿Peschopyo?
¡Levantá la cabeza!	<font color=ForestGreen><b>vtr.imper.:</b></font> Pechpusgia
¡Córtalo!	Orden de cortar algún objeto con cuchillo. <font color=ForestGreen><b>vtr.imper.:</b></font> Pestigia
¡Dale de comer!	Orden de dar de comer a alguien o a un animal. <font color=ForestGreen><b>vtr.imper.:</b></font> Pengia
¡Pescá!	Orden de una persona a otra para pescar. <font color=ForestGreen><b>vtr.imper.:</b></font> Pengia
¿Estás pescando?	Pregunta de una persona a otra si está pescando. <font color=purple>/</font> También se utiliza para preguntar si le ha dado de comer a una persona o animal. <font color=ForestGreen><b>vtr.ger.interrog.:</b></font> ¿Penko?
¿Ya le dio de comer?	<font color=ForestGreen><b>vtr.interrog.:</b></font> ¿Penkoripo?
¿Ya pescaste?	<font color=ForestGreen><b>vtr.interrog.:</b></font> ¿Penkoripo?
Tienes sed de tomar, beber, de saciarse con alguna bebida	<font color=ForestGreen><b>vtr.afirm.:</b></font> Petarako?
Botar algo comestible en un lugar determinado	<font color=ForestGreen><b>vtr.:</b></font> Pepchoka
Botar, tirar, Lanzar algo al suelo	<font color=ForestGreen><b>vtr.:</b></font> Pepchopuegia
¡Tienes que retacear!	Cortar, picar trozar por pedazos o retacear. <font color=ForestGreen><b>vtr.cond.imper.:</b></font> Pestitigigia
¡Tienes que cortar!	Orden de cortar diferentes objetos o cosas. <font color=ForestGreen><b>vtr.imper.:</b></font> Pestigia
¡Pégale!	Persona que ordena a pegar a la otra persona. <font color=ForestGreen><b>vtr.imper.:</b></font> Pe'a
¡Afilá!	Orden de afilar herramientas u otros objetos metálicos. <font color=ForestGreen><b>vtr.imper.:</b></font> Pessuka
¡Aplástalo!	Orden de aplastar un objeto, animal o cosas. <font color=ForestGreen><b>vtr.imper.:</b></font> Peñatsigia
¡Tentá su cabeza!	Orden de palpar la cabeza de otra persona o animal. <font color=ForestGreen><b>vtr.imper.:</b></font> Pemmosgia
¡Ámame!	Orden de amar. <font color=ForestGreen><b>vtr.imper.:</b></font> Pemnákanu
Tu deuda	persona que tiene deuda pendiente. <font color=ForestGreen><b>adj.dem.n.f.:</b></font> Pentévene
Es tu trabajo	Afirmación de una persona a otra. <font color=ForestGreen><b>deter.poses.:</b></font> Pemtone
Jochi colorado	Animal silvestre que se alimenta de la calucha del motacú. <font color=ForestGreen><b>zool.:</b></font> Pe'i
Pedorro	Que expele ventosidades del vientre con frecuencia o sin reparo. <font color=ForestGreen><b>adj.:</b></font> Pejwa'i
¡Zambullí!	Orden para que se sumerja en el agua. <font color=ForestGreen><b>vtr.imper.:</b></font> Pesmuka
Casa	Lugar de refugio para una familia. <font color=ForestGreen><b>n.f.:</b></font> Peti
¿Le pegaste?	<font color=ForestGreen><b>vtr.interrog.:</b></font> Pe'o
Eres peleador	Califica a una persona de su cualidad de peleador. <font color=ForestGreen><b>adj.:</b></font> Pe'ora'i
Marimono	Mono animal silvestre que vive en la selva amazónica. <font color=ForestGreen><b>zool.:</b></font> Patore
Tojito pequeño	Ave que imita los cantos, sonidos de otras aves y algunos animales. <font color=ForestGreen><b>zool.:</b></font> Paturi
¡Modifícalo!	Orden de transformar algún objeto. <font color=ForestGreen><b>vtr.imper.:</b></font> Pekyecha
Transformador	Persona que posee el don de transformar cosas. <font color=ForestGreen><b>adj.:</b></font> Pekyera'i
Tú Abarca	<font color=ForestGreen><b>deter.poses.:</b></font> Pepkopewo
¡Tápalo!	Ordena tapar o cubrir a persona o cosa de algo para protegerlo. <font color=ForestGreen><b>vtr.imper.:</b></font> Pepkucha
¡Cerralo!	Orden de clausurar, obstruir sellar u obturar. <font color=ForestGreen><b>vtr.imper.:</b></font> Pjiocha
¡Tendé el mantel!	Orden de poner y acomodar el mantel en la mesa. <font color=ForestGreen><b>vtr.imper.:</b></font> Pepkómegia
¿Hablaste?	<font color=ForestGreen><b>vtr.interrog.:</b></font> ¿Pechjiko?
Sos hablador	Afirmación de una persona a otra que es lenguaraz. <font color=ForestGreen><b>adj.:</b></font> Pechjikra'i
¡Atendé!	<font color=ForestGreen><b>vtr.imper.:</b></font> Puechora'i
Pan	Alimento hecho de harina. <font color=ForestGreen><b>n.m.:</b></font> Panu
Perro	Animal Doméstico. <font color=ForestGreen><b>zool.:</b></font> Paku
Taitetú	 Animal silvestre. Su carne es comestible. <font color=ForestGreen><b>zool.:</b></font> Pakrara
¡Hacéte inyectar!	Orden de una persona a otra de que se haga inyectar con una jeriga <font color=ForestGreen><b>vintr.imper.:</b></font> Pakyumtu
¡Lávate tu testículo!	<font color=ForestGreen><b>vtr.prnl.imper.:</b></font> Paksip'agi
¡Ponte Cabecera!	<font color=ForestGreen><b>vtr.imper.:</b></font> Pakchunsiji
¡Sembrá!	Persona que ordena que siembre. <font color=ForestGreen><b>vtr.imper.:</b></font> Paksukre
¡Lávate la cara!	<font color=ForestGreen><b>vtr.imper.:</b></font> Paksipugi
Tienes que hacer para tu chaco	<font color=ForestGreen><b>cond.:</b></font> Pakesane
¿Será que lo vas a necesitar?	<font color=ForestGreen><b>cond.interrog.:</b></font> ¿Pakmumpuka?
¡Pobre perro!	Expresión de pena por un perro. <font color=ForestGreen><b>adj.interj.:</b></font> Pakchicha
¡Tienes que tener hijo!	<font color=ForestGreen><b>cond.imper.:</b></font> Pakchicha
Perrito	<font color=ForestGreen><b>n.m.dim.:</b></font> Pakgira
¡Tenés que chapapear!	Carne, pescado asado a fuego. <font color=ForestGreen><b>vtr.imper.:</b></font> Pakjítoru
¡Cocé!	Cocer De manera lenta y con cuidado la carne o pescado. <font color=ForestGreen><b>vtr.imper.:</b></font> Pjito'a
¡Tienes que asar!	Cocer porciones de carne o pescado. <font color=ForestGreen><b>vtr.imper.:</b></font> Pakojtoru
¡Tienes que estar atento!	Dar advertencia. <font color=ForestGreen><b>vtr.imper.:</b></font> Pasamóra'i
Campana	Instrumento de metal en forma de copa invertida que suena al golpearlo. <font color=ForestGreen><b>n.f.:</b></font> Punu
Charuto	Resto del cigarro de tabaco. <font color=ForestGreen><b>n.m.:</b></font> Puchu
Ciego	Persona no vidente. <font color=ForestGreen><b>adj.:</b></font> Puchugi
Avispa	Insecto que elabora celdas de prisión de barro, para encerrar a su presa. (Nombre común camoatí). <font color=ForestGreen><b>zool.:</b></font> Puti
Fortuna	Planta de mediana altura que sirve para medicina natural. <font color=ForestGreen><b>bot.:</b></font> Puutuna
Maíz	Grano blando de color amarillo. <font color=ForestGreen><b>bot.:</b></font> Puugieru
Yayú	Pez que vive en lugares pantanosos de la Amazonia. <font color=ForestGreen><b>zool.:</b></font> Pújogi
Eres dormilón	<font color=ForestGreen><b>adj.:</b></font> Pimkugi
¡Tejé!	Orden de elaborar un tejido. <font color=ForestGreen><b>vtr.imper.:</b></font> Pitsmerigia
Colibrí, picaflor	Ave silvestre, pequeña que habita en las selvas y pampas. <font color=ForestGreen><b>zool.:</b></font> Pitse
Turiro	Termita, insecto que perfora y se alimenta de madera. <font color=ForestGreen><b>zool.:</b></font> Pusi
Perezoso	Nombre común de una especie de mamífero lento. <font color=ForestGreen><b>zool.:</b></font> Po'e
Otro	Uno más. Necesito otro, que pase otro. <font color=ForestGreen><b>deter.:</b></font> 'Pona
Tu pueblo	Demuestra el lugar de procedencia natal. <font color=ForestGreen><b>adj.dem.:</b></font> Pkowsa
¡Ponelo!	Orden de colocar un objeto en un sitio o lugar. <font color=ForestGreen><b>vtr.imper.:</b></font> Pnoka
¡Añadilo!	persona que ordena agregar o incorporar una cosa con la otra. <font color=ForestGreen><b>vtr.imper.:</b></font> Pyukorocha
Abarca	Calzado de cuero que cubre solo la planta de los pies. <font color=ForestGreen><b>n.f.:</b></font> Pokopewo
¡Guíate!	Guiarse en el monte por el ruido o un sonido <font color=ForestGreen><b>vtr.imper.:</b></font> 'Po'cha
Pobre	Persona de escaso recurso económico. <font color=ForestGreen><b>adj.:</b></font> Powre
Paleta	Omóplatos. <font color=ForestGreen><b>anat.:</b></font> Powrocho
Tu cuerpo	<font color=ForestGreen><b>adj.dem.:</b></font> Pyog'e
Ajeno	Animal, objeto que pertenece a otra persona. <font color=ForestGreen><b>adj.:</b></font> 'Poy'e
Chulupi	Cucaracha, insecto de cuerpo aplanado negruzco. <font color=ForestGreen><b>zool.:</b></font> Poymo
Perro silvestre	Anmal salvaje de las selvas y pampas de la Amazonía. <font color=ForestGreen><b>zool.:</b></font> 'Popaku
Que tiene lunar	Persona, animal que tiene lunar. <font color=ForestGreen><b>adj.:</b></font> Pocho'o
Otro lado	Que está del otro lado. <font color=ForestGreen><b>deter.:</b></font> 'Pochkoyo
Acabado, perfecto, consumado, terminado	<font color=ForestGreen><b>adj.:</b></font> Pochpo
Terminado	Poner término a una cosa. <font color=ForestGreen><b>adj.:</b></font> Pochripo.  <font color=purple>Ej:</font> ¡Por fin termine mi trabajo!
Orrillear	Esquivar un obstáculo o dificultad. <font color=ForestGreen><b>vtr.:</b></font> Pócheko
Lo acabaste	Se lo acabó. <font color=ForestGreen><b>vtr.:</b></font> Pitoku'o
¡Tienes que terminalo!	Orden de terminar o acabar algo. <font color=ForestGreen><b>vtr.imper.:</b></font> Pitoku'a
¡Hacelo escuchar!	Persona que ordena a darle la información. O hacer probar algún alimento o bebida. <font color=ForestGreen><b>vtr.imper.:</b></font> Pimsama
Tienes que ofrecer	Orden de ofrecer algún objeto a. <font color=ForestGreen><b>v.mod.cond.:</b></font> Pimsamuigia
Tienes que vender	Persona que ordena vender. <font color=ForestGreen><b>v. mod.cond.:</b></font> Pijrorigia
¡Hacelo enojar!	Orden de hacer molestar a otra persona. <font color=ForestGreen><b>vtr.imper.:</b></font> Pimyunoka <font color=purple>/</font> pimyuujecha
Tienes que darle	De dar, otorgar. <font color=ForestGreen><b>mod.cond.:</b></font> Pijroka
Tu labio	Señala su labio. <font color=ForestGreen><b>adj.dem.:</b></font> Pcheyo
Tu mosquitero	Que el objeto le pertenece. <font color=ForestGreen><b>pron.dem.:</b></font> Pchaku
Tu corva	Le indica la parte posterior de la rodilla del cuerpo humano. <font color=ForestGreen><b>pron.dem.:</b></font> Pkute
Tienes que volver	Condiciona a regresar al sitio o lugar. <font color=ForestGreen><b>v.mod.cond.:</b></font> Pchapo
Tienes que besarlo	Condiciona a besar o tocar a alguien con los labios en señal de saludo, cariño. <font color=ForestGreen><b>v.mod.cond.:</b></font> Ptsuka
Tienes que apurarte	<font color=ForestGreen><b>v.mod.cond.:</b></font> Pyoyuchapo
¿Estás temblando?	<font color=ForestGreen><b>vtr.interrog.:</b></font> Pyooyoyojiko
Tienes que colgarlo	<font color=ForestGreen><b>v.mod.cond.:</b></font> Pchumka
¿Lo encontraste?	<font color=ForestGreen><b>vtr.interrog.:</b></font> ¿Pchimpo?
Tienes que ahorcarlo	<font color=ForestGreen><b>v.mod.cond.:</b></font> Pchumnuka
Tienes que jalarlo	<font color=ForestGreen><b>v.mod.cond.:</b></font> Pchuuka
Tienes que arrastrarlo	Orden de arrastrar canoa, palo, etc <font color=ForestGreen><b>v.mod.cond.:</b></font> Pchuupuegia
Tienes que arrastrarlo	<font color=ForestGreen><b>v.mod.cond.:</b></font> Pchuurigia
Tienes que sancochar	Orden de sancochar huevo. <font color=ForestGreen><b>v.mod.cond.:</b></font> Pchun'aka
Tienes que sancocharlo	Orden de sancochar alimentos. <font color=ForestGreen><b>v.mod.cond.:</b></font> Pchunoka
¡Llévalo a la fuerza!	<font color=ForestGreen><b>vtr.imper.:</b></font> Pchumtetegia
Tienes que poner el toco debajo de algo	<font color=ForestGreen><b>v.mod.cond.:</b></font> Pchúmocha
Tienes que acuñarlo	<font color=ForestGreen><b>v.mod.cond.:</b></font> Pchuncha
Tienes que preguntarle	<font color=ForestGreen><b>v.mod.cond.:</b></font> Pyoserigia
Tienes que pedir	<font color=ForestGreen><b>v.mod.cond.:</b></font> Pyosserigia
Tienes que orar por mí	<font color=ForestGreen><b>v.mod.cond.:</b></font> Pyosiuchanu
Es tu parte	<font color=ForestGreen><b>adj.dem.:</b></font> Pyekna
Es tuyo	<font color=ForestGreen><b>adj.poses.:</b></font> Pye'e
Tienes que ir	<font color=ForestGreen><b>v.mod.cond.:</b></font> Pyana
Tienes que huir, escapar	<font color=ForestGreen><b>v.mod.cond.:</b></font> Pyutajgia
Tienes que peluquearme o cortarme el cabello	<font color=ForestGreen><b>v.mod.cond.:</b></font> Pchuksigianu
¿Lo estás peluqueando?	<font color=ForestGreen><b>vtr.interrog.ger.:</b></font> Pchuksiko
¿Está peluqueando?	<font color=ForestGreen><b>vtr.interrog.:</b></font> Pchuksiriko
¡Ponte a guardar tus cosas!	<font color=ForestGreen><b>vtr.imper.:</b></font> Pyunaregia
¡Guárdalo!	<font color=ForestGreen><b>vtr.imper.:</b></font> Pyunaka
Tu manija	<font color=ForestGreen><b>adj.poses.:</b></font> Pyuwaragia
Tu primogénito	<font color=ForestGreen><b>adj.dem.:</b></font> Pimaruupe
Ramón	Nombre de persona. <font color=ForestGreen><b>n.:</b></font> Ramón
Rayador	Utensilio que se utiliza para rayar algún alimento. <font color=ForestGreen><b>n.m.:</b></font> 'Rekropa
Nuevo	Objeto o cosa que están nueva <font color=ForestGreen><b>adj.:</b></font> 'Rajru
Ladrillo	Material de construcción hecho de barro cocido.  <font color=ForestGreen><b>n.m.:</b></font> Rawriyu
Farol	Utensilio para alumbrar las calles que consiste en una luz eléctrica. <font color=ForestGreen><b>n.m.:</b></font> Rateena
Lata	envase de plástico, aluminio o metal. <font color=ForestGreen><b>n.f.:</b></font> Rata
Joven	Persona que esta en la etapa de la juventud. <font color=ForestGreen><b>adj.:</b></font> 'Raetona
Tutuma	Fruto de la planta del tutumo, del que se elabora como recipiente. <font color=ForestGreen><b>n.f.:</b></font> 'Repo
Lima	Fruta cítrica comestible. <font color=ForestGreen><b>bot.:</b></font> Rimateesia
Basura	Conjunto de desperdicios, barreduras, materiales etc., que se desechan. <font color=ForestGreen><b>n.f.:</b></font> 'Rimeji
Limón	Fruta cítrica que sirve para sazonar la comida. <font color=ForestGreen><b>bot.:</b></font> Rimo
Romana	Máquina que sirve para pesar cosas. <font color=ForestGreen><b>n.f.:</b></font> Romana
Guaso	Venado que vive en la selva. <font color=ForestGreen><b>zool.:</b></font> Ropo
Médico	Persona que tiene la autorización académica y legal para ejercer la medicina. <font color=ForestGreen><b>adj. n.m.:</b></font> Roktoru
Carcoma	Insecto que se utiliza para adornar el plumaje del machetero. <font color=ForestGreen><b>zool.:</b></font> Rókosi
Gracias	Expresión que se usa para agradecer algo a una persona. <font color=ForestGreen><b>n.f.:</b></font> Rusrupaya
Palometa	Pez de agua dulce. <font color=ForestGreen><b>zool.:</b></font> 'Rumo
Melero	Animal silvestre de la selva. <font color=ForestGreen><b>zool.:</b></font> 'Rukre
Peto abeja	Insecto de la familia de la abeja. <font color=ForestGreen><b>zool.:</b></font> 'Ruusi
Lucresia	Nombre de persona femenina. <font color=ForestGreen><b>n.f.:</b></font> Rukresia
Lunes	Primer día de la semana <font color=ForestGreen><b>n.m.:</b></font> Rúnesi
Día	Parte del día en que dura la claridad del Sol. <font color=ForestGreen><b>n.m.:</b></font> Sache
Fruta de la planta de la sandía	<font color=ForestGreen><b>bot.:</b></font> Saniya
Sábado	Sexto día de la semana. <font color=ForestGreen><b>n.f.:</b></font> Sáwaru
Machete	Herramienta que se utiliza para limpieza. <font color=ForestGreen><b>n.m.:</b></font> 'Saype
Sapo	Anfibio similar a la rana de mayor tamaño. <font color=ForestGreen><b>zool.:</b></font> Sapu
Su Apellido	<font color=ForestGreen><b>n.m.adj.dem.:</b></font> Sapíjane
Chaco	Espacio donde se produce los alimentos agrícolas. <font color=ForestGreen><b>n.m.:</b></font> 'Santi
Varios días	Conjunto de días durante el mes o año. <font color=ForestGreen><b>deter.:</b></font> Sachono
Sol del Gran Mojos	<font color=ForestGreen><b>n.p.:</b></font> Sáchemojo
Ají sol	Ají muy picante. <font color=ForestGreen><b>bot.:</b></font> Sachemo
Jahusi	Reptil pequeño de colores tornasoles que vive en la tierra. <font color=ForestGreen><b>zool.:</b></font> Semu
Mujer	Persona de sexo femenino <font color=ForestGreen><b>n.f.:</b></font> 'Seno
Tortuga	Animal silvestre del monte con caparazón. <font color=ForestGreen><b>zool.:</b></font> Sipu
Onda	Arma hecha con dos correas que sirve para lanzar piedras. <font color=ForestGreen><b>n.m.:</b></font> Sirinka
Oso hormiguero	Animal silvestre que se alimenta de hormiga. <font color=ForestGreen><b>zool.:</b></font> 'Siipo'e
Piyu	Avestruz. Ave que es corredora de pata larga. <font color=ForestGreen><b>zool.:</b></font> Sipa
Silla	Asiento individual con patas y respaldo. <font color=ForestGreen><b>n.f.:</b></font> Siya
Nariz	Parte saliente del rostro humano situada entre los ojos y la boca, con dos orificios en la parte inferior y que sirve para respirar y oler. <font color=ForestGreen><b>anat.:</b></font> Siri
Tiluchi	Ave de color Marrón que elabora su nido de barro. <font color=ForestGreen><b>zool.:</b></font> 'Sigieru
Incapaz	Persona inútil de realizar un mandato o actividad. <font color=ForestGreen><b>adj.:</b></font> Súteji
Chaisita	Paloma pequeña. <font color=ForestGreen><b>zool.:</b></font> Sivigira
Es de ella	Objeto que corresponde a ella. <font color=ForestGreen><b>adj.dem.:</b></font> Sye'e
Cangrejo, seboro	Crustáceo de río. <font color=ForestGreen><b>zool.:</b></font> Sose
Gato montés	Felino silvestre. <font color=ForestGreen><b>zool.:</b></font> Sóñore
Animal	Se utiliza para referirnos a cualquier animal. <font color=ForestGreen><b>zool.n.p.:</b></font> Sórare
Tabaco	Hoja de esta planta que, curada y preparada, se fuma, se masca o se aspira en forma de rapé. <font color=ForestGreen><b>n.m.:</b></font> Saware
Su abuelo	<font color=ForestGreen><b>adj. dem.:</b></font> Sochko
Chancho, cerdo	<font color=ForestGreen><b>zool.:</b></font> Smoru
Pato macho	Pato doméstico y silvestre. <font color=ForestGreen><b>zool.:</b></font> 'So'i
Zapato	<font color=ForestGreen><b>n.m.:</b></font> Spatu
Sucha	Ave carroñera. <font color=ForestGreen><b>zool.:</b></font> Spugi
Sama	Especie de araña de tamaño normal. <font color=ForestGreen><b>zool.:</b></font> Smatu
Pacú	Pez de agua dulce. <font color=ForestGreen><b>zool.:</b></font> Spuire
Chonta	Fruto de la palmera propia de la selva. <font color=ForestGreen><b>bot.:</b></font> Stovere
Kutuqui	Planta de olor rechinante que se utiliza como medicina natural. <font color=ForestGreen><b>bot.:</b></font> Smopre
Aurora	Ave que recibe ese nombre. <font color=ForestGreen><b>zool.:</b></font> Spupkure
Anta, tapir	Animal silvestre que vive en la selva. <font color=ForestGreen><b>zool.:</b></font> Samo
Tiesto	Utensilio de barro o metal que utiliza para tostar. <font color=ForestGreen><b>n.m.:</b></font> Srugrecho
Tostado	Alimento tostado de la carne de pescado o Como también de harina. <font color=ForestGreen><b>adj.:</b></font> Srupa
Sembradío	Que está destinado al sembrado. <font color=ForestGreen><b>n.f.adj.:</b></font> Skureko
Su nieto	<font color=ForestGreen><b>pron.dem.:</b></font> Samri
Especie de Martín pescador	Ave silvestre que habita en las orillas de los ríos. <font color=ForestGreen><b>zool.:</b></font> Sitgiiri
Martín pescador	Ave silvestre que se alimenta de peces. <font color=ForestGreen><b>zool.:</b></font> Schakra
Cuervo víbora	Tipo de ave silvestre que se alimenta de peces <font color=ForestGreen><b>zool.:</b></font> Schokre
Indomable	Que no se le puede dominar o domar. <font color=ForestGreen><b>adj.:</b></font> taato'okore
Su color	Afirmar el color de algo. <font color=ForestGreen><b>adj.dem.:</b></font> Taem'i
Apagado	Electrodoméstico, fuego, foco, mechero, vela que está apagado <font color=ForestGreen><b>adj.:</b></font> Tem'o
Lo mueve	Mover con una máquina algún objeto de gran tamaño o pesado. <font color=ForestGreen><b>vtr.:</b></font> Teyjoko
Su anzuelo	Cuando el anzuelo corresponde a la liñada. <font color=ForestGreen><b>adj.dem.:</b></font> Tenrove
Leque	Ave comúnmente de la pampa. <font color=ForestGreen><b>zool.:</b></font> Tete'u
Aviso	Mensaje o comunicado de lo que se puede recordar, pasado, presente. <font color=ForestGreen><b>n.m.:</b></font> Techokore
Entendido	Persona o animal que entiende o capta. <font color=ForestGreen><b>vtr.:</b></font> Taechemra'i
Se preocupa	Animal que tiene pena por su cría, o por volver a su lugar de origen. <font color=ForestGreen><b>vtr.prnl.:</b></font> Techomji
Manera de un animal en reconocer a su amo	<font color=ForestGreen><b>vtr.afirm.:</b></font> Temoti
Escucha	Techora'i. <font color=ForestGreen><b>vtr.:</b></font> T-samra'i
Escuchador	Persona que tiene buen oído para escuchar algún sonido, voz. <font color=ForestGreen><b>adj.:</b></font> T-samrogño
Algo que destinado para una actividad especial	<font color=ForestGreen><b>pron.indef.:</b></font> Téchosi
Construcción hecha de animales	Nidos. Cuevas. <font color=ForestGreen><b>n.m.:</b></font> Tepyako
El único	Se utiliza para referirnos a que una persona va llevar solo a un animal o cosa en especial. <font color=ForestGreen><b>adj.:</b></font> Takejworichu
Todo	Se refiere para afirmar o preguntar si los animales u objetos están todos en un mismo lugar. <font color=ForestGreen><b>deter.pron.indef.:</b></font> Tamutu
Se despertó	Para afirmar que el animal se ha despertado. <font color=ForestGreen><b>vtr.prnl.:</b></font> Tejamikpo
Su patio	<font color=ForestGreen><b>adj.dem.:</b></font> Tamíro'u
Me lo dio	<font color=ForestGreen><b>vtr.:</b></font> Tíjroknu
Le hace calor	<font color=ForestGreen><b>vtr.prnl.:</b></font> Tijru'o
Limosnero	Persona que pide limosna. <font color=ForestGreen><b>adj.:</b></font> T-yosse'i
Reloj	Objeto que sirve para medir el tiempo, indicador de horas, minutos y segundos. <font color=ForestGreen><b>n.m.:</b></font> Tkimotyorakore
Se derramó	Referido a la semilla que se demarró sobre el campo. <font color=ForestGreen><b>vtr.:</b></font> Teprekwo
Está flaco	Afirmación sobre una persona que perdió peso por alguna enfermedad o que tiene contextura delgada. <font color=ForestGreen><b>adj.:</b></font> Tejwóro'i
Está caliente	Afirmación sobre un objeto redondo, fruta, caldera caliente. <font color=ForestGreen><b>adj.:</b></font> Tijre'i
Calor	Energía que se manifiesta por un aumento de temperatura. <font color=ForestGreen><b>n.m.:</b></font> Tíjru'i
Caliente	Mesa, silla que está caliente. <font color=ForestGreen><b>adj.:</b></font> Tijrumo
Lo erró	Animal que por su bravura le falló con el asta o ataque a una persona. <font color=ForestGreen><b>vtr.:</b></font> Taejeko
Se partió	Afirmación de que la tierra o piso se dividió. <font color=ForestGreen><b>vtr.:</b></font> Tepjapueko
Masa de yuca que le falta fermentar	<font color=ForestGreen><b>n.f.:</b></font> Tu'eji
Persona que por su característica no sabe escuchar	<font color=ForestGreen><b>adj.:</b></font> Tu'esi
Valiente	Persona o animal que actúa con valor. <font color=ForestGreen><b>adj.:</b></font> 'Tummeji
Frío	Temperatura: Clima está frío. <font color=ForestGreen><b>n.m.:</b></font> Tummako
Fuerzudo	Persona que tiene mucha fuerza. <font color=ForestGreen><b>adj.:</b></font> Tume
Canoa, gaveta, tutuma de tamaño grande	<font color=ForestGreen><b>n.f.:</b></font> 'Tumesi
Que  enseña	Persona que transmite enseñanza. <font color=ForestGreen><b>n.f.m.:</b></font> Timitriko
Fuerza	Fuerza o energía de una maquinaria o animal. <font color=ForestGreen><b>n.m.:</b></font> Tatúmewo
Silba	Persona o animal que emite un silbido. <font color=ForestGreen><b>vintr.:</b></font> T-siko
Color negro	<font color=ForestGreen><b>n.m.:</b></font> T-siso
Se defecó	<font color=ForestGreen><b>vtr.prnl.:</b></font> T-soko
Se  enojó	Persona, animal o ave que se enoja. <font color=ForestGreen><b>vtr.prnl.:</b></font> T-semo
Ave silvestre nocturna que vive en la selva	<font color=ForestGreen><b>zool.:</b></font> T-seseko
Se detuvo	Exclusivo: para animal que se para o detiene por algún peligro o ruido, también cuando el avión aterriza. <font color=ForestGreen><b>vintr.:</b></font> Tichiko
Bibosi	Árbol de la selva que crece en la parte baja especialmente en la orilla de los ríos. <font color=ForestGreen><b>bot.:</b></font> Tsatsagi
Comadreja	Animal nocturno marsupial de la familia de los roedores. <font color=ForestGreen><b>zool.:</b></font> Tsaru
Gallareta	Ave de color rojiso de patas largas que habita en los lugares pantanosos. <font color=ForestGreen><b>zool.:</b></font> Tseru
Está vivo/viva	Animal, planta o persona que tiene vida o existe. <font color=ForestGreen><b>adj.:</b></font> Titoriko
Da afirmación de que un animal o ave le da de comer o amamantar	<font color=ForestGreen><b>vtr.afirm.:</b></font> Taejroko
Le gusta dar	Le Agrada compartir. <font color=ForestGreen><b>vtr.:</b></font> Tijrokra'i
Destructor	Persona o animal que le gusta destruir. <font color=ForestGreen><b>adj.:</b></font> Tisera'i
Chichilo	Mono pequeño salvaje de color amarillento. <font color=ForestGreen><b>zool.:</b></font> Tsigi
Lejía	Líquido extraído de la ceniza de la cáscara de plátano o del árbol etc. <font color=ForestGreen><b>n.f.:</b></font> Tsima
Orinón	Persona que por una enfermedad o mala costumbre micciona a cada rato. <font color=ForestGreen><b>adj.:</b></font> Tsimakure
Cagón	Persona que defeca a cada rato. <font color=ForestGreen><b>adj.:</b></font> T-sókra'i
Sin sabor	Comida o bebida que está sin gusto. <font color=ForestGreen><b>adj.:</b></font> T-yakaeru
Su hembra	<font color=ForestGreen><b>adj.dem.:</b></font> Tayeno
Su garganta (tragadero)	<font color=ForestGreen><b>adj.dem.:</b></font> Taereno
Patujú	Flor de planta silvestre que vive en lugares húmedos. <font color=ForestGreen><b>bot.:</b></font> Taruuno
Perdió	Persona que pierde algún juego o competencia. <font color=ForestGreen><b>vtr.:</b></font> Tito'a
Esqueleto	Hueso de personas, animales. Vertebrados. <font color=ForestGreen><b>n.m.anat.:</b></font> Titopéraji
Sin hierva	Espacio descubierto que no tiene hierva. <font color=ForestGreen><b>prep.:</b></font> Titopa'i
Se acabó	Afirmación de que un trabajo, comida o actividad se ha terminado. <font color=ForestGreen><b>vtr.:</b></font> Títowo
Mago	Persona que tiene poderes ocultos. <font color=ForestGreen><b>n.m.:</b></font> Tittuj'o
Pelopincho	Persona que tiene el cabello parado. <font color=ForestGreen><b>adj.:</b></font> Tichekosi
Lleno	Recipiente o vasija que está llena. <font color=ForestGreen><b>adj.:</b></font> Tinko
Ya se llenó	Afirmación de que un recipiente, carretón o vasija esta completamente lleno. <font color=ForestGreen><b>vtr.:</b></font> Tinkopo
Claridad	Ambiente que esta iluminado o que tiene visibilidad. <font color=ForestGreen><b>adj.:</b></font> Tjaraku
Amaneció	Afirmación que comienza un nuevo día. <font color=ForestGreen><b>v.impers.:</b></font> Tjara'i
Color Blanco	<font color=ForestGreen><b>adj.:</b></font> Tjopu
Blanco	Persona que tiene la tez o piel blanca. <font color=ForestGreen><b>adj.:</b></font> Tjopuna
Está amaneciendo	<font color=ForestGreen><b>v.impers.:</b></font> Tjarakupo
Está mirando	Afirmación de que esta mirando algún evento o actividad. <font color=purple>/</font> Persona que es mirón. <font color=ForestGreen><b>vtr.:</b></font> Timora'i
Rayo	Descarga eléctrica entre dos nubes cargada de electricidad estática. <font color=ForestGreen><b>n.m.:</b></font> Taechcharako
Erección	Aumento del volumen y la rigidez de un órgano del cuerpo (como el clítoris, los pezones, especialmente, el pene). <font color=ForestGreen><b>n.f.:</b></font> T-semoyogi
Quebraron los huevos	Afirmación de que las crías de los ovíparos salieron del cascaron. <font color=ForestGreen><b>vintr.afirm.:</b></font> Taepcharakono
Quebró Sing	Taepcharakono. <font color=ForestGreen><b>vintr.:</b></font> Taepchako
Lo abrigó	Afirmación de que un animal o ave cubre o abriga a sus crías. <font color=ForestGreen><b>vtr.:</b></font> Takomjicho
Apareamiento	Acción de aparear o aparearse un macho y una hembra. <font color=ForestGreen><b>n.m.:</b></font> Takoyeno
Insistente	Acción de insistir del animal hasta conseguir lo que quiere. <font color=ForestGreen><b>adj.:</b></font> Takomesegnérawo
Está asando	Acción de una persona cuando esta asando carne, pecado. <font color=ForestGreen><b>vtr.:</b></font> Tkojmoru
Que es necesario	Por necesidad o por obligación. <font color=ForestGreen><b>adv.:</b></font> Tkomnukre
Fermentado	Bebida que esta fermentado.  <font color=purple>Ej.</font> La chicha, guarapo, chapunato que se elabora y consume dentro los Mojeños Trinitarios. <font color=ForestGreen><b>adj.:</b></font> Tkotsiomo
Dolencia	Persona que afirma que esta con alguna dolencia. <font color=purple>/</font> También se utiliza para referirse al ají que esta picante. <font color=ForestGreen><b>n.f.:</b></font> Tkoti
Leñear	Persona que va a recolectar o cortar leña. <font color=ForestGreen><b>vtr.:</b></font> Tneriko
Fruta	Fruta de algún árbol. <font color=ForestGreen><b>n.:</b></font> To'i
Rancio	Que con el tiempo toma un sabor y olor más fuertes mejorándose o echándose a perder. <font color=ForestGreen><b>adj.:</b></font> Tko'u
Florece	Afirmación que un árbol está con flores. <font color=ForestGreen><b>bot.vtr.:</b></font> Tkoj'u
Tiene fruta	Afirmación que un árbol tiene fruta. <font color=ForestGreen><b>n.f.:</b></font> Tko'i
Arrugado	<font color=ForestGreen><b>adj.:</b></font> Tvíchemo
Inflamado	Persona que presenta absceso por algún golpe o enfermedad. <font color=ForestGreen><b>adj.:</b></font> Tyamo
Vuela	Afirmación de que un objeto o ave esta volando. <font color=ForestGreen><b>adj.:</b></font> Tyoro
Ladrón	Persona que hurta lo que no es suyo. <font color=ForestGreen><b>adj.:</b></font> Tyomera'i
Largo	Que tiene más extensión en una de las dimensiones del plano que en otra. <font color=ForestGreen><b>adj.:</b></font> Tyumo
Está contento	Estado de ánimo de una persona, animal. <font color=ForestGreen><b>adj.:</b></font> Tyuusamre
Bien	Afirmativo para decir que un trabajo o hecho está bien. <font color=ForestGreen><b>adv.:</b></font> Tyuri
Bonito(a)	Que tiene belleza o atractivo y resulta agradable de contemplar o de escuchar <font color=ForestGreen><b>adj.:</b></font> Tyuunanaji
Delicioso	Afirmación de que la comida, fruta que esta sabroso. <font color=ForestGreen><b>adj.:</b></font> Tyuunisi
Bonito	Exclusivamente para: una canción, conversación, discurso esta bonito o interesante. <font color=ForestGreen><b>adj.:</b></font> Tyuupi
Come siripi	Persona que le gusta comer el siripi. <font color=ForestGreen><b>adj.:</b></font> Tyuuko
Flecha larga	Herramienta de caza y pesca propia de los pueblos originarios. <font color=ForestGreen><b>n.f.adj.:</b></font> Tyutagrigi
Aguja larga	Herramienta de costura. <font color=ForestGreen><b>n.f.adj.:</b></font> Tyupa
Árbol de tallo largo	<font color=ForestGreen><b>bot.adj.:</b></font> Tyugi
Se va	Afirmación de una persona que alguien se está yendo. <font color=ForestGreen><b>vtr.afirm.:</b></font> T-yono
Se tarda	Persona que tarda mucho. <font color=purple>/</font> También se utiliza para referirse cuando tarda mucho tiempo. <font color=ForestGreen><b>vtr.:</b></font> T-yere
Dañino	Persona o animal perjudicial. <font color=ForestGreen><b>adj.:</b></font> T-yuukóra'i
Me hace enojar	Persona que me hace poner molesto. <font color=ForestGreen><b>vtr.:</b></font> T-yuukonu
Que nada	Persona o animal que esta nadando. <font color=ForestGreen><b>vtr.:</b></font> Tyowreko
Sinvergüenza	Persona o animal. <font color=ForestGreen><b>adj.n.:</b></font> Tapikura'i
Hormiga cazadora	Especie de hormiga que presenta su tenaza que es su medio de defensa. <font color=ForestGreen><b>zool.:</b></font> 'Tsaysi
Concha	Tipo de molusco que se encuentra en la orilla de los ríos. Caracoles. <font color=ForestGreen><b>zool.:</b></font> Tsuype
Se enojó	Persona, animal que presenta una actitud de enojo y de agresividad. <font color=ForestGreen><b>vtr.:</b></font> T-semo
Pez Dorado	Alimento cocido a fuego lento. <font color=ForestGreen><b>zool.:</b></font> Tit-yara
Abizcochado	Alimento cocido al horno. <font color=ForestGreen><b>adj.:</b></font> Tñoro
¡Botémoslo!	Se refiere a la acción de echar o botar a una persona, animal o cosa por alguna circunstancia. <font color=ForestGreen><b>vtr.imper.:</b></font> Vewtsuka
¿Dónde pescaremos?	Pregunta del lugar donde se va pescar. <font color=purple>/</font> También se refiere al lugar donde se va dar de comer. <font color=ForestGreen><b>prep.interrog.:</b></font> Vensi'yore
¡Ahóguemoslo!	Persona que incita a ahogar a otra persona. <font color=ForestGreen><b>vtr.imper.:</b></font> Vkeegia
Estamos enlazando	<font color=ForestGreen><b>vtr.:</b></font> Veesareko
¡Murámosnos!	<font color=ForestGreen><b>vintr.prnl.imper.:</b></font> Vépena
¡No importa si morimos!	<font color=ForestGreen><b>adv.neg.imper.:</b></font> Vepenaríne
¡Chaqueemos!	<font color=ForestGreen><b>vtr.pl.imper.:</b></font> Veutaregia
¡Sembremos!	<font color=ForestGreen><b>vtr.imper.:</b></font> Veuka
Nuestro trabajo	<font color=ForestGreen><b>adj.poses.pl.:</b></font> Vemtone
Nuestra carnaza	<font color=ForestGreen><b>adj.poses.pl.:</b></font> Venriji
Nuestra vara o caña de pescar	<font color=ForestGreen><b>adj.poses.pl.:</b></font> Venrigi
¡Degollémoslo!, ¡Cortémosle el cuello!	 <font color=purple>Ej.</font> Cuando carnean un animal. <font color=ForestGreen><b>vtr.imper.pl.:</b></font> Vestinka
Oveja, cordero	<font color=ForestGreen><b>zool.:</b></font> 'Vesa
Lo tumbamos	Tumbar a una persona, árbol o cosa por un empujón. <font color=ForestGreen><b>vtr.afirm.pl.:</b></font> Vesorijko
¡Champémoslo!	Acción de champar a alguien o algo al agua. <font color=ForestGreen><b>vtr.imper.pl.:</b></font> Veutsegia
Batidor/jometoto	Utensilio de la cocina que se usa para batir alimento, bebida. <font color=ForestGreen><b>n.m.:</b></font> Veuriipe
¡Invitémosle!	Dar de comer o dar un regalo a alguien. <font color=ForestGreen><b>vtr.imper.pl.:</b></font> Venrigia
Lo terminamos	<font color=ForestGreen><b>vtr.pl.afirm.:</b></font> Vito
¡Terminémoslo!	<font color=ForestGreen><b>vtr.pl.imper.:</b></font> Vita
Lobo silvestre	<font color=ForestGreen><b>zool.:</b></font> Vita
Murciélago	<font color=ForestGreen><b>zool.:</b></font> Vite
Vivos	Que sigamos con vida. <font color=ForestGreen><b>adj.:</b></font> Vitorigia
¡Vámonos!	<font color=ForestGreen><b>vtr.imper.:</b></font> Vyampo
Nuestra juventud	<font color=ForestGreen><b>adj.poses.:</b></font> Vyampeewo
¡Durmamos!	<font color=ForestGreen><b>vtr.imper.pl.:</b></font> Vimka
Lo hemos llamado	<font color=ForestGreen><b>vtr.afirm.pl.:</b></font> Vich'oo'i
¡Ya lo vimos!	<font color=ForestGreen><b>vtr.imper.:</b></font> Vim'oripo
¡Ayudémoslo!	<font color=ForestGreen><b>vtr.imper.pl.:</b></font> Vimkataka
Los vimos a ustedes	<font color=ForestGreen><b>vtr.afirm.pl.:</b></font> Vim'o'e
¡Atrasémoslo!	Persona que retrasa a alguien en una actividad. <font color=ForestGreen><b>vtr.imper.pl.:</b></font> Vemtoka
Nuestro padrasto	<font color=ForestGreen><b>adj.poses.:</b></font> Viyara'o
Difuntos	Personas fallecidas. <font color=ForestGreen><b>adj.:</b></font> Viyanini
Nuestro padre terrenal / Dios	<font color=ForestGreen><b>adj.poses.:</b></font> Viya
Santo, Dios Padre	<font color=ForestGreen><b>adj.:</b></font> Viyachicha
Está de viaje	<font color=ForestGreen><b>vtr.:</b></font> Vyajeru
¡Traguémoslo!	<font color=ForestGreen><b>vtr.imper.pl.:</b></font> Vjiigia
Estamos carpiendo	<font color=ForestGreen><b>vtr.pl.afirm.:</b></font> Viso'o
Grillo	Insecto pequeño invertebrado. <font color=ForestGreen><b>zool.:</b></font> Vichi
Nos iremos no más	<font color=ForestGreen><b>vtr.imper.pl.:</b></font> Vyanarine
Nuestro anillo	<font color=ForestGreen><b>adj.poses.:</b></font> Vtig're
Nuestro cuaderno	<font color=ForestGreen><b>adj.poses.:</b></font> Vyajumeru
¡Escribamos!	<font color=ForestGreen><b>vtr.imper.pl.:</b></font> Vyajrigia
¡Vamos!	<font color=ForestGreen><b>vtr.imper.pl.:</b></font> Vyana
Nuestro camino	<font color=ForestGreen><b>adj.poses.:</b></font> Vyochereku
Ya nos iremos	<font color=ForestGreen><b>vtr.afirm.pl.:</b></font> Vyongienepo
Estábamos enfermo, pero nos fuimos	<font color=ForestGreen><b>vtr.afirm.pl.cond.:</b></font> Vyowrorokwo
Nuestro territorio o espacio territorial	<font color=ForestGreen><b>deter.poses.:</b></font> Vyooperu
Nuestra chapapa	Objeto hecho de madera rustica que sirve para guardar cosa, fruta, etc. <font color=ForestGreen><b>deter.poses.:</b></font> Vyommeru
Nos queda bonito	<font color=ForestGreen><b>adj.:</b></font> Vyuupo'o
Jugamos	<font color=ForestGreen><b>vtr.afirm.pl.:</b></font> Vyutsaru
Somos de alta estatura	<font color=ForestGreen><b>adj.pl.:</b></font> Vyuna
Lo guardamos	<font color=ForestGreen><b>vtr.afirm.pl.:</b></font> Vyunako
Granizo	<font color=ForestGreen><b>n.m.:</b></font> 'Veregie
Bandera	<font color=ForestGreen><b>n.f.:</b></font> Wanera
Vaca	<font color=ForestGreen><b>zool.:</b></font> Waka
Banco	Asiento que sirve para sentarse. <font color=ForestGreen><b>n.m.:</b></font> Wanku
No importa que nos cansemos	<font color=ForestGreen><b>adv.:</b></font> Wawtarine
¡Reunámonos!	<font color=ForestGreen><b>vtr.imper.pl.:</b></font> Waamutu
Carne	 Carne de cualquier animal. <font color=ForestGreen><b>n.f.:</b></font> Wákaji
¡Conozcamos!	Acción de conocer un lugar o alguien <font color=ForestGreen><b>vtr.imper.pl.:</b></font> Wemoti
Hombre	Acción de conocer un lugar o alguien <font color=ForestGreen><b>adj.:</b></font> Wakachkaka
¡Trabajemos!	<font color=ForestGreen><b>vtr.imper.pl.:</b></font> Wakemtone
¡Cansémonos!	<font color=ForestGreen><b>vtr.imper.pl.:</b></font> Wawta
Japutamo	Insecto muy pequeño que se sujetan en la piel causando picazón. <font color=ForestGreen><b>zool.:</b></font> Wajeru
Azucaró	Árbol que crece en la pampa, selva y ríos. <font color=ForestGreen><b>bot.:</b></font> Wajéma
Hueso con un poco de carne	<font color=ForestGreen><b>anat.:</b></font> Wákagi
Cara de vaca	Máscara de la danza del torito. <font color=ForestGreen><b>adj.:</b></font> Wakamiro
Huérfano	Persona que queda sin padres. <font color=ForestGreen><b>adj.:</b></font> Wacha
Persona despectiva o lenta	<font color=ForestGreen><b>adj.:</b></font> Wama'i
Pampa	Espacio extenso de palmeras, curichis y bajios. <font color=ForestGreen><b>n.f.:</b></font> Wom'i
No le queda o no le pinta	<font color=ForestGreen><b>adv.:</b></font> Wotoopo'o
Música, charla, discurso desagradable	<font color=ForestGreen><b>n.f.adj.:</b></font> wotoopi
Feo	<font color=ForestGreen><b>adj.:</b></font> wotoonanaji
No es largo Referido a bolsa	<font color=ForestGreen><b>adj.neg.:</b></font> woto'e
No lo ha visto	<font color=ForestGreen><b>adv.neg.:</b></font> wotem'a
No lo quiere dejar, soltar	Referido a un animal. <font color=ForestGreen><b>adv.neg.:</b></font> wotenajigia
Sur	Frío helada en tiempos de invierno. <font color=purple>/</font> Punto cardinal. <font color=ForestGreen><b>adj.n.:</b></font> Wono
Sur con agua	<font color=ForestGreen><b>n.m.:</b></font> Wonogiere
No	Negación. <font color=ForestGreen><b>adv.neg.:</b></font> Wo'i
Boga	Pez de agua dulce. <font color=ForestGreen><b>zool.:</b></font> 'Wogi
¡Hay por dios!	Expresión de rechazo o escándalo por alguna acción que realiza una persona. <font color=ForestGreen><b>interj.:</b></font> Wijcha
Bravo	Expresión de enojo por alguna molestia. <font color=ForestGreen><b>adj.:</b></font> Winaráji
Todavía	<font color=ForestGreen><b>adv.t.:</b></font> Wich'o
¡Ya no!	<font color=ForestGreen><b>adv.interj.:</b></font> Wipo'eto
Tiempo de sur	<font color=ForestGreen><b>n.f.:</b></font> Wonomu'i
Cascabel	Serpiente venenosa. <font color=ForestGreen><b>zool.:</b></font> Wregie
Tábano Insecto muy pequeño	<font color=ForestGreen><b>zool.:</b></font> Wáyosi
Limosna	Ofrenda económica en ritual religioso. <font color=ForestGreen><b>n.f.:</b></font> Wórare
Gallina	Ave de corral. <font color=ForestGreen><b>zool.:</b></font> Wrayu
Huevo	Huevo de aves y de reptiles. <font color=ForestGreen><b>n.m.:</b></font> Wray'a
Ya sos huérfano	<font color=ForestGreen><b>adj.:</b></font> Wachavipo
Bolivia	Nombre del Estado Plurinacional de Bolivia. <font color=ForestGreen><b>n.:</b></font> Worivya
No quiero	<font color=ForestGreen><b>adv.neg.:</b></font> Wonawro'o
Loro	De la familia de los pericos que es de cola corta o chuta. <font color=ForestGreen><b>zool.:</b></font> Woru
Mauri	Ave silvestre de color negro. <font color=ForestGreen><b>zool.:</b></font> Worikusri
Lo hubiéramos encontrado	<font color=ForestGreen><b>vtr.afirm.cond.:</b></font> Waatoo'ini
Asno, burro Animal de carga	<font color=ForestGreen><b>zool.:</b></font> Wariku
Ciudad	<font color=ForestGreen><b>n.:</b></font> 'Wósare
Buey	Animal que sirve para jalar el carretón. <font color=ForestGreen><b>zool.:</b></font> Wiye
¡Nunca más!	<font color=ForestGreen><b>adv.neg.interj.:</b></font> Winepo
¡Compartamos!	<font color=ForestGreen><b>vtr.imper.pl.:</b></font> Wakajkoko
Carne molida	<font color=ForestGreen><b>adj.n.f.:</b></font> Wákapa
Carne de res	<font color=ForestGreen><b>n.f.:</b></font> Wakaeche
¡Estudiemos!	<font color=ForestGreen><b>vtr.imper.pl.:</b></font> Wakarawo'u
Dar una porción de lo que tiene	Compartir. <font color=ForestGreen><b>vtr.:</b></font> Wakaji
Carne de res o de otro animal	<font color=ForestGreen><b>n.f.:</b></font> Wakaji
Estamos trabajando	<font color=ForestGreen><b>vtr.afirm.ger.pl.:</b></font> Wkemtone
Somos iguales	Igualdad. <font color=ForestGreen><b>n.f.:</b></font> Wkutirichu
¡Tengamos!	<font color=ForestGreen><b>vtr.imper.pl.:</b></font> Wakye'e
¡Hamaquemonos!	<font color=ForestGreen><b>vtr.imper.pl.:</b></font> Wákachu
Lado derecho	<font color=ForestGreen><b>adv.l.:</b></font> Wowre
¡Ven o vení!	<font color=ForestGreen><b>vtr.imper.:</b></font> Yare
Nuestra casa	<font color=ForestGreen><b>adj.poses.:</b></font> Iypeno
Nuestro guía	Guía para llegar a un lugar o método para hacer música. <font color=ForestGreen><b>adj.poses.:</b></font> Iyponogieru
¡Sigámoslo!	<font color=ForestGreen><b>vtr.imper.pl.:</b></font> Iypona
Por ese lugar vamos	<font color=ForestGreen><b>deter.pron.dem.:</b></font> Iypopuegia
Seguirlo o repetir lo que realiza	<font color=ForestGreen><b>vtr.imper.:</b></font> Iyponora'i
¡Traguémoslo!	<font color=ForestGreen><b>vtr.imper.pl.:</b></font> Iyjiigia <font color=purple>/</font> vjiigia
Nuestro lunar	<font color=ForestGreen><b>adj.poses.:</b></font> Iypochowo
Hacha	Que sirve para cortar palo <font color=ForestGreen><b>n.f.:</b></font> Iywoti
Ya queremos	<font color=ForestGreen><b>vtr.afirm.:</b></font> Iywoo'oripo
Nuestra Muñeca	Parte del cuerpo humano. <font color=ForestGreen><b>anat.:</b></font> Iywo'u
Manetacu	Manija para moler alimento en el tacú. <font color=ForestGreen><b>n.f.:</b></font> Iywáragi
Charque molido	<font color=ForestGreen><b>adj.:</b></font> Iywapa
Nuestro pago	<font color=ForestGreen><b>adj.poses.:</b></font> Iywacho
¡Compremos!!	<font color=ForestGreen><b>vtr.imper.pl.:</b></font> Iywachrigia
Nuestro buey	<font color=ForestGreen><b>adj.poses.:</b></font> Iywiyera
Nuestro tobillo	<font color=ForestGreen><b>adj.dem.:</b></font> Iypigi
Nuestra rodilla	<font color=ForestGreen><b>adj.dem.:</b></font> Iypúyusi
Nuestro cachete 	<font color=ForestGreen><b>adj.dem.:</b></font> Iypuku
Nuestro muslo	<font color=ForestGreen><b>adj.dem.:</b></font> Iypa'e
¡Qué pasó!	Problema o suceso inadvertido. <font color=ForestGreen><b>interj.:</b></font> Yátupi
De malas ganas / convaleciente	Persona que se está recuperando de una enfermedad. <font color=ForestGreen><b>adj.:</b></font> Yatpipijina
Yeso	Material de construcción. <font color=ForestGreen><b>n.m.:</b></font> Yesu
Yegua	<font color=ForestGreen><b>zool.:</b></font> Yewa
Surubí	Pez de agua dulce. <font color=ForestGreen><b>zool.:</b></font> Yona
Jochi pintado	Animal que habita en la selva amazónica. <font color=ForestGreen><b>zool.:</b></font> Yopo
Noche	<font color=ForestGreen><b>n.f.:</b></font> Yoti
¡Buenas noches!	Expresión de saludo. <font color=ForestGreen><b>interj.:</b></font> Yotyoopo
Lechuza	Ave nocturna <font color=ForestGreen><b>zool.:</b></font> Yusa
Cántaro	 Recipiente elaborado de barro cocido. <font color=ForestGreen><b>n.f.:</b></font> Yupi
Autoridad	Alcalde. <font color=ForestGreen><b>n.m.:</b></font> Aakare
¿Qué?	<font color=ForestGreen><b>adj.pronom.:</b></font> Taa
¿Quién?	<font color=ForestGreen><b>pron.interrog.:</b></font> Naa
marzo	Tercer mes del año. <font color=ForestGreen><b>n.m.:</b></font> Maaso
Palta	Fruta del árbol del palto. <font color=ForestGreen><b>bot.:</b></font> Paata
Carmen	 Nombre femenino. <font color=ForestGreen><b>n.f.:</b></font> Kaame
Parque	 Espacio recreativo <font color=ForestGreen><b>n.:</b></font> Paake
Bufeo	Delfín de agua dulce. <font color=ForestGreen><b>zool.:</b></font> Aeko
Lo mezquina	<font color=ForestGreen><b>vtr.:</b></font> Taeima
Su macho	<font color=ForestGreen><b>adj.dem.:</b></font> Taema
Detrás	<font color=ForestGreen><b>adv.l.:</b></font> Taegne
vocal compleja	<font color=ForestGreen><b>n.f.:</b></font> Aee
Discoteca	<font color=ForestGreen><b>n.f.:</b></font> Naeemuisrare
Se hundió su cabeza	<font color=ForestGreen><b>vtr.prnl.:</b></font> Taeemusko
Vocal compleja	<font color=ForestGreen><b>n.f.:</b></font> Aei
Se maduró	Afirmación de una persona a otra de que su plátano o guineo ya maduró. <font color=ForestGreen><b>vintr.afirm.:</b></font> Naeikane
Eleuterio	Nombre masculino. <font color=ForestGreen><b>n.m.:</b></font> Eeterio
Enlazar	<font color=ForestGreen><b>vtr.:</b></font> Eesapuegia
viernes	Quinto día de la semana. <font color=ForestGreen><b>n.:</b></font> Vyeenési
Ternero(a)	<font color=ForestGreen><b>zool.:</b></font> Teenera
Anzuelo	<font color=ForestGreen><b>n.m.:</b></font> 'Niive
Liñada	<font color=ForestGreen><b>n.f.:</b></font> 'Niipi
Gallo	<font color=ForestGreen><b>zool.:</b></font> 'Jii'i
Baila	<font color=ForestGreen><b>vtr.afirm.:</b></font> Tiimuiko
¿Dónde?	<font color=ForestGreen><b>adv.interrog.:</b></font> Ooyo
¡Alégrense!	<font color=ForestGreen><b>vtr.imper.pl.:</b></font> Oosamre
¿De dónde vienes?	<font color=ForestGreen><b>adv.interrog.:</b></font> Oopyos'o
¡Ojalá que sirva!	<font color=ForestGreen><b>interj.:</b></font> Toonaa'ini
¡Andá traele!	<font color=ForestGreen><b>vtr.imper.:</b></font> Jvejninapo
¡Traé!	Orden de que vaya a traer algo. <font color=ForestGreen><b>vtr.imper.:</b></font> Jvejna
¿Lo has traído?	<font color=ForestGreen><b>vtr.interrog.:</b></font> Jvejno
¿Ya lo trajiste?	<font color=ForestGreen><b>vtr.interrog.:</b></font> Jvejnoripo
Después lo trae	<font color=ForestGreen><b>adv.t.:</b></font> Jvejnarine
¡Córtalo!	<font color=ForestGreen><b>vtr.imper.:</b></font> Jvestirigia
Desamarrar hamaca, mosquitero	<font color=ForestGreen><b>vtr.afirm.:</b></font> Jvejchaka
¡Encógelo!	<font color=ForestGreen><b>vtr.imper.:</b></font> Jvechaka
¡Descascáralo!	<font color=ForestGreen><b>vtr.afirm.imper.:</b></font> Jvejchok'a
Violar	Abusar sexualmente de una persona en contra de su voluntad. <font color=ForestGreen><b>vtr.:</b></font> Jooreko
Árbol de ajo	<font color=ForestGreen><b>bot.:</b></font> Choogi
Mediano	<font color=ForestGreen><b>adj.:</b></font> Toonera
Tornillo	<font color=ForestGreen><b>n.m.:</b></font> Tooniyu
¿Ya regresaste?	<font color=ForestGreen><b>vtr.interrog.:</b></font> Pchoopo
Ya regresé	<font color=ForestGreen><b>vtr.afirm.:</b></font> Nchoopo
Espumea	<font color=ForestGreen><b>adj.:</b></font> Tkoososo
Espumeador	<font color=ForestGreen><b>n.m.:</b></font> Tkoososoro'o
Remo	Instrumento de remar. <font color=ForestGreen><b>n.m.:</b></font> Noope
Rana	Anfibio. <font color=ForestGreen><b>zool.:</b></font> Uupe
Acariciar	<font color=ForestGreen><b>vtr.:</b></font> Uututita
Está limpio, bonito	<font color=ForestGreen><b>adj.:</b></font> Tyuuna
División	División de casa o habitación. <font color=ForestGreen><b>n.f.:</b></font> Tayuchororoju'e
División	Compartirse en parte iguales. <font color=ForestGreen><b>n.f.:</b></font> Tasorawko
Estoy bien	<font color=ForestGreen><b>adj.afirm.:</b></font> Nuurichu
Al momento	<font color=ForestGreen><b>adv.t.:</b></font> 'Nuujipo
Cacare	Ave de color negro, come guayaba <font color=ForestGreen><b>zool.:</b></font> Giapo
Fiebre	Aumento de la temperatura del cuerpo por encima de la normal. <font color=ForestGreen><b>n.f.:</b></font> Giewre
Mono	Animal silvestre que huele a ajo. <font color=ForestGreen><b>zool.:</b></font> Gievi
Mara	Tipo de Árbol. <font color=ForestGreen><b>bot.:</b></font> Gíjogi
Turo	Molusco de color negro. <font color=ForestGreen><b>zool.:</b></font> Giyo
Víbora	Reptil venenoso. <font color=ForestGreen><b>zool.:</b></font> Giore
Gusano o lombriz	<font color=ForestGreen><b>zool.:</b></font> Giorepi
Chuño de plátano	<font color=ForestGreen><b>bot.:</b></font> Giajo
Queso	<font color=ForestGreen><b>n.m.:</b></font> Giesu
Jengibre	<font color=ForestGreen><b>bot.:</b></font> Giwre
Trabajo	<font color=ForestGreen><b>n.m.:</b></font> 'Motnaeko
Vasija de tutuma	<font color=ForestGreen><b>n.f.:</b></font> 'Repo
Raya	Pez raya. <font color=ForestGreen><b>zool.:</b></font> 'Jinomo
Benton	Pez de agua dulce. <font color=ForestGreen><b>zool.:</b></font> 'Nere
Tachacá	Pez de agua dulce <font color=ForestGreen><b>zool.:</b></font> Táchaka
Adulto	<font color=ForestGreen><b>adj.n.m.f.:</b></font> 'Chónaru
Sal	<font color=ForestGreen><b>n.f.:</b></font> 'Cheve
Oso bandera	<font color=ForestGreen><b>zool.:</b></font> 'Tikre
Patito pequeño	<font color=ForestGreen><b>zool.:</b></font> 'Pojgira
Arriba	<font color=ForestGreen><b>adv.l.:</b></font> 'Nug'e
Terreno	Planeta tierra. <font color=ForestGreen><b>n.m.:</b></font> 'Pog'e
Hombre	Persona de sexo masculino. <font color=ForestGreen><b>n.m.:</b></font> 'Jiro
Recién parida	Persona que ha dado a luz. <font color=ForestGreen><b>adj.:</b></font> 'Renako
Novedoso, algo nuevo	<font color=ForestGreen><b>pron.indef.:</b></font> 'Renako
