a	mew, mu; pvle.
abajo	naq; pvlom.
abandonar	mvñalvn.
abatir	afelzuamvn.
abeja	ziwjiñ.
abertura	(entrada) wvbgiñ, vbgiñ; (en el techo para que salga el humo) wiyoyoruka.
abierto	nvlaley; (los ojos) lelilen; (las piernas) wiralen.
abogar	zuguñman, zvguñman, zuguñpen, zvguñpen.
aborrecer	vzen.
abortar	juzkvn.
abrazar	rofvlvn, pagkon.
abrazo	pagko.
abreviar	picikvnun.
abrigarse	(del viento) makuñtun; (de la lluvia) cejkomtun, cvjkumtukun.
abrigo	nvkvmtuwe.
abrir	nvlan.
abrirse	wegan.
abuela	(paterna) kuku; (materna) cucu.
abuelo	(paterno) baku; (materno) cezki, cece.
abundar	fenxelen, abvlen, pvxvlen.
aburrirse	afeluwvn; coñiwvn.
abusar	yomzuamvn.
acá	tvfa, faw; fapvle; <font color="blue"><i><b>*pasar hacia a.</b></i></font> rupan; <font color="blue"><i><b>*por a.</b></i></font> fapvle, tvfa pvle, faw pvle.
acabar	zewvn, afvn.
acariciar	jawmatun.
acarrear	wiñamvn.
acechar	joftun, elman.
aceite	yiwiñko.
aceptar	jowvn, pin.
acequia	wif.
acercar	fvlvmvn.
acercarse	fvlvn.
acertar	kvjvn, relvn, tuten.
ácido	muxag; koxv; (agrio) mukaz.
aclararse	liftun; (el cielo) liftun wenu.
acogotar	gvxvn.
acometer	lefkontun.
acomodarse	feyvmvn.
acompañar	(guiar) guyvlvn.
acontecer	femvn.
acordarse	kimniekan, kimtun.
acostarse	kuzun.
acostumbrarse	wimvn.
activo	kvlfvn.
acudir	amun, amuh.
acusar	zajun, zajuntukun.
adaptarse	feyvmvn.
adelante	puñma.
adentro	ponwi, koneltu; (de la casa) puruka; <font color="blue"><i><b>*muy a.</b></i></font><b> </b>abvkon; <font color="blue"><i><b>*del lado de a.</b></i></font><b> </b>ponwitu.
adherirse	pvhan.
adivinanza	konew.
adivinar	mupin, pelontun.
admirable	afmatufal.
admirar	afmatun.
admirarse	afmatun.
admitir	jowvn.
adornar	ayfiñvn.
adquirir	nvn, nvh; pen, petun.
adulterar	kakvnun.
adulto	xem, xemce.
adversario	kon.
advertir	(notar) pewvtun, juwan.
afecto	poyen.
afeitar	payuntun.
afeitarse	payuntuwvn.
afilado	yuge.
afilar	yugvmvn.
afirmar	feley pin.
afirmarse	rekvl, rekvltun.
afligirse	mvlezuamvn, awvwvn.
aflojar	jocolvn.
aflojarse	jocolvn, jocolvwvn, jocon.
afónico	kafir.
afrecho	cvkvl.
afrentar	yewelkan.
afuera	wekun; <font color="blue"><i><b>*del lado de a.</b></i></font> wekuntu.
agachado	ponor, poxog; <font color="blue"><i><b>*pasar a. por debajo</b></i></font><b> </b>siñumrumen; cvñvlrumen.
agacharse	jowvkvnvwvn, jowvnaqvn.
agarrar	nvn, nvh, tun; ñvmin.
agarrarse	nvwvn.
ágil	kvlfvn; (ser) yewmen.
agradar	tuten.
agradecer	mañumvn.
agraviar	jazkvlvn.
agregado	yom.
agregar	yompeñ.
agridulce	mukur.
agrio	koxv; (ácido) mukaz.
agua	ko; (caliente) kufvh; (que se quedo sin agua) arken; <font color="blue"><i><b>*beber a.</b></i></font> pvtokon.
aguacero	fvxa mawvh.
aguardar	vgvmvn.
agudo	yuge.
águila	<font color="blue"><i><b>*a. leonada</b></i></font> kalkiñ; <font color="blue"><i><b>*a. mora</b></i></font> pewko.
aguilucho	ñamku.
aguja	(de colihue) zvpijwe.
agujerear	katan; wecozvn; (abrir) wegan.
ahí	tvfey mew; <font color="blue"><i><b>*por a.</b></i></font> fey pvle.
ahogar	(apretando el cuello) gvxvn.
ahogarse	(asfixiarse) xvfvn; (en el agua) vrfin.
ahora	fewla; (en un breve momento) azo.
ahuyentar	wemvn.
ají	xapi; (machacado) xahanxapi; (molido con sal) xapicazi.
ajo	aku.
ala	mvpv.
alabar	sakin.
alba	wvh.
alborotarse	(el caballo) vñan.
alcanzar	puwvn; (algo elevado) zin, zitun; (aquí a tiempo) xenpan; (allá a tiempo) xenpun.
alegrar	ayvwvlvn.
alegrarse	ayvmvn, ayvwvn.
alegre	ayvw; <font color="blue"><i><b>*estar a.</b></i></font> ayelen.
alegremente	ayvwvnkeci.
aletear	mvpvmvn.
alfarería	wizvn.
alfarero	wizvfe.
alforja	kutama.
algas	(cochayuyo) kojof; (luhua) buwa.
algarabía	wakeñvn.
aliento	heyeh, heyen.
alimentar	ilelvn.
aljibe	rvgan ko.
alma	pvjv; (del recien muerto) am.
almacigo	jekvm.
alojarse	uman.
alrededor	waj, wajon, waj pvle, wajon mew, wajpa.
alto	(en lo mas alto) wecuñtu.
alumbrar	pelomtun, pelotun.
alzado	(animal) kayta.
alzar	wixapvramvn, wixañpvramvn, wenuntun, wenumpvramvn; (agarrar) nvn, nvh.
alzarse	(rebelarse) awkan.
allá	tvyiw, vyiw, vyew, iyew; <font color="blue"><i><b>*pasar hacia a.</b></i></font> rumen; <font color="blue"><i><b>*por a.</b></i></font> iyew pvle, vyew pvle.
allí	tvye mew, vye mew; <font color="blue"><i><b>*hacia a.</b></i></font> tvye pvle; fey pvle.
amanecer	(al alba) wvh, wvhvn; <font color="blue"><i><b>*casi al a.</b></i></font> epe wvh.
amansar	ñomvmvn.
amante	vñam, qvñam.
amar	ayvn, poyen.
amargamente	jazkvnkeci.
amargarse	jazkvn
amargo	fvre.
amarillo	coz; (ocre) palaw.
amarrar	xapelvn, xarin.
ambos	caq.
amenazar	añelvn, ahelvn, aheltun.
amigo/a	wehvy, weni; (vocativo) ahay.
amor	ayvn.
amorosamente	ayvnkeci.
ancas	agka; <font color="blue"><i><b>*llevar en a.</b></i></font> agkazvn.
ancho	fvxarupa.
ancestros	kuyfikece.
anciana	kuse.
anciano	fvca.
andar	miawvn; (caminar) xekan; (ir) amun, amuh; (a gatas) winolvn; (a los saltos) rvgkvyawvn; <font color="blue"><i><b>*a. enfermo </b></i></font>kuxankvyawvn; <font color="blue"><i><b>*¿como andas?</b></i></font> ¿cum miawimi.
angosto	gvxaf, picirupa.
anillo	yvwvbkuwv.
animal	kujiñ.
animar	yafvlvn.
animarse	yafvlvwvn.
ano	gekvciw, liwe.
anoche	xafia.
anochecer	puhvn.
anteayer	epuwe mom.
antes	wema.
antiguamente	kuyfi.
antorcha	kvze.
anudar	pvron.
anzuelo	cikv; kvbi.
añadir	yompeñ.
año	xipantu; (de clima templado) zomo xipantu; (de clima frío) alka xipantu; <font color="blue"><i><b>*el a. pasado</b></i></font> kamel;
apacentar	vtalvn, tvgvmvn.
apagarse	cogvn.
apalear	mvxogvn.
aparecer	wefvn; <font color="blue"><i><b>*hacer a.</b></i></font> wepvmvn.
apartar	jaynakvmvn; (la vista) kakintun.
apartarse	pvntvn, pvbtvn, wicun, wvzan.
aparte	(de a uno) kisuke; (en grupo) wicuke.
apellido	kvpalme.
apenas	geju, eja.
apéndice	cvmpun.
apetecer	ijun.
apisonar	gvriñvn.
aplacar	gvfen.
aplastado	capvz.
aplastar	xañman.
aplastarse	(entre dos objetos) mvbafman.
apostar	ranvn.
apreciar	poyen.
apremiar	reyen.
aprender	kimvn, logkontukun; azvmvn.
apretado	gvriley.
apretar	fvyvm, fvyvmvn.
aprisa	matu.
aprovechar	gvnaytun.
aproximarse	fvlvn.
apuñalar	cvgarvn.
apurado	matukawvn.
apuro	(tener) matukawvn; <font color="blue"><i><b>*en apuros</b></i></font> fijmawvn.
aquel/lla	tvye; tvyeci.
aquél/lla	tvyeci.
aquello	tvyeci.
aquí	faw, tvfa mew, tamu.
araña	lalvg; (venenosa) paju.
arañar	kawpvn, kawlitun.
arar	kexan; <font color="blue"><i><b>*terreno para a.</b></i></font> kexawe.
araucaria	pewen, peweh.
árbol	aliwen.
arboleda	aliwentu.
arbusto	rvxon.
arco	<font color="blue"><i><b>*a. iris</b></i></font> relmu.
arder	lvfvn, vyvn.
arena	kuyvm.
arma	(de fuego) xalka.
armadillo	kofvr; (pichi) kvmxv.
armar	(juntar) xvrvmvn
aro	caway.
arrancar	(de raíz) gezun, wegkolvn; (la piel) solkin.
arrastrar	wigvzvn.
arrastrarse	cvñvlrumen.
arrayán	kojvmamvj.
arrear	kecan.
arrebatar	mvntun.
arreglado	(verse bien) azvn; <font color="blue"><i><b>*dejar a.</b></i></font> azkvnun.
arrepentirse	wiñozuamvn, kazuamtun, kazuamvn.
arriba	wenu; (cima) wecuñ.
arribar	akun.
arrimar	inafvlvn.
arrodillarse	lukutun.
arrojar	vxvfvn; (dentro) vxvfkonvn; (desparramar) pacvqvn.
arruga	zoñv.
arruinarse	wesacewvn.
arveja	ajfiz.
asado	kagkan.
asador	(aparato) kagkawe.
asar	kagkan; (papas) kuwen.
asco	(tener nauseas) vbgun, vhun.
ascuas	ayben.
asfixiarse	xvfvn.
así	femgeci; (estar) felen; (ser) femgen; <font color="blue"><i><b>*a. es</b></i></font> feley; <font color="blue"><i><b>*no es a.</b></i></font> felelay.
asiento	anvtuwe, wagku.
aspecto	az; <font color="blue"><i><b>*tener buen a.</b></i></font> kvme azgen.
áspero	cvmeñ.
asqueroso	vkvypuwe.
astilla	(pequeñas) zvmijko; (leña) iran.
astucia	(engaño) gvnen; <font color="blue"><i><b>*hacer maldad con a.</b></i></font> azkan.
asunto	zugu, zvgu.
asustarse	xupefvn, cijfun, xepewvn, pejken.
atado	kvxvg.
atajar	kaxvtun; (mutuamente) xogkvn.
atalaya	azkintuwe.
ataque	malon.
atar	xarin.
atardecer	naq antv.
ataúd	wampo.
atender	(escuchar) ajkvtun.
atinar	tutekvnun.
atormentarse	kuxankawvn.
atrás	furi; furitu; (desde/hacia atrás) furi pvle; <font color="blue"><i><b>*dejar a.</b></i></font> jaynakvmvn; <font color="blue"><i><b>*muchos días a.</b></i></font> fvxa cumvl.
atravesado	kakvl.
atravesar	hon; (hacia este lado) hopan.
atreverse	yafvlvwvn; <font color="blue"><i><b>*no a.</b></i></font> yofvn.
axila	puñpuya.
aun	petu, metu.
autonomía	kisu gvnewvn.
ave	vñvm.
avellana/o	gefvñ.
avenida	(crecida de un río) magiñ.
aventar	piculvn.
avergonzar	yewelkan.
avergonzarse	yewen.
averiguar	gvneytun, gvnezuamvn; (preguntando) inaramtun.
avisar	kimelvn.
aviso	<font color="blue"><i><b>*estar sobre a.</b></i></font> pewvtulen.
avutarda	<font color="blue"><i><b>*a. blanca</b></i></font> patakan; <font color="blue"><i><b>*a. roja</b></i></font> kawken.
ayer	wiya, wvya.
ayuda	(pedir) igkatu;(conseguir) wican.
ayudante	keju.
ayudar	kejun; (en pelea o juego) igkan.
azadón	<font color="blue"><i><b>*cavar con a.</b></i></font> kaypvn.
azotar	wiman.
azúcar	kocvlwe.
azul	kajfv; <font color="blue"><i><b>*a. marino</b></i></font> kurvkajfv.
baba	vhwi.
bailar	purun, faylan.
bailarín	purufe.
bajar	naqvn, naqvmvn, nakvm.
bajo	(altura) picipvra.
balai	jepv.
balde	<font color="blue"><i><b>*en b.</b></i></font> (en vano) gvnam; (sin pago) refalta.
ballena	yenv.
banco	wagku.
bandera	wenufoye.
bandurria	rakiñ, xuxek.
bañarse	mvñetun.
barba	payuh, payun.
barbechar	kexan.
barbilla	kexe.
barranco	lil.
barrer	lepvn.
barriga	pvxa; <font color="blue"><i><b>*estar de b.</b></i></font> lvpvlen.
barro	pebe, foxa.
bastante	abvn, abv.
bastón	rexv.
beber	pvtun; (agua) pvtokon.
besar	xuyun.
bicicleta	xogli kawej.
bien	kvme; <font color="blue"><i><b>*estar b.</b></i></font> kvmelen; (de salud) xemolen; <font color="blue"><i><b>*verse b.</b></i></font> azvn; <font color="blue"><i><b>*andar b.</b></i></font> kvmeyawvn; <font color="blue"><i><b>*está b.</b></i></font> (así es) feley, fey.
bigote	payuh, payun.
biodiversidad	ixofijmogen.
biombo	kaxvntukuwe.
bisnietos	yom.
blanco	(brillante, traslucido) liq, lvq; (mate) pvlag, fvlag; <font color="blue"><i><b>*hombre b.</b></i></font> wigka.
blando	gvfar, pañus.
boca	wvh; <font color="blue"><i><b>*b. del estomago</b></i></font> logko pvxa.
bofe	pohoh; (relleno de sangre condimentada) apol.
bola	(de chueca) pali.
boldo	fobo.
boleadoras	bvkay.
bolsa	(de cuero) yapaw; (alforja) kutama; (de ubre de vaca) xonxon.
bonito	(ser) kvme azgen; <font color="blue"><i><b>*verse b.</b></i></font> azvn.
boquilla	vfvrwe.
borde	vpvl.
bordó	(color) kurvkelv.
borracho	gojiñ.
bosque	mawiza.
bostezar	vgapuwvn.
bote	fote.
bramar	waqlvn.
brasa	ayben.
brazo	lipag; <font color="blue"><i><b>*tomar en brazos</b></i></font> metan.
brillante	jvmjvm
brillar	buyvfvn.
brindar	jaqpan.
brindemos	jaqpayu.
brindis	jaqpan.
bromear	ayekan.
bronce	pasigka.
brotar	jeqvn.
brote	coyvn.
brujería	kalku zugu.
brujo/a	kalku.
buches	(hacer) vbpuwvh.
bueno	kvme; (ser) kvmen; <font color="blue"><i><b>*hallar b.</b></i></font> azentun.
buenos días/tardes	mari mari.
buey	mansun.
búho	nuku.
bulto	yewvn; (carga) cecvm; (ropa) ajwiñ.
burlarse	ayetun.
buscar	kintun; (al tanteo) sumpatun; <font color="blue"><i><b>*ir a b.</b></i></font> yemen; <font color="blue"><i><b>*venir a b.</b></i></font> yepan; <font color="blue"><i><b>*pasar a b.</b></i></font><b> </b>yerpun; <font color="blue"><i><b>*estar buscando</b></i></font> kintunyen.
caballo	kawej, kaweju;<b> </b><font color="blue"><i><b>*c. de paseo</b></i></font><b> </b>magka.
cabecera	mexvl.
caber	feyvn; (corresponder) xafvn.
cabeza	logko.
cabello	xvna.
cabra	kapvra.
cada	fij.
cadera	xuxe.
caer(se)	(persona o animal) xanvn; (perder algo) jagkvn; (cosas verticales) larvn; (de arriba) jagkvnaqvn; (de espaldas) paybaxipan; (de maduro) jagkon; (marchitarse) wancon; (desprenderse y caer) waxonaqvn; <font color="blue"><i><b>*c. de bruces</b></i></font> mvjofvn.
café	(color) kolv.
calabaza	waza.
calandria	xegka, xenka.
calavera	forologko.
caldeado	kofvn.
caldo	korv.
calentar	eñumalvn.
calentarse	aren, eñumtun.
caliente	eñum; (agua) kufvh.
calmar	ñopimvn.
calor	are; (tener) aren.
calzar	feyvmvn.
calzoncillo	carawija.
cama	kawitu.
camarón	zaqju.
cambiar	kakvnun; (trocar) xafkiñtun; (de idea) kazuwamvn, kazuwamtun.
caminar	xekan.
camino	rvpv; <font color="blue"><i><b>*perder el c.</b></i></font> ñuwin.
campo	lelfvn; (despoblado) uwe.
cana	xvren.
canción	vl, vlkantun.
candela	kvze.
canelo	foye.
canilla	(hueso) maxa.
cansado	(estar) vrkvlen, axvrvn.
cansarse	vrkvn.
cantar	vlkan, vlkantun, vlkatun.
cántaro	(jarra) metawe; (tinaja) meñkuwe; (cisterna) meseg.
canto	vlkatun, vlkantun.
cantor	vlkatufe, vlkantufe.
caña	foron.
capaz	(ser) topan.
cara	az; (rostro) age.
características	(de un territorio) azmapu.
carancho	xaru.
carbón	kuyvb, kuyub.
cardo	xolxo.
carga	cecvm.
cargar	cecvmvn, pañvn; (en la espalda) meñkun.
carne	ilo; (desecada) agim.
carpintero	(pájaro) rere.
carta	cijka.
casa	ruka; (muy adentro de la casa) jizruka; (atrás de la casa) furiruka (dentro de la casa) puruka.
cascabel	yvwju, kaskawija; (de calabaza) waza.
cascada	xayen.
caserío	rukantu.
casi	epe.
castigar	nalvn.
cataratas	(en los ojos) xirkan.
catre	kawitu.
catuto	mvlxvn.
cavar	rvgan, kaypvn.
caverna	lolo.
cebada	kaweja.
cebollín	lawv.
cegarse	xexiñvn.
ceja	zvñin, zvñiñ.
celar	(la mujer) mvritun.
celeste	payne.
celular	(teléfono) pici kujkuj.
cementerio	eltun, eltuwe, eluwe.
ceniciento	kazv.
ceniza	xufken.
centro	ragiñ, ragi; (jugador central en la chueca) logkopalife.
cerca	ina, inalmu, pvje, jekv.
cercenar	rvpun.
cerco	malal.
cerdo	zañiw, sañwe.
cerebro	mvjo, rvpawlogko.
cernícalo	jeqjeqkan.
cernidor	ciñvzwe.
cernir	ciñvzvn.
cerrar	nvrvfvn.
cerrazón	xukvr.
cerro	wigkul.
cesar	<font color="blue"><i><b>*sin c.</b></i></font><b> </b>afkentu.
cesta	(de fibra vegetal) kvlko; (para aventar grano) jepv.
ciego	xawma.
cien	pataka.
ciertamente	feley.
cierto	rvf zugu.
ciervo	<font color="blue"><i><b>*c. macho</b></i></font> xuli.
cigarrillo	pvxem.
cima	wecuñ.
cimentarse	foliluwvn.
cinco	kecu.
cintura	xariwtuwe.
cinturón	xariwe.
circular	xvgkvr.
ciruelillo	xewmvn.
cisterna	meseg.
citar	(mencionar) konvmpan.
ciudad	waria, kara.
cizaña	kamca.
claro	pelo, lif.
clavar	xawawtukun, kvlafan.
cobarde	jvkanten.
cobija	vltu.
cobre	kumpañilwe; <font color="blue"><i><b>*sulfato de c.</b></i></font> kajfvbaweh.
cocer	afvmvn; (con agua) majun.
cocerse	afvmvn.
cocinar	afvmvn; (con agua) majun.
cochayuyo	kojof.
codo	xulixuli, coñoy lipag.
coger	(agarrar) nvh, nvn, tun, ñvmin.
coihué	koywe; (fruto) koqvj.
coipo	koypu.
cojo	kvnxo.
cola	kvlen.
colar	caytun.
colgado	(sobre algo) sencu.
colgar	pvlkvn.
colibrí	pinza.
colihue	rvgi, kila.
color	az.
colorado	kelv.
columna	(vertebral) kuziforo.
comandante	toki.
combate	weycan.
combatir	weycan, weycatun.
combatiente	weycafe
comedero	iwe.
comenzar	jitun.
comer	in; (carne) ilotun; (con ansia) vpagvn.
comestible	ipeye.
comezón	(producir) vnan.
comida	iyaqel, iyael; <font color="blue"><i><b>*dar c.</b></i></font> ilelvn.
como	cum; cumgeci, cumueci; (similar) erke, reke; <font color="blue"><i><b>*¿c. estas?</b></i></font> cumleymi; <font color="blue"><i><b>*¿c. andas?</b></i></font> ¿cum miawimi?; <font color="blue"><i><b>*tal c.</b></i></font><b> </b>reke.
compañero/a	kompañ; afkazi.
competir	kuzen; (en una carrera) hotulefvn.
componer	kvme elvn; kvmekvnun.
comprar	gijan; <font color="blue"><i><b>*hacer compras</b></i></font> gijakan.
comprender	kimtukun, gvnekonvn.
comprimir	gvxalvn.
comunicación	<font color="blue"><i><b>*medio de c.</b></i></font> amulzuguwe.
comunidad	lof, lofce.
con	(con otro) egu, (con otros) egvn; mew, mu; konme.
conciente	<font color="blue"><i><b>*estar c.</b></i></font> kimkvlen.
concluir	afvn; (fabricar) zewman.
concubina/o	vñam.
cóndor	mañke.
conejo	mara.
conocedor	kimvnce.
conocer	kimvn; <font color="blue"><i><b>*c. a fondo</b></i></font> azvmvn.
conocimiento	kimvn.
conseguir	aretun; (ayuda) wican.
consejo	gvbam.
consolarse	ñawfvn.
consumir	apvmvn.
contar	rakin; (decir) nvxamyen.
contento	ayvw.
contradecir	caftu zugun, caftun, caqtun, vyaqtun.
contradicción	caftu.
contraer	(una enfermedad) tukuxanvn; (los músculos, piernas) xukvfvn.
contragolpear	caqtun.
controlar	gvnewvn.
conversación	nvxam, gvxam.
conversar	gvxamvn.
convexo	xoxo.
convidar	magelvn.
conyuge	piñom.
coraje	(valor) fvta piwke.
corazón	piwke.
cordero	pici ufisa.
cordillera	mawizantu.
cormorán	yeku.
cornear	repvlvn.
corral	malal.
corralera	xakaya.
correr	lefvn, nekulvn.
cortador	kaxvwe.
cortar	kaxvn; (a golpes) rvpun; (en trozos) kaxvntukun.
cosa	cemkvn; <font color="blue"><i><b>*cualquier c.</b></i></font> cem rume.
cosechar	kogin.
coser	ñvzvfvn.
cosmos	waj mapu.
cosquillas	(tener) ñayvn.
cosquilloso	(ser) ñayvgen.
costado	kazil, kazij; (exterior de la casa) kazijruka.
costilla	kazi.
costumbres	az, azmogen.
coyuntura	vjgvz, xoy; (de la pierna) xoy luku; (del brazo) xoy lipag.
cráneo	foro logko, legleg.
crecer	xemvn, yvfvn; (un río) magin.
creciente	(de un río) magiñ.
creer	feyentun.
crespo	xinxi.
cresta	kaniw.
cría	koñi.
criar	xemvmvn.
cruzar	hon; (a nado) weyvlhopan.
cual	tuci, cuci.
cualquiera	iney rume, iñey rume, cuci rume, tuci rume.
cualquier	<font color="blue"><i><b>*c. cosa</b></i></font> cem rume.
cuando	tunten mew, cumvl, cumuej, tuntewe; <font color="blue"><i><b>*hasta c.</b></i></font> tuntepu; <font color="blue"><i><b>*de vez en c.</b></i></font> kaxv kaxv.
cuanto(s)	tunten, cumten; mufv; <font color="blue"><i><b>*c. tiempo</b></i></font> tunteñma; <font color="blue"><i><b>*unos c.</b></i></font> kiñe mufv.
cuatro	meli.
cubrir	mvnulvn, takun.
cuchara	wixu.
cucharón	rvfvwe, rvfuwe.
cuchichear	kafkvn.
cuchillo	kuciju, kaxvwe.
cuello	peb.
cuenta	<font color="blue"><i><b>*tomar en c.</b></i></font> inarumen.
cuento	epew, apew.
cuerear	rowvn.
cuerno	mvta; (instrumento que se usa como llamador) kujkuj.
cuero	xvlke; <font color="blue"><i><b>*c. cabelludo</b></i></font> xawalogko; <font color="blue"><i><b>*bolsa de c.</b></i></font> yapaw.
cuerpo	kalvl.
cuidar	penien, azkintunien.
culo	kvciw.
cumbre	wecuñ.
cumplir	puwvlvn.
cuna	kupvlwe; <font color="blue"><i><b>*poner al bebe en la c.</b></i></font> kupvlvn.
cuncuna	pvxew.
cuñada	kvrun, fijka; (h. fem.) ñazu.
cuñado	kvrun, fijka; (h. masc.) gijañ.
curar	zan, zatun.
curioso	(ser) fijmagen; (mirar con curiosidad) leliwvlvn.
curvado	wixur.
chacay	cakay.
chamuscar	kupvlvn.
chancear	ayekan.
chancho	zañiw.
charqui	agim.
chato	capvz.
chico	pvci, pici.
chingolo	cigkol.
chimango	xiwke, xiwkv, ciwkv.
chimenea	(abertura en el techo) wiyoyoruka.
chispear	pvtiwvn.
chivito	pici kapvra.
chivo	kapvra.
chueca	(juego) palin; (bola) pali; <font color="blue"><i><b>*palo de ch.</b></i></font> wiño.
chueco	xvmpew.
chuequero	(jugador de chueca) palife.
chupar	focvzvn.
dar	elun, wvlvn; (comida) ilelvn; (un recado) yefazugun; <font color="blue"><i><b>*</b></i></font><font color="blue"><i><b>d. la mano</b></i></font> mankuwvlvn.
de	mew, mu.
debajo	miñce, mince, mvnce; naqeltu.
decir	pin; <font color="blue"><i><b>*d. así</b></i></font> feypin.
declarar	nentuzugun, zugun.
dedo	cagvj; (de la mano) cagvjkuwv; (del pie) cagvjhamuh.
defender	igkan.
defenderse	kaxvtuñmawvn, igkawvn.
defensa	(en el juego de chueca) kaxilfe.
dejar	mvñalvn, elkvnun; elvn; (soltar) hebvmvn, heykvmvn; <font color="blue"><i><b>*d. atrás</b></i></font> jaynakvmvn.
delantero	(en el juego de chueca) wecuñtufe.
delgado	picirume.
delinquir	werilkan; yafkan.
delito	werin.
demandar	(algo) zajun, zajuntukun.
demasiado	mvtewe, rume, rumeñma.
demonio	wekufv.
dentro	ponwi, koneltu, pu; (de la casa) puruka.
derecha	man; <font color="blue"><i><b>*a la d.</b></i></font> man pvle; <font color="blue"><i><b>*dar la mano d.</b></i></font> mankuwvlvn.
derecho	man; (recto) nor, norkeci, wif, vgkv; (tendido derecho) nvxvg.
derramar	wixun.
derramarse	wixuxipan.
derredor	waj.
derretirse	jiwvn.
derribar	xantun.
desbastar	yvfkvn.
descabezar	(el trigo o la cebada) sucetun.
descansar	vrkvtun.
descascarar	(legumbres) okvjvn, wvkvjvn.
desconocer	kimwetunon.
descubrir	(poner al descubierto) pegeltukun.
descuidarse	uzuamvn.
desde	pvle; mew, mu.
deseable	zuamfalvn; ayvfal.
desear	ijun.
desgastar	vgvrvn.
desgranar	zojkin.
desmenuzar	aten.
desnudo	xilxag; (estar) cañalen, mojkvlen.
desocupado	(estar) relen.
despacio	ñoci, nocikeci.
desparejo	wej.
desparramar	fulvn, pvzvn, wizpvn; (lanzar) pacvqvn; (semillas) gahvn.
despedazar	kaxvkan, picipicitun, wirvfkan; (con la boca) vcafvn.
desperdiciar	gvnamvn; <font color="blue"><i><b>*no d.</b></i></font> gvnaytun.
despertar	nepen, xepen.
despierto	(vivo) ñuwa.
desplomarse	lofvn.
despoblado	(campo) uwe.
despreciar	ijamvn, werin.
desprenderse	lefkvn; (caer) waxonaqvn.
después	wvla, feywvla; fey mew, fey mu.
destapar	wegan.
destruir	teyfvn.
desvalido	kuñifaj.
detrás	furi mew; (hacia/desde atrás) furi pvle.
deuda	zefe.
devolver	(algo prestado) wiñolvn.
día	antv; <font color="blue"><i><b>*hace días</b></i></font> cumvl, cumuej; <font color="blue"><i><b>*muchos dias atrás</b></i></font> fvxa cumvl; <font color="blue"><i><b>*todos los dias</b></i></font> fij antv.
diarrea	(tener) kaycvn.
dibujar	wirin; (al tejer) gvpvnkan.
dibujo	wirin; (en un tejido) gvpvn; (ideograma) ñimin.
diente	foro; (incisivos) ayeweforo; (molares) vlgaforo; <font color="blue"><i><b>*romper con los dientes</b></i></font> waxalvn.
diez	mari.
difamar	yewelkan.
diferente	(ser) kagen.
dificultosamente	ajwe, ajwekeci, kuxangekeci.
diligente	kvlfvn.
diluvio	fvxa mawvh.
dinero	kujiñ.
dirección	ñom.
directamente	wif.
discursear	wewpin.
disparejo	wej.
disputar	notukan.
distancia	tuwvn.
distinto	ka.
distintos	kake.
diuca	siwka.
diverso	fij.
dividir	wvzkan; kaxvntukun.
dividirse	(apartarse) wvzan.
doblar	mvcamvn.
dolor	kuxan, kuxantun, jazkvlumvn; <font color="blue"><i><b>*quejarse de d.</b></i></font> eyvtun.
dolorosamente	kuxangekeci.
dominar	ñopimvn, gvnewvn.
donde	cew.
dormir(se)	umawtun, umaqtun; (profundamente) konumaqkvlen.
dormitorio	umawtuwe.
dorso	(de la mano) wente pvbay kuwv.
dos	epu; <font color="blue"><i><b>*nosotros d.</b></i></font> iñciw; <font color="blue"><i><b>*ustedes d.</b></i></font> eymu; <font color="blue"><i><b>*ellos d.</b></i></font> feyegu.
dulce	kocv.
durar	abvñman.
duro	yafvn, xegkvl.
eco	awkiñ; (del agua) awkiñko; <font color="blue"><i><b>*hacer e.</b></i></font> ciwawvn.
echado	(hacia atrás) xvker.
educador	kimeltucefe.
él	fey; kisu.
elevado	fvxapvra, alvpvra.
elevar	wenumpvramvn, wenupvramvn, wenuntun.
ella	fey; kisu.
ellos/as	(plural) feyegvn, kisu egvn; (dual) feyegu, kisu egu.
emborracharse	gojin.
embriagarse	gojin.
empapar	wifontukun.
emparejar	xvrvmvn.
empeine	wentehamuh.
empezar	jitun.
empollar	jvpañvn.
empujar	rvlxen, vlxen.
en	mew, mu.
enano	lafxa.
encaminar	guyvlvn.
encandilarse	xexiñvn.
encargar	yefaltun; (algo a alguien) elfalvn.
encargo	yefaltu.
encender	vyvmvn, lvpvmvn.
encenderse	lvfvn, vyvn.
encías	vrum.
encima	wente; <font color="blue"><i><b>*pasar por e.</b></i></font> pvrarupan.
encontrar	pen, petun; (por suerte) xafman.
encorvarse	gvjun.
endulzante	kocvlwe.
endurecerse	(madurar) xewvn.
enemigo	kayñe.
enemistar	kayñetuwvn.
energía	(vital) newen.
enfermarse	kuxanvn, tukuxanvn; (de nuevo, recaida) wiñokuxantun.
enfermedad	kuxan.
enfermo	kuxan; <font color="blue"><i><b>*andar e.</b></i></font> kuxankvyawvn.
enfrente	puñma, ixoxipa.
engañar	gvnenkan.
engaño	gvnen.
engendrar	yajvn, yajvmvn.
engreído	xegkvl.
enjuagar	(la boca) vbpuwvh.
enjugar	gvjuzvn.
enmohecerse	perkanvn.
enojar	yafkan.
enojarse	ijkun, jazkvn; <font color="blue"><i><b>*montar en cólera</b></i></font> ijkukonvn.
enramada	kvni.
enredadera	foki.
enredarse	cirwan.
enseguida	feykamvten, pvrvm, mvcay mvten.
enseñar	kimvlvn, kimelvn.
entender	kimvn, azvmvn.
entero	felen.
enterrar	rvgalvn, kvgalvn, rvkvftukun; (a un muerto) elvn.
entonces	fey mew, fey mu, fey wvla.
entrada	wvbgiñ, vbgiñ.
entrar	konvn; (con dificultad) gejukonvn; (a pie) xekakonvn; <font color="blue"><i><b>*volver a e.</b></i></font> kontun.
entregar	calintukun.
entristecer	jazkvzuamvn, weñagkvn.
entristecerse	jazkvn.
entumirse	cokon.
enturbiarse	xufvn.
entusiasmarse	yeñpvramvn.
enviar	werkvlvn; (mensajero) werkvn; (mensaje) amulzugun.
envidia	vxir.
envidiar	vxirvn.
envolver	impobvn, iwvzvn.
equivocarse	welulkawvn.
era	(terreno para trillar) lila.
erizo	(marino) yupe.
esa/e	tvfey, fey; tvfeyci, feyci.
ésa/e	tvfeyci, feyci.
escama	bvbi.
escaparse	montun.
escarbar	kaypvn, keypvn.
escarmentar	kufvn.
escasez	(de víveres) fija.
escatimar	rvkvn.
escoba	lepvwe.
escoger	zujin.
escogido	zujiñ.
esconder	ejkan.
esconderse	ejkawvn.
escondido	(a escondidas) ejkankeci; (detrás) furi.
escribir	wirin, cijkatun; <font color="blue"><i><b>*poner por escrito</b></i></font> wirintukun; <font color="blue"><i><b>*dejar escrito</b></i></font> wirikvnun.
escritor	wirife.
escuchar	ajkvtun.
escupir	tofkvn, tofkvtun.
esférico	mogkol.
eso	tvfeyci, feyci; <font color="blue"><i><b>*e. es</b></i></font> fey.
esófago	rulmewe.
espacio	(lugar) mapu.
espalda	furi; <font color="blue"><i><b>*de e.</b></i></font> payba; <font color="blue"><i><b>*tendido de e.</b></i></font> paybalen.
espantarse	xupefvn, xepewvn.
español	(idioma) wigkazugun.
esperar	vgvmvn.
espeso	pez, mvza.
espina	wayun, wayuh.
espino	(arbusto) wayun, wayuh.
espíritu	pvjv.
esposa	kure.
espuma	xor, xorfan.
esputo	tofkvh.
esta/e	tvfa; tvfaci, faci.
ésta/e	tvfaci.
estaca	vgko; <font color="blue"><i><b>*plantar estacas</b></i></font> vgkolvn.
estampido	xofvn.
estandarte	wenufoye.
estar	mvlen; <font color="blue"><i><b>*e. bien</b></i></font> kvmelen; (de salud) xemolen; <font color="blue"><i><b>*e. así</b></i></font> felen.
este	(oriente) puel.
esternón	xari rvku.
estiércol	me.
estimar	poyen, falintun.
estimular	gvcalvn.
estirado	vhib.
estirarse	wihvn.
esto	tvfaci, faci.
estomago	pvxa.
estornudar	eciwvn.
estornudo	eciw.
estrella	wagvben.
estremecer(se)	geykufvn.
estrujar	kuxvn.
estudiar	cijkatun; (lugar donde se estudia) cijkatuwe.
eventualmente	agkantu.
evidente	(ser) cañalen.
examinar	gvneytun; mabvn, mabvh.
excremento	me.
existir	<font color="blue"><i><b>*no existe</b></i></font> gelay.
expectativa	<font color="blue"><i><b>*estar a la e.</b></i></font> pewvtulen
expropiar	(con engaños y vejaciones) gagen.
extendido	vhib.
exterminar	cewpvzvn.
extranjero	kamojfvñce, kaxipace, wigka; (opresor) wigka.
extraviarse	(del camino) ñuwin.
extremadamente	fentepun.
extremo	wecuñ.
fabricar	zewman.
fábula	(cuento) epew, apew.
fácil	zuguno.
falsedad	gvnen, koibazugu; <font color="blue"><i><b>*levantar falsedades</b></i></font> gvnekvnuzugun.
falta(s)	(cometer) werilkan, yafkan.
familia	(biológica) reñma; (seres queridos) fvren.
fantasma	am.
favor	<font color="blue"><i><b>*por f.</b></i></font> fvrenyen, fvreneafen.
favorecerse	fvrenyewvn.
fecha	<font color="blue"><i><b>*la f. indicada</b></i></font> elantv.
feliz	ayvw.
femenino	zomo.
feo	(ser) wesa azgen.
fermentar	fayvn.
ficha	(de juego) kow.
fierro	pañilwe.
fiesta	kawiñ.
fijarse	(observar) gvnezuamvn.
fila	wixvn, wiftun; (de a uno) wihwih.
filtrar	caytun.
finalmente	feywaj, zewaj, inageci.
flaco	xogli.
flamenco	pixal.
flatulencia	perkvn.
flecha	pvlki.
flexible	gvfvgefvn, vñaz.
flojera	(tener) cofvh, cofvn.
flojo	cofv.
flor	rayen.
florecer	rayvn.
fluctuar	bvfayvn.
fogón	kvxaltuwe.
forastero	ñañ.
forma	az; <font color="blue"><i><b>*dar f.</b></i></font> wizvn.
formal	(serio) gvnel.
fortín	malal.
forzar	newentun.
frazada	gvtantu; ponxo.
freír	fvrin.
frente	tob; (colocado de frente) relmalen.
fresco	fvskv; <font color="blue"><i><b>*tomar el f.</b></i></font> fvskvtun.
frío	wvxe, uxe; <font color="blue"><i><b>*muy f.</b></i></font> axeq; <font color="blue"><i><b>*entumirse de f.</b></i></font> cokon; (tiritar) yafyafvn.
fruta/o	fvh.
frutilla	jaweñ, kejeñ.
frutos	yaj.
fucsia	cilko.
fuego	kvxal; (hacer fuego) kvxaltun.
fuente	(manantial) wvfko.
fuera	(afuera) wekun wekuntu.
fuerte	(ser) newengen; (fortín) malal; (sabor) fvre.
fuerza	newen; <font color="blue"><i><b>*hacer f.</b></i></font> newentun; <font color="blue"><i><b>*estar sin f.</b></i></font> wancon.
fumar	pvxemtun.
gallina	acawaj; <font color="blue"><i><b>*g. araucana</b></i></font> pojonka.
gallo	alka acawaj; alka.
galopar	wirafvn.
ganar	wewvn; (de nuevo) wiñowewtun.
gancho	cag; (para colgar algo sobre el fuego) pvlxvwe, pvlxvntukuwe.
garfio	kvjpvwe.
gargajo	kaqvl.
garganta	rulmewe; (cuello) peb.
gárgaras	walwalvn.
garrote	karoti.
gastar	apvmtukun.
gatear	winolvn.
gato	ñarki, narki; <font color="blue"><i><b>*g. montés</b></i></font> kozkoz.
gaviota	cvje.
gemelo	kvñe.
gemir	eyvtun.
gente	ce.
gobernar	gvnewvn.
gofio	mvrke.
golondrina	pilmayken, wicijkoñ.
golpear	xawawvn, xayayvn; (la cabeza con un objeto duro) xalofvn; (con un palo) mvxogvn; <font color="blue"><i><b>*cortar a golpes</b></i></font> rvpun.
gordo	moxiñ, moxin.
gotear	bvykvn.
gracias	kvmey mi fvrenyefiel, caltu.
grande	fvxa; fvxañma; (ser grande) pvxvn.
granizar	piren.
granizo	pire, piren.
grasa	yiwiñ, iwiñ.
greda	raq; (trabajar la greda) wizvn.
grieta	xow.
grillo	kuhihkuhih, kuninkunin.
gris	cufkeñ; (ceniciento) kazv, kasv.
gritar	wirarvn.
grueso	fvxarume; (ser) rvgen.
gruñir	kogkvlvn.
grupo	xokiñ; (aparte en grupo) wicuke.
guanaco	buah, buan.
guardar	elvn.
guardián	kamañ.
guerra	awkan; (combate) weycan.
guerrear	weycatun.
guerrero	weycafe.
guiar	guyvlvn.
gusano	piru.
gustar	kvmentun.
gustosamente	ayvnkeci; <font color="blue"><i><b>*si gustan</b></i></font> ayvlmvn.
haba	awar; <font color="blue"><i><b>*juego de las habas</b></i></font> awarkuzen.
habilidad	(practica) azvm.
habitar	rukawkvlen, anvmvwkvlen.
hablar	zugun, zvgun; (por otro) zuguñman, zvguñman, zuguñpen, zvguñpen; (mal de alguien) zuguyen, zvguyen.
hace	<font color="blue"><i><b>*h. dias</b></i></font><b> </b>cumvl, cumuej; <font color="blue"><i><b>*h. muchos días</b></i></font><b> </b>fvxa cumvl, fvxa cumuej; <font color="blue"><i><b>*h. mucho tiempo</b></i></font><b> </b>fvxa kuyfi; <font color="blue"><i><b>*h. mucho rato</b></i></font><b> </b>fvxa tayi.
hacer	zewman; <font color="blue"><i><b>*h. fuerza</b></i></font> newentun; <font color="blue"><i><b>*¡y que le voy a h.!</b></i></font> ¡cumafun kay!; <font color="blue"><i><b>*soler h.</b></i></font> cumken.
hacha	toki.
hacia	pvle; mew, mu.
hallar	pen, petun; (casualmente) azman; (algo que otro perdió) pezan; <font color="blue"><i><b>*h. bueno</b></i></font> azentun.
hambre	(tener) gvñvn, qvñin.
harina	(cruda) rvgo; (tostada) mvrke.
hartarse	(estar satisfecho) wezan.
hasta	kvtu; mew, mu; <font color="blue"><i><b>*¿h. cuando?</b></i></font> tuntepu; <font color="blue"><i><b>*h. la vista</b></i></font> pewkajal.
hastiarse	ñon.
hay	<font color="blue"><i><b>*no hay</b></i></font> gelay, geno, geho.
hechicería	kalku zugu.
hechicero	kalku.
hecho	<font color="blue"><i><b>*estar h.</b></i></font> zewvn.
helada	xagliñ, piliñ.
hembra	zomo.
hemorragia	(en la nariz) wawyun.
hender	xvlan.
hendidura	xow.
herida	ajfeñ.
herir	ajfvlvn; (ser herido) ajfvn.
hermana	(h. masc.) lamgen, zeya; (h. fem.) lamgen.
hermano	(h. masc.) peñi; (h. fem.) lamgen.
hermoso	kvme azgen.
herramienta	kvzawpeyvm.
hervir	wazkvn.
hiel	vxum.
hierro	pañilwe.
hígado	ke.
hija	(h. masc.) ñawe; (h. fem.) zomo pvñeñ.
hijo	(h. masc.) fotvm; (h. fem.) wenxu pvñeñ.
hijos	(h. masc.) yaj; (h. fem.) pvñeñ; (“retoños”) coyvn.
hilo	fvw.
hipo	(tener) vxorvn.
historiador	wewpife.
hocico	wvh.
hola	mari mari.
hollín	mulpuh.
hombre	wenxu.
hombro	falke; <font color="blue"><i><b>*encogido de hombros</b></i></font> ponor.
honda	(arma) wixuwe.
hondo	jufv.
hongo	<font color="blue"><i><b>*h. comestible</b></i></font> (del roble) ñegvm, ziweñ; (los grandes con forma de riñón) pvna.
honrar	sakin, ekun.
hora	<font color="blue"><i><b>*¿que h. es?</b></i></font> cumtey antv, tuntey antv, cumte koni antv, tunte koni antv.
hormiga	kojaja, kojeja.
hoy	faciantv.
hoyo	lolo; (en la cancha de chueca) zigijwe, svgvjwe; (hacer hoyos) rvgan.
huella	pvnon.
huérfano	paraway.
hueso	foro.
huevo	kuram.
huir	lefmawvn; (con algo) lefyen.
humear	fvcon; <font color="blue"><i><b>*hacer h.</b></i></font> fvcotun.
humedecer	vremvn, narfvn.
humilde	genozuamgen.
humillarse	jejipun.
humo	fixun.
hundirse	(irse a pique) lanvn.
hurtar	weñen.
ideograma	ñimiñ.
idioma	cezugun; ce kewvh.
igual	ka femgen.
igualar	civmvn.
iluminado	pelo.
imagen	(reflejo) aywiñ.
imitar	inafemvn, inawentun; azentun.
impacientarse	(el caballo) vñan.
imperfectamente	wej, wejkeci.
incisivos	(dientes) ayeweforo.
incitar	gvcalvn.
inclinarse	(el cuerpo hacia adelante) wajonaqvn.
incluso	ka.
inconsciente	(travieso) weswes.
increíble	feyentufalay.
incursión	(ataque) malon.
indicar	zikon; (con señas) vwvmvn.
indomable	awka.
ingle	jawe.
inicio	(parte inicial) ñizo.
inmediatamente	pvci mvcay.
inspeccionar	gvneytun.
insultar	piyawvlvn.
intención	zuam.
intentar	xokitun.
interesante	ayvfal.
interior	<font color="blue"><i><b>*en el i.</b></i></font> pu.
intestinos	kvjce, kvlce; <font color="blue"><i><b>*i. grueso</b></i></font> fvxa rume kvlce, fvxa rume kvjce.
intruso	(ser) fijmagen.
inundación	magiñ.
invierno	pukem.
ir	amuh, amun; (para luego volver) gemen; (a buscar) yemen.
isla	wapi.
izquierda	wele; <font color="blue"><i><b>*a la i.</b></i></font> wele pvle.
jaguar	nawel.
jamás	cumkaw no rume.
jarra	metawe.
jefe	logko; ñizol; (en tiempo de guerra) toki.
joroba	gvxufuri.
jote	kanin.
joven	(varón) wece; (mujer) vjca.
joyero	(platero) rvxafe.
jugar	awkantun; (con juguete) azgejuwvn; (apostar, competir) kuzen; (chueca) palin.
jugo	korv.
junquillo	rvme; <font color="blue"><i><b>*entre los junquillos</b></i></font> rvmentu.
junta	xawvn.
juntar	xawvlvn; xapvmvn; gvlvm, gvlvmvn; (armar) xvrvmvn.
juntarse	xawvluwvn, xawvn.
junto	kiñewvn; (cerca) ina; <font color="blue"><i><b>*j. a la pared</b></i></font> xafruka.
justamente	yoci.
juzgar	feyelvn.
labios	mejfvwvh.
ladear	kvlvn.
ladearse	kalvnaqvn.
lado	az; <font color="blue"><i><b>*al l.</b></i></font> ina pvle, af; <font color="blue"><i><b>*al otro l.</b></i></font> home, hometu; <font color="blue"><i><b>*de este l.</b></i></font> hopa; <font color="blue"><i><b>*recostado de l.</b></i></font> rekvl; <font color="blue"><i><b>*hacia el otro l.</b></i></font><b> </b>ka az pvle; <font color="blue"><i><b>*por todos lados</b></i></font> fij pvle.
ladrar	wagkvn.
ladrón	weñefe; (opresor) wigka.
lagaña	kabe.
lagartija	fijkuñ.
lagarto	palvm.
lago	bafkeh, bafken.
lagrima	kvjeñu.
laguna	bafkeh, bafken.
lamentar	gvmayen.
lana	kab.
lanzar	vxvfvn; (desparramar) pacvqvn.
lápiz	wiriwe.
largo	wif.
laringe	(y la traquea) kvbolkvbol.
lastima	(tener) kuñiltun, kuñvlvn, kuxanzuamyen; <font color="blue"><i><b>*¡que l.!</b></i></font><b> </b>mvna wesa.
lastimarse	ajfvn.
lateral	kazil, kazij; <font color="blue"><i><b>*linea l.</b></i></font> (en el juego de chueca) kaxilwe.
laurel	xiwe.
lavar	kvcan.
lazo	(de junquillo) zef.
leche	lici.
lechuza	pekeñ; <font color="blue"><i><b>*l. cordillerana</b></i></font> yarken; <font color="blue"><i><b>*lechucita de las vizcacheras</b></i></font>; kijkij.
leer	cijkatun.
legua	lewa.
legumbres	(cocidas) pizku
lejos	abv mapu, ka mapu.
lengua	kewvh; (idioma) zugun.
lentamente	ñoci, ñocikeci.
lenteja	jvgi, jancika.
lento	ñoci, ñocikeci.
leña	mamvj; <font color="blue"><i><b>*l. partida</b></i></font> iran; <font color="blue"><i><b>*partir l.</b></i></font> iran.
león	(león americano, puma) pagi, xapial.
lerdo	hape.
levantar	wenuntun, wixañpvramvn, wixapvramvn (poder levantar) lemvn.
levantarse	wixan.
librar	montulvn.
librarse	montun.
líder	logko.
liebre	mara.
liendre	vxen.
ligero	(veloz) yewmewvn, matu.
limosna	(pedir) wvfkvn.
limpiar	liftun.
limpio	lif.
linaza	liñu, jiñu.
lindo	kvme.
liso	yus, payus; (resbaladizo) meyuz.
listo	zew, eluwvn; mvñal.
lobo	<font color="blue"><i><b>*l. marino</b></i></font> bame.
loco	wezwez; “pirulogko”.
locro	(de maíz o cebada) cvkvl
loro	coroy; <font color="blue"><i><b>*l. barranquero</b></i></font> rawijma; <font color="blue"><i><b>*lorito de los pinares</b></i></font> kacaña.
lucero	yepuh, uñelfe.
luchar	mvxatun.
luego	mvcay, mvcay mvten; feykamvten; fey mew, fey mu; feywvla; pvrvm.
lugar	(dirección) ñom; <font color="blue"><i><b>*en l. de</b></i></font> welu.
luhua	buwa.
lumbrera	kvze.
luna	kvyeh; <font color="blue"><i><b>*luz de l.</b></i></font> ale, alen; <font color="blue"><i><b>*l. nueva</b></i></font> we kvyeh; <font color="blue"><i><b>*l. creciente</b></i></font> apoy pvrapan kvyeh; <font color="blue"><i><b>*l. llena</b></i></font> apoy kvyeh; <font color="blue"><i><b>*l. menguante</b></i></font> naq kvyeh.
lustre	(tener) buyvfvn.
luz	anci.
llamar	mvxvmvn, guxumvn.
llamarse	pigen.
llano	laf.
llanura	laf mapu.
llegar	(aquí) akun; (allí) puwvn.
llenar	apolvn.
llenarse	apon.
lleno	apon; <font color="blue"><i><b>*estar ll.</b></i></font> apolen.
llevar	yen; (un recado) yezugun; <font color="blue"><i><b>*ll. consigo</b></i></font><b> </b>yenien; <font color="blue"><i><b>*ll. en ancas</b></i></font> agkazvn.
llorar	gvman.
llover	mawvhvn.
lluvia	mawvh; <font color="blue"><i><b>*protegerse de la ll.</b></i></font> cvjkumtukun.
machacar	xahan; <font color="blue"><i><b>*piedra para m.</b></i></font> xahaxapiwe.
macho	wenxu, alka.
machucar	cajofvn.
madera	mamvj.
madre	ñuke.
madrugada	epe wvh.
madurar	afvmvn; (los granos) xewvn.
maestro	kimeltupelu
magnifico	tutelu.
maíz	uwa; (asado) kucen.
mal/o	wesa, weza; <font color="blue"><i><b>*ando m.</b></i></font> wesayawvn.
maltratar	awvkan, piñmalkan
mallín	majiñ.
mama	moyo.
mamá	papay.
manantial	wvfko.
mandar	werkvn.
manejar	<font color="blue"><i><b>*saber m.</b></i></font><b> </b>pepilvn.
manera	<font color="blue"><i><b>*de esta m.</b></i></font> faleci; <font color="blue"><i><b>*de esa m.</b></i></font> feleci; <font color="blue"><i><b>*de otra m.</b></i></font><b> </b>kageci; (ser) kagen; <font color="blue"><i><b>*de varias maneras</b></i></font> kakerumeci; <font color="blue"><i><b>*de buena m.</b></i></font> kvmekeci; <font color="blue"><i><b>*de mala m.</b></i></font><b> </b>wezakeci; <font color="blue"><i><b>*de ninguna m.</b></i></font> cumgeci no rume, cumueci no rume.
mangrullo	azkintuwe.
manifiesto	(evidente) cañalen.
mano	kuwv; (dar la mano derecha) mankuwvlvn.
manosear	mabvtun.
manso	ñom.
manta	makuñ.
manteca	yiwiñ, iwiñ.
mañana	(al salir el sol) liwen, liweh; (en el transcurso) puliwen; (el día siguiente) wvle, wile, ule; <font color="blue"><i><b>*pasado m.</b></i></font> epuwe.
mapuche	mapuce; (idioma) mapuzugun, mapucezugun.
maqui	(árbol) kvboh.
mar	bafkeh, bafken.
mara	(liebre patagónica) mara.
maravillarse	afmatun.
maravilloso	afmatufal; tutelu.
marca	gvnel.
margen	vpvl.
marido	fvta, wenxu.
mariposa	jampvzkeñ; (nocturna) tohtoh.
marrón	kolv.
más	zoy, yoz, yaf, yom; <font color="blue"><i><b>*¿que m.?</b></i></font> ¿ka cem?
masajear	gvtamvn.
mata	(planta) kajwe.
matar	bagvmvn.
mate	mate.
matear	(tomar mate) matetun.
materia	(pus) xar.
matorral	rvxontu.
mayor	unen, wvnen, wvnel.
mayores	(ancestros) kuyfikece.
medianamente	eja.
mediano	mvha, eja.
medianoche	ragi puh.
medico	zacefe, zatucefe.
medio	(mitad) ragiñ, ragi; <font color="blue"><i><b>*en el m.</b></i></font><b> </b>ragiñma, ragiñtu; <font color="blue"><i><b>*m. de comunicación</b></i></font> amulzuguwe.
mediodía	ragi antv; <font color="blue"><i><b>*después del m.</b></i></font><b> </b>zoy ragi antv, rupan antv.
medula	(espinal) vzkifuri.
membrillo	emperiju.
memorando	wirikvnun.
memoria	<font color="blue"><i><b>*tener buena m.</b></i></font><b> </b>kvme logkogen.
mencionar	(nombrar) konvmpan.
mendigar	wvfkvn.
menor	inan; <font color="blue"><i><b>*el m. de todos</b></i></font> zoy inan.
menospreciar	ijamvn.
mensaje	zugu; <font color="blue"><i><b>*enviar un m.</b></i></font> amulzugun.
mensajero	werken; <font color="blue"><i><b>*enviar un m.</b></i></font> werkvn.
mentir	koybatun.
mentira	koyba, gvnen.
mes	kvyeh.
meta	(en la chueca) xipalwe.
metal	pañilwe.
meter	tukun.
mezclar(se)	reyvn.
mezquinar	rvkvn.
mezquino	rvkv.
mi(s)	ñi.
miedoso	jvkanten.
miel	miski.
mientras	petu, metu.
mil	waragka.
millón	mijon.
mirador	azkintuwe.
mirar	lelin; (con curiosidad) leliwvlvn; (observar) azkintun; (hacia arriba) pvrakintun; (hacia abajo) naqkintun; (hacia adentro) konkintun; (hacia atras) wiñokintun; (dar un vistazo) kintuwvlvn.
miseria	fija.
mitad	ragiñ, ragi
moco	merun.
modo	<font color="blue"><i><b>*de este m.</b></i></font> famueci, fameci, famgeci;<font color="blue"><i><b>*de ese m.</b></i></font> femueci, femgeci; <font color="blue"><i><b>*de un m. raro/de otro m.</b></i></font> kageci.
mofarse	ayetun.
moho	perkan.
mojarse	kvlcafvn.
molares	vlgaforo.
moler	aten; <font color="blue"><i><b>*piedra de m.</b></i></font> kuzi.
molesto	vñfi; (ser) fijazgen.
mollera	wiyulogko, wiyologko.
momento	<font color="blue"><i><b>*en un breve m.</b></i></font> azo; <font color="blue"><i><b>*en otro m.</b></i></font> mvcay wvla.
montaña	mawiza, wigkul.
monte	mawiza.
montón	wirkon; (cosas) wvxul, fuxul.
montoncito	xumaw.
montura	cija.
morder	vnatun.
morir	ban.
mosca	pvbv.
moscardón	ziwjiñ.
mostrar	pegelvn.
mote	kako.
moverse	hegvmvn.
muchacha	mabeh, vjca zomo.
muchísimo	mvna fenxen.
mucho	rume, abv, abvn; fenxen, fenten; wera; (tiempo) fenxentu; <font color="blue"><i><b>*no m.</b></i></font> ajvwe.
mudo	kexo.
muela	vlga, vlgaforo.
muerte	ban.
mujer	zomo; (esposa) kure.
mundo	wajontu mapu.
muñeca	(de la mano) gvñunkuwv, xoy kuwv.
murmullo	kvfvkvfvn.
murmurar	(sobre alguien) zuguyen, zvguyen.
murtilla	vñi.
músculo	fvnilo.
muslo	jike.
mutuamente	welukon, weluke; epuñpvle.
muy	rume, mvte, mvna.
nacer	jeqvn, akun.
nada	cem no rume; <font color="blue"><i><b>*no es n.</b></i></font> cem zugu no tati; pifalay.
nadar	weyvlvn, weyvbvn; (cruzar a nado) weyvlhopan.
nadie	iney no rume.
nalga	kvnvfvncag.
nariz	yu; <font color="blue"><i><b>*hemorragia en la n.</b></i></font> wawyun.
nauseas	(tener) vbgun, vhun.
navegar	zehoyvn.
neblina	ciway, xukvr.
necesidad	zuam.
necesitar	zuamvn, zuamyen; (urgentemente) rume zuamvn.
necio	joy.
negro	kurv.
nevar	piren.
nido	zañe.
niebla	xukvr.
nieto/a	baku, kuku, cezki, cucu.
nietos	yom.
nieve	piren, pire.
ninguna/o	iney no rume, iñey no rume; <font color="blue"><i><b>*de n. manera</b></i></font> cumgeci no rume, cumueci no rume.
niño	pici ce, pici wenxu.
niña	pici ce, pici zomo.
no	se utilizan las partículas -la-(modo real); -no- (modo hipotetico); -kel- (modo volitivo) para formar el negativo de los verbos, Ej. <i>xekan</i> caminar, caminé; <i>xeka</i><font color="blue"><i><b>la</b></i></font><i>n</i> no caminé.
noble	(persona rica y generosa) vbmeh.
noche	puh; <font color="blue"><i><b>*buenas noches</b></i></font> puh may; <font color="blue"><i><b>*toda la n.</b></i></font> kiñe puh.
nomás	mvten.
nombrar	(mencionar) konvmpan; (poner nombre) vytun.
nombre	vy.
norte	pikun, pikum.
nosotros	iñciñ, iñcin; (dual) iñciw.
notar	juwan.
noticia	we zugu;<font color="blue"><i><b>*dar una n.</b></i></font> kimelvn
novedad	we zugu.
novia	gapiñ; vñam.
novio	vñam.
nube	xomv.
nublado	(día) bobma.
nuca	topeb.
nudo	pvron.
nuera	(h. masc.) pvñmo; (h. fem.) hahvg.
nuestro	yiñ; (de nos. dos) yu.
nueve	ayja.
nuevo	we.
numerar	rakin.
nunca	cumkaw no rume, turpu.
nutria	koypu.
ñandú	coyke.
o	kam.
obedecer	feyentun, mvgeltun; tagkvn; yezugun.
observar	azkintun; gvnezuamvn, inazuamvn; inarumen.
obstruirse	gvfvn.
ocaso	kon antv, koni antv.
ocioso	re felepvran.
ocre	palaw.
ocultar	jumvmvn.
ocupado	(estar) zuamgelen, zuamkameken.
ocupar	pvhen.
ocho	pura.
odiar	vzen.
oeste	gulu.
ofender	bukatun.
oficio	kvzaw.
oír	ajkvn.
ojalá	(desear) pewmagen.
ojo	ge; (parte interna) kuralge; <font color="blue"><i><b>*tener los ojos cerrados</b></i></font> umerkvlen.
ojota	okota.
ola	rew.
oler	hvmvtun.
olfatear	hvmvtun
olivillo	tvke.
olor	(tener) hvmvn, hvmvh.
olvidar	goyman, goyin, guyvn; upen, upezuamvn.
olvido	upezuam; <font color="blue"><i><b>*como por o.</b></i></font><b> </b>upezuamkeci.
olla	caja.
ombligo	fvzo.
opresor	wigka.
oprimido	(en apuros) fijmawvn.
oprimir	(con la mano) gvxarvn.
orcón	orkon.
ordenado	<font color="blue"><i><b>*dejar o.</b></i></font> azkvnun.
ordenar	werkvn.
ordinario	(con costumbres wingkas) yana.
oreja	pilun.
origen	(familiar) kvmpeñ; (geografico) tuwvn.
orilla	vpvl; <font color="blue"><i><b>*en la o.</b></i></font><b> </b>inal, inaltu.
orina	wijen, wijeñ.
orinar	wijvn.
oro	mija.
oruga	pvxew.
osar	<font color="blue"><i><b>*no o.</b></i></font> yofvn.
oscurecer	(al anochecer) zum zum.
oscuridad	zumiñ.
oscuro	zumiñ.
otoño	xafkem, rvmv, remvgen.
otro	ka, kagelu; (otros) kake; (personas) kakelu; <font color="blue"><i><b>*al o. lado</b></i></font> home, hometu; <font color="blue"><i><b>*de o. modo</b></i></font> kageci; <font color="blue"><i><b>*en otra parte</b></i></font> kañpvle.
oveja	ufisa.
ovillo	xvko.
pacer	vtan.
pacientemente	ajwe, ajwekeci.
padecer	kuxankawvn.
padre	caw.
pagar	kujin.
país	mapu.
paja	pinu; (para construir casas) kvha.
pájaro	vñvm, qvñvm; <font color="blue"><i><b>*p. carpintero</b></i></font> rere.
palabra	hemvl.
palma	(de la mano) pvbay.
palo	mamvj; <font color="blue"><i><b>*bicho p.</b></i></font> xagvren.
palote	(insecto) xagvren.
paloma	maykoño.
palpar	mabvh, mabvn.
pan	kofke; (horneado) ronotunkofke; (cocido en ceniza) rvmulkofke; (comer pan) kofketun.
páncreas	jikanten, jvkanten.
panecillo	(cocido en agua) svmita, simita; (de arvejas y condimentos) mvjokiñ; (frito) yiwiñkofke.
pantano	foxa; jozko.
pantorrilla	kvmon, komofvhmaxa.
panza	pvxa.
pañal	pici ekuj.
papa	poñv, poñi; (asada) kuwe; (fermentada) funa poñv; <font color="blue"><i><b>*asar papas</b></i></font><b> </b>kuwen; <font color="blue"><i><b>*sembrar papas</b></i></font> poñilvn.
papá	cacay.
par	mvr.
para	mew, mu; <font color="blue"><i><b>*p. qué</b></i></font> cumal, cumael.
parado	wixan.
pararse	wixakvnuwvn, wixapvran.
pardo	kolv.
parecido	erke, reke.
pareja	mvr; afkazi.
parejo	xvr, laf.
parentesco	az.
pariente	mogeyel.
parir	koñin; (mujer) pvñeñvn.
parlamentar	wewpin, koyaqtun.
parte	wvzkan, jaq; <font color="blue"><i><b>*por todas partes</b></i></font> muñku, fij pvle; <font color="blue"><i><b>*en p.</b></i></font> wej, wejkeci; <font color="blue"><i><b>*en otra p.</b></i></font> kañpvle.
partera	pvñeñelcefe.
partir	wvzkan, wvzamvn; xvlan (leña) iran.
partirse	xvlan.
pasado	<font color="blue"><i><b>*p. mañana</b></i></font> epuwe; <font color="blue"><i><b>*el año p.</b></i></font> kamel.
pasar	rulvn, rupan; (hacia acá) rulpan, rupapan; (hacia allá) rumen; (agachado por debajo) siñumrumen; cvñvlrumen; (por encima) pvrarupan; (atravesar) hon; (de una mano a otra) raxon; <font color="blue"><i><b>*no dejar p.</b></i></font> gvrvf; <font color="blue"><i><b>*p. a buscar</b></i></font> yerpun.
paso	<font color="blue"><i><b>*venir de p.</b></i></font> gepan.
pasto	kacu; (paja para hacer casas) kvha.
pastor	kamañ.
pastorear	vtalvn.
pata	hamuh.
patear	mahkvn.
patente	(evidente) cañalen.
patilla	geziñ.
patio	lepvn; (anterior) ixoxipa; (trasero) furiruka.
pato	patu; <font color="blue"><i><b>*p. marrón</b></i></font> kvjfv, kvyfv; <font color="blue"><i><b>*p. de los ríos</b></i></font> wala; <font color="blue"><i><b>*p. nocturno</b></i></font> weraf; <font color="blue"><i><b>*p. picazo</b></i></font> xawa xawa; <font color="blue"><i><b>*p. chucao</b></i></font> cukaw; <font color="blue"><i><b>*patito marrón</b></i></font> pojoj.
paulatinamente	ajwe, ajwekeci.
pavo	pafu; <font color="blue"><i><b>*p. macho</b></i></font> kolkol.
pecho	rvku; (mama) moyo.
pedazo	wvzkan, kaxvn; <font color="blue"><i><b>*hacerse pedazos</b></i></font> cafozvn.
pedernal	likan.
pedir	gijatun; <font color="blue"><i><b>*p. prestado</b></i></font> aretun; <font color="blue"><i><b>*p. ayuda</b></i></font> igkatu; <font color="blue"><i><b>*p. limosna</b></i></font> wvfkvn.
pedo	perkvn.
pedregal	kurantu.
peer	perkvn.
pegamento	vpe.
pegar	(unir) wiban.
pegarse	(adherirse) pvhan.
pelar	lawvmvn; cafvn.
pelear	kewan; (en una guerra) weycan, weycatun.
peligroso	(ser) kuñiwvngen.
pellizcar	ruxetun.
pelo	kab; rvna.
peludo	(armadillo) kofvr.
pena	weñag.
pene	pvnvn.
penosamente	jazkvnkeci.
pensamiento	rakizuam.
pensar	rakizuamvn; (formar animo de) xokitun.
pequeño	pici, pvci; (ser) picin.
pera	(barbilla) kexe.
percibir	juwan.
perder	ñamvmvn; jagkvn.
perderse	ñamvn; gvnan.
perdiz	sijo, fvzv.
perezoso	hape.
permanecer	mvlekan, mvlen; <font color="blue"><i><b>*p. largo tiempo</b></i></font> abvñman.
pero	welu.
perro	xewa.
perseguir	inantukun.
persona	ce.
personalidad	az.
persuadir	gvfetun.
pertenecer	gehgen.
pesado	fanen.
pesar	(dolor) kuxantun; (peso) fanen.
pescado	cajwa.
pestaña	vmi.
petirrojo	joyka.
petróleo	kvxalko, yiwiñko.
pez	cajwa.
pezón	wecuñmoyo, logkomoyo.
picante	fvre.
picar	vpirvn.
pícaro	vñfi.
pico	wvh.
pichi	(pequeño armadillo) kvmxv.
pie	hamuh; <font color="blue"><i><b>*de p.</b></i></font> wixan.
piedra	kura; (de moler) kuzi; (para machacar) xahaxapiwe; (para pulir objetos de greda) vku.
piel	xawa; (de la cabeza) xawalogko <font color="blue"><i><b>*arrancar la p.</b></i></font> solkin.
pierna	cag; (muslo) jike; (parte posterior) furicag.
piñón	(fruto) gvjiw.
piojo	tvh; (del cuerpo) pvxar.
pisar	pvnon.
pitihué	(pájaro) pvtiw.
pitra	(planta) pvxa.
placenta	kvziñ.
planeta	(tierra) wajontu mapu.
plano	laf.
planta	(sembrada) ahvmka; (del pie) pvnowe.
plantar	ahvmvn, anvmvn; (estacas) vgkolvn.
plata	lvqen; <font color="blue"><i><b>*hacer joyas de p.</b></i></font> rvxan.
platero	rvxafe.
plato	rali; (comedero) iwe.
pléyades	<font color="blue"><i><b>*las p.</b></i></font> (constelación) gaw.
plomo	titi.
pluma	picun.
pobre	kuñifaj.
poco	picin; <font color="blue"><i><b>*hace p. rato</b></i></font> cayi, tayi; <font color="blue"><i><b>*por p. tiempo</b></i></font><b> </b>picintu; <font color="blue"><i><b>*p. tiempo</b></i></font> piciñma.
polvareda	xufvr.
polvo	xufvr.
pollo	acawaj.
pómulo	foroge.
poncho	vkvja.
poner	tukun; (dejar) elvn.
por	mew, mu; <font color="blue"><i><b>*por que</b></i></font> cumuelu, cumgelu, cumwelu, cemu.
por favor	fvrenyen.
porción	xokiñ.
poroto	zegvj, zeguj; kvbwi.
posadera	anvwe.
poseer	nien.
poste	vgko; (de la casa) orkon.
pozo	(de agua, aljibe) rvgan ko.
pregunta	ramtun.
preguntar	ramtun.
preguntas	ramtukan.
premonición	perimontun.
prenderse	(encender) vyvn.
prepararse	pepikawvn.
presentación	(intercambiar saludos) pentukun.
prestado	<font color="blue"><i><b>*pedir p.</b></i></font> aretun.
prestar	aregvlvmvn; arelvn.
primavera	pewv.
primero	wvne, une; (el mayor) wvnel; wvnen; (antes) wema.
primo	(materno) mvha.
principal	ñizol.
principio	<font color="blue"><i><b>*al p.</b></i></font> wvnetu.
prisionero	reqge.
probar	(registrar) mabvh, mabvn.
procedencia	(territorial) tuwvn; (familiar) kvpalme.
proceder	(de un lugar) tuwvn.
profesor	kimeltucefe.
promontorio	azkintuwe.
pronto	matu, matuke, arol; awe; mvcay.
provenir	tuwvn.
provisiones	(para un viaje) rokiñ. <b>pudrirse</b> funan.
pudu	puzu.
pueblo	waria.
puerta	(entrada) wvbgiñ, vbgiñ.
pues	ga.
pulga	nervm.
pulido	meyuz.
pulmón	pohoh.
puma	pagi; xapial.
punta	wecuñ; forol.
puntiagudo	yuge.
punto	<font color="blue"><i><b>*cuatro puntos cardinales</b></i></font> meli wixan mapu.
puñado	runa, xuna.
pus	xar.
que	cem; <font color="blue"><i><b>*para q.</b></i></font> cumal, cumael; <font color="blue"><i><b>*por q.</b></i></font><b> </b>cumuelu, cumgelu, cumwelu; <font color="blue"><i><b>*q. mas</b></i></font> ka cem.
quebrado	xafo.
quebrar(se)	waxon, xagon, xafon; (con los dientes) waxalvn.
quedarse	mvlekan.
quejarse	(gemir) eyvtun.
quemar	pvxem; lvpvmvn.
quemarse	lvfvn.
querer	(amar) ayvn; (desear) zuamvn.
quien	iney, iñey, iñi.
quijada	xagaxaga.
quila	kvba.
quillay	kvjay.
quitar	mvntun.
rábano	(dulce) svjgaw.
rabia	(tener) ijkun.
racimo	kvgko.
radal	(árbol) raral.
raíz	folil.
rajarse	(ropa) wicafvn, wicarvn.
rama	row.
rana	pakarwa, jvgki.
rápido	(ser) yewmen.
raro	kageci; (ser) kagen.
rascar	vnan.
rasgarse	wicarvn, wicafvn; wikvrvn.
rasguñar	kawlitun.
raspar	yvfkvn.
rastro	pvnon.
rata	zewv.
rato	<font color="blue"><i><b>*hace poco r.</b></i></font> tayi, cayi; <font color="blue"><i><b>*hace mucho r.</b></i></font> fvxa cayi; <font color="blue"><i><b>*a cada r.</b></i></font> mvcayke.
ratón	zewv.
ratonera	(pasto) cvrvk.
raulí	(árbol) ruyli.
realidad	<font color="blue"><i><b>*en r.</b></i></font> rvf, rvftu.
rebelarse	awkan.
rebelde	awka.
rebuscar	kintukan.
recado	(dar un r.) yefazugun; (llevar un r.) yezugun.
recaída	wiñokuxantun.
recibir	jowvn.
recién	we wvla.
reciente	we.
recipiente	(tinaja) mvñkuwe, meñkuwe.
recobrar	petun, elugetun.
recoger	ñvmin, ñvmitun.
reconocible	kimfalvn.
recordar	konvmpan, kimnien; (de repente) xepezuamvn.
recostado	(de lado) rekvl.
recostarse	(hacia atrás) xvkervn.
recto	nor, wif; (tendido) nvxvg; (persona recta) norce; (el recto) xoxome; <font color="blue"><i><b>*en forma recta</b></i></font> norkeci.
recuerdos	kimniekan.
red	ñewen.
rededor	waj, wajpa, wajon.
redondo	cvgkvz, xvgkvr.
referir	(contar) nvxamyen.
reflejo	(imagen) aywiñ.
reflexionar	xokitun; inazuamvn.
refrescarse	fvskvtun.
regalar	maneluwvn.
regalo	manelun, yewvn.
registrar	(examinar) mabvh, mabvn.
reír	ayen.
reírse	(mofarse) ayetun.
relámpago	jvfke.
relampaguear	jvfken.
relato	(cuento) epew, apew.
relinchar	gaygayvn.
relincho	gaygay.
relumbrar	alofvn.
rellenar	gvriñvn.
remedio	baweh; (experto en remedios) bawehtucefe; (hacer remedios) bawehtun.
remojarse	jozvn.
remolino	(viento) mewbeh; (agua) jufv.
reparar	(observar, tomar en cuenta) inarumen.
reprender	ijkunpen; piyawvlvn.
resbaladizo	meyuz.
rescoldo	awiñ.
reservar	(comida) ecelvn.
resfriarse	cafon.
resistir	newenkvlen.
resolana	pañv.
resonar	ciwawvn.
respetar	ekun.
respiración	heyeh, heyen.
respirar	heyvn.
responder	jowzugun; (obedecer) tagkvn.
restallar	xofvn.
restante	vxo.
restituir	wiñoltun, wvltun.
restregar	gvñkvn.
resuello	heyen, heyeh.
retar	bukatun.
retener	(liquido en la boca) vmun.
retoño	coyvn.
reunión	xawvn.
reunir	xvrvmvn, gvlvmvn, gvlvm.
reventar	pafvn.
revés	<font color="blue"><i><b>*al r.</b></i></font> ka az pvle, wele pvle.
revestir	mvnulvn.
revisar	inarumentukun.
revolver	ziwijvn.
rico	vbmeh, riku.
riñón	kusakusa, kuzakuza, kuzajkiñ.
río	bewfv.
robar	weñen, wigkvn.
roble	koyam.
rocío	mvlum, mulfvn.
rodear	wajvn; cvñkoñman.
rodilla	luku; (parte posterior) gvñunluku.
roer	vgalvn.
rogar	jejipun; gijatun.
rojo	kelv; (oscuro) kum.
romper	(con los dientes) waxalvn.
romperse	cafozvn.
roncar	xalxalvn.
ronco	kafir.
ropa	takun, wesakelu.
rosado	ciwaw.
rostro	age.
rotar	waycvfvn
rotación	waycvf; (terrestre) waycvf mapu.
roto	(un recipiente) weyungen.
ruido	(de mucha gente) wakeñvn; (hacer r. con voces) goygoyvn.
rumiar	kaymvtun.
saber	kimvn; (saber manejar algo) pepilvn.
sabiduría	kimvn.
sabio	kimce.
sacar	entun, nentun; <font color="blue"><i><b>*s. el cuero</b></i></font> rowvn.
sacudir	mvxowvn.
sagrado	(digno de respeto) pijan.
sal	cazi.
salado	koxv.
salida	xipawe, xipalwe; <font color="blue"><i><b>*s. del sol</b></i></font> xipapan antv, xipan antv.
salir	xipan.
saliva	kowvh; tofkvh.
saltar	rvgkvn.
saludar	calin.
saludarse	caliwvn.
saludo	calin.
salvaje	(animal) kayta.
salvar	montulvn.
salvarse	montun.
sanar	xemon, jaftun, jafvn, mogen.
sangre	mojfvñ.
sano	xemo; (estar sano) xemolen.
sapo	bafaxa.
satisfecho	(estar) wezan.
secarse	ñifvn; agkvn.
seco	agken, arken; piwvn, xegkvl.
sed	(tener) wvywvn.
seguir	inan; (con la vista) inakintun.
seis	kayu.
semblante	az.
sembrado	gah.
sembrar	(papas) poñilvn; <font color="blue"><i><b>*s. al voleo</b></i></font> gahvn.
semen	fine.
semilla	fvh, vxar.
sentar	(a una persona) anvmvn.
sentarse	anvn; (despues de estar acostado) anvpvran.
sentir	<font color="blue"><i><b>*s. olor</b></i></font> hvmvtun.
señal	gvnel.
señas	(hacer) vwvmvn.
señora	papay; (no mapuche) ciñura.
separar	kaxvntukun.
separarse	wvzan, pvbtvn.
ser	<font color="blue"><i><b>*s. diferente</b></i></font> kagen; <font color="blue"><i><b>*s. así</b></i></font> femgen, (habitualmente) femken.
serio	(formal) gvnel.
serpiente	filu.
sesos	mvjo, rvpawlogko.
sí	may; fey; <font color="blue"><i><b>*si gustan</b></i></font> ayvlmvn.
siempre	rumel.
siete	reqle.
silbar	wvyweñvn, vweñvn, wikeñvn.
silbido	wvyweñ.
silla	wagku; (de montar) cija.
similar	erke, reke.
sin	geho, geno; <font color="blue"><i><b>*s. embargo</b></i></font> welu; <font color="blue"><i><b>*s. cesar</b></i></font> afkentu.
sobre	wente, wente mew; (acerca de) mew, mu.
sobrino/a	(paterno/a) pabu, maje; (materno/a) weku, koñintu.
soga	mawej, mawvj.
sol	antv; <font color="blue"><i><b>*al bajar el s.</b></i></font><b> </b>naq antv; <font color="blue"><i><b>*al salir el s.</b></i></font> liwen, liweh; <font color="blue"><i><b>*salida del s.</b></i></font><b> </b>xipapan antv, xipan antv.
solamente	mvten.
solo	kisu.
solsticio	(de invierno) wiñoy xipantu, we xipantu, pvrapa gaw.
soltar	haytun, nelvn; (dejar) heykvmvn, hebvmvn.
soltero/a	kawcu.
sombra	jawfeñ.
somnolencia	coñiwvn.
soñar	pewman.
sopa	korv.
sopaipilla	yiwiñkofke.
soplar	pimun.
sorber	ofvlvn.
sordo	pilu.
sosegarse	tvgvn.
sospecha	upezugun.
sospechar	upetun, upezugun.
su(s)	(de usted) mi; (de ustedes dos) mu; (de ustedes) mvn; (de la tercera persona sing. pl. y dual) ñi.
suave	pañus, payus.
subir	pvran; (un cerro) wecun; <font color="blue"><i><b>*hacer s.</b></i></font> pvramvn.
sucio	vkvypuwe.
sudar	arofvn.
suegra	(h. masc.) jaja; (h. fem.) hahvg.
suegro	(h. masc.) cezkuy; (h. fem.) pvñmo.
suelo	pvji.
sueño	pewma; (ganas de dormir) umaq.
sujetar	nvhyen, ñopimvn.
sumamente	kazme, kazel.
superar	<font color="blue"><i><b>*tratar de s. a alguien</b></i></font> hotukan.
superior	(parte superior) ñizo.
sur	wiji; <font color="blue"><i><b>*viento s.</b></i></font> wayweh.
surgir	xipapan.
suspender	(una acción) afelvn.
suspendido	(colgando sobre algo) sencu.
suspirar	weñagkvn.
tabaco	pvxem.
tábano	pvxokiñ.
tal	<font color="blue"><i><b>*t. como</b></i></font> erke, reke; <font color="blue"><i><b>*tener por t.</b></i></font> feyelvn.
talón	rvgkoy.
tallo	kajwe.
también	kafey, ka.
tantear	sumpatun.
tanto	fenxen.
tapar	takun.
taparse	gvfvn.
tardarse	abvñman.
tarde	(la tarde) rupan antv; naq antv.
techo	pvzij.
tejer	(en telar) gvren; (haciendo dibujos) gvpvnkan.
tejido	(con dibujos) gvpvn.
telar	wixal.
temblar	mvbmvlvn, xvnxvnvn.
temblor	(terremoto) nvyvn.
temer	jvkan.
tendido	(en línea recta) nvxvg; (de espaldas) paybalen.
tener	nien; <font color="blue"><i><b>*t. por tal</b></i></font> feyelvn.
teñir	afvlkan.
terminar	zewvn; (consumir) apvmvn.
tero	xeqel, xeqvl, keltewe.
terreno	mapu.
terremoto	nvyvn.
territorio	mapu; (todo el t. mapuche) waj mapu.
testículo	kvxaw.
teta	moyo.
tía	(paterna) pabu; (materna) ñukentu.
tibio	jako, yako.
tiempo	<font color="blue"><i><b>*largo t.</b></i></font> abvñma, abvntu; <font color="blue"><i><b>*mucho t.</b></i></font><b> </b>fenxentu; <font color="blue"><i><b>*poco t.</b></i></font> piciñma, picintu; <font color="blue"><i><b>*hace muchisimo t.</b></i></font> kuyfi, fvxa kuyfi; <font color="blue"><i><b>*con el t.</b></i></font> agkantu; <font color="blue"><i><b>*tanto t.</b></i></font> (saludo) fvta kuyfi, ta kuyfi.
tierra	tuwe; mapu; pvji; (planeta) wajontu mapu.
tinaja	meñkuwe; (cisterna) meseg.
tiniebla	zumiñ.
tío	(paterno) maje; (materno) weku.
tirador	(con arma de fuego) xalkatufe.
tiritar	mvbmvlvn, xvnxvnvn, yafyafvn.
tiuque	ciwkv, xiwke, xiwkv.
tizón	comaz.
tobillo	palipalihamuh.
tocar	(corresponder) xafvn.
tocayo	baku.
todavía	petu, metu.
todo	kom; (cada uno) fij; <font color="blue"><i><b>*por todas partes</b></i></font> muñku.
tomar	(agarrar) tun, nvn; (beber agua) pvtokon; (de un trago) kiñentukun; <font color="blue"><i><b>*t. en brazos</b></i></font> metan; <font color="blue"><i><b>*t. en cuenta</b></i></font> inarumen.
tonto	joy, boy.
toparse	xogkvn.
tope	<font color="blue"><i><b>*al t.</b></i></font> wecuñtu.
torcaza	kono.
torcer	wicvnvn.
torcido	xvmfvn, xvfvl.
tordo	kvrew.
tortafrita	yiwiñkofke.
tórtola	maykoño.
tos	xvfon, cafo.
toser	cafon.
tostado	kobvf.
tostador	leqpe; kotvwe.
tostar	kotvn.
total	felen; (la totalidad) ixo.
trabajador	kvzawfe.
trabajar	kvzawvn.
trabajo	kvzaw.
traer	kvpalvn.
tragar	bvmvn.
trago	<font color="blue"><i><b>*tomar de un t.</b></i></font> kiñentukun.
traicionero	vñfi.
trampa	(de hilo) waci.
trance	(de machi) kvymin.
tranquilizar	(con palabras y caricias) pijeltun.
transcurso	<font color="blue"><i><b>*en el t.</b></i></font> agkantu.
transparente/cia	ayliñ.
traquea	kvbolkvbol.
trasegar	rvfvn.
trasero	anvwe.
trasladar	wiñamvn.
trasquilar	keziñvn.
tratar	(mal) awvkan.
travesura	<font color="blue"><i><b>*como por t.</b></i></font> awkantunkeci.
travieso	weswes.
trazar	wirin.
trenza	capetu.
trenzar	capen.
tres	kvla.
trigo	kacija; (tostado) kotvh; (crudo machacado) tvkvh.
tripas	kvlce, kvjce.
triste	(estar) weñagkvlen, jazkvlen.
tristeza	weñag.
trocar	xafkiñtun.
trompa	wvh.
tronco	muxug.
tropezar	mvxurvn.
trueno	xalkan.
tu	eymi; <font color="blue"><i><b>*¿y tu?</b></i></font> eymi kay.
tu(s)	mi.
tucutuco	(roedor) tunzuku.
tuerto	xawma.
tuétano	vrkvforo.
tullirse	wayfvn.
tupido	xoge; (ser t.) xogen.
ubicación	<font color="blue"><i><b>*tener u.</b></i></font> gvnezuamvn.
ubre	gvja; moyo.
ulmo	(árbol) gulgu.
ultimo	inageci.
unir	wiban.
universo	waj mapu.
uno/a	kiñe.
uña	wili.
usado	juz.
usar	pvhen.
usted	eymi.
ustedes	eymvn; (dual) eymu.
vaca	waka.
vaciar	wejimvn.
vacío	wejin.
vadear	giban.
vado	gibawe.
vagina	kuxi.
vago	cofv; (ser vago) cofvh, cofvn.
vaho	orkvn.
vaina	(de legumbre) kapi.
valer	falin.
valiente	(ser) fvta piwkegen.
valor	fvta piwke.
valle	waw.
vanagloriarse	majmazugun.
vano	<font color="blue"><i><b>*en v.</b></i></font> gvnam.
vapor	wvwan; orkvn.
varas	(para construir) tara.
varón	wenxu.
vaso	pvtokowe, pvtuwe.
vecino	karukace.
vejiga	pafvzkoñ.
vela	kvze.
veloz	yewmewvn.
vello	(púbico) kabca, kalca.
vena	kvnvfvh.
vencer	yerpvn, wewvn.
vender	fenzen.
veneno	fvñapuwe.
venir	kvpan; (de paso) gepan; <font color="blue"><i><b>*v. a buscar algo</b></i></font> yepan.
venus	(planeta) yepuh, uñelfe.
ver	pen, petun; (observar) azkintun; (distinguir, ver claro) pelon.
verse	(mutuamente) pewvn.
verano	walvg.
veras	<font color="blue"><i><b>*de v.</b></i></font><b> </b>rvfkvnu.
verdad	mupiñ zugu; <font color="blue"><i><b>*en v.</b></i></font> rvf, rvftu.
verdaderamente	mupiñkeci; rvf, rvftu.
verdadero	mupiñ, mvcay.
verde	karv; (claro, verde agua) liqkarv.
vergüenza	<font color="blue"><i><b>*tener v.</b></i></font> yewen.
vertiente	wixunko.
vesícula	(biliar) vxum.
vestido	(de mujer) camaj; festiw.
vestimenta	takun.
vez	naq, rupa, rupaci, rvtu; <font color="blue"><i><b>*de v. en cuando</b></i></font> kaxv kaxv; <font color="blue"><i><b>*algunas veces</b></i></font> kiñekemu.
viajar	(al extranjero) hampvlkan.
vicioso	(ser) fijazgen.
vida	mogen.
vieja	kuze.
viejo	(personas) fvca; (animal) magka; (ser viejo) fvcan.
viento	kvrvf; <font color="blue"><i><b>*v. sur</b></i></font> wayweh.
vientre	jawepvxa.
vigilar	gvneytunien.
vincha	xarilogko.
vino	pulku; <font color="blue"><i><b>*beber v.</b></i></font> pulkutun.
violar	nvntun.
violeta	koñoj.
visión	(premonición) perimontun.
visitar	jajitun.
vista	(el sentido) ge; (mirada) kintun; <font color="blue"><i><b>*apartar la v.</b></i></font> kakintun.
vistazo	<font color="blue"><i><b>*dar un v.</b></i></font> kintuwvlvn.
vitoreo	afafan.
vivir	mogen.
vivo	(despierto) ñuwa.
volar	mvpvn.
volcán	zeqiñ, zeqvñ.
voltear	(derribar) xantun.
voluntariamente	kisuzuam.
volver	wiñon; (corriendo) wiñolefvn; <font color="blue"><i><b>*v. a entrar</b></i></font> kontun.
vomitar	rapin; (expulsar algo vomitandolo) rapinentun.
vos	eymi; <font color="blue"><i><b>*¿y v.?</b></i></font> ¿eymi kay?
vosotros	eymvn; (vosotros dos) eymu.
voz	zugun.
vueltas	<font color="blue"><i><b>*dar v.</b></i></font> waycvfvn; (alrededor) wajvn, wajon.
vuestro(s)	(de vosotros) mvn; (de vosotros dos) mu.
vulva	kuxi.
y	ka; kay.
ya	zewma, zew.
yegua	zomo kawej.
yerno	(h. masc.) cezkuy (h. fem.) kulgen.
yo	iñce.
yugo	yuku.
yunta	xanin; <font color="blue"><i><b>*y. de bueyes</b></i></font> xanin mansun.
yuyo	napor.
zambullir	rvlun, rvmvn.
zanjón	lol.
zapallo	pegka.
zapato	sumel, sapatu.
zaranda	ciñvzwe.
zorrino	zañi.
zorro	gvrv.
zorzal	wijki, wilki.
